0x12CB3460, 36963305641247600, 230975105, 230975130, 25, 424x240 
0x12CB3460, 36963305642851600, 230975261, 230975264, 3, 424x240 
0x12CB3460, 36963305643969472, 230975383, 230975386, 3, 424x240 
0x12CB3460, 36963305645249808, 230975506, 230975509, 3, 424x240 
0x12CB3460, 36963305646852536, 230975676, 230975678, 2, 424x240 
0x12CB3460, 36963305647970616, 230975776, 230975780, 4, 424x240 
0x12CB3460, 36963305649247744, 230975906, 230975909, 3, 424x240 
0x12CB3460, 36963305651326384, 230976106, 230976120, 14, 640x360 
0x12CB3460, 36963305651967720, 230976176, 230976184, 8, 640x360 
0x12CB3460, 36963305653889456, 230976374, 230976379, 5, 640x360 
0x12CB3460, 36963305654211440, 230976395, 230976399, 4, 640x360 
0x12CB3460, 36963305654529240, 230976426, 230976430, 4, 640x360 
0x12CB3460, 36963305655008600, 230976474, 230976481, 7, 640x360 
0x12CB3460, 36963305655329400, 230976514, 230976521, 7, 640x360 
0x12CB3460, 36963305655649128, 230976546, 230976548, 2, 640x360 
0x12CB3460, 36963305655970616, 230976575, 230976578, 3, 640x360 
0x12CB3460, 36963305656290232, 230976606, 230976608, 2, 640x360 
0x12CB3460, 36963305656611808, 230976646, 230976649, 3, 640x360 
0x12CB3460, 36963305657248320, 230976708, 230976712, 4, 640x360 
0x12CB3460, 36963305657567632, 230976736, 230976739, 3, 640x360 
0x12CB3460, 36963305657888072, 230976766, 230976769, 3, 640x360 
0x12CB3460, 36963305658207528, 230976796, 230976799, 3, 640x360 
0x12CB3460, 36963305658530312, 230976826, 230976830, 4, 640x360 
0x12CB3460, 36963305659009440, 230976883, 230976886, 3, 640x360 
0x12CB3460, 36963305659328288, 230976907, 230976910, 3, 640x360 
0x12CB3460, 36963305659647832, 230976945, 230976948, 3, 640x360 
0x12CB3460, 36963305659969024, 230976975, 230976981, 6, 640x360 
0x12CB3460, 36963305660288272, 230977007, 230977009, 2, 640x360 
0x12CB3460, 36963305660609944, 230977036, 230977040, 4, 640x360 
0x12CB3460, 36963305660927488, 230977076, 230977079, 3, 640x360 
0x12CB3460, 36963305661248720, 230977105, 230977108, 3, 640x360 
0x12CB3460, 36963305661568072, 230977136, 230977138, 2, 640x360 
0x12CB3460, 36963305661887848, 230977165, 230977168, 3, 640x360 
0x12CB3460, 36963305662209496, 230977196, 230977199, 3, 640x360 
0x12CB3460, 36963305662531248, 230977235, 230977238, 3, 640x360 
0x12CB3460, 36963305663011656, 230977275, 230977279, 4, 640x360 
0x12CB3460, 36963305663328264, 230977308, 230977311, 3, 640x360 
0x12CB3460, 36963305663646864, 230977345, 230977348, 3, 640x360 
0x12CB3460, 36963305663966832, 230977372, 230977375, 3, 640x360 
0x12CB3460, 36963305664287568, 230977406, 230977409, 3, 640x360 
0x12CB3460, 36963305664607944, 230977435, 230977453, 18, 640x360 
0x12CB3460, 36963305664928752, 230977474, 230977477, 3, 640x360 
0x12CB3460, 36963305665247776, 230977505, 230977508, 3, 640x360 
0x12CB3460, 36963305665568376, 230977536, 230977539, 3, 640x360 
0x12CB3460, 36963305665890264, 230977565, 230977568, 3, 640x360 
0x12CB3460, 36963305666212456, 230977596, 230977600, 4, 640x360 
0x12CB3460, 36963305666690800, 230977646, 230977649, 3, 640x360 
0x12CB3460, 36963305667011880, 230977677, 230977681, 4, 640x360 
0x12CB3460, 36963305667332944, 230977711, 230977715, 4, 640x360 
0x12CB3460, 36963305667647056, 230977745, 230977747, 2, 640x360 
0x12CB3460, 36963305667966840, 230977775, 230977778, 3, 640x360 
0x12CB3460, 36963305668286784, 230977805, 230977807, 2, 640x360 
0x12CB3460, 36963305668607232, 230977836, 230977838, 2, 640x360 
0x12CB3460, 36963305668928136, 230977873, 230977881, 8, 640x360 
0x12CB3460, 36963305669247952, 230977906, 230977923, 17, 640x360 
0x12CB3460, 36963305669568328, 230977935, 230977937, 2, 640x360 
0x12CB3460, 36963305669888480, 230977966, 230977970, 4, 640x360 
0x12CB3460, 36963305670208656, 230977996, 230978000, 4, 640x360 
0x12CB3460, 36963305670691792, 230978045, 230978048, 3, 640x360 
0x12CB3460, 36963305671007864, 230978076, 230978078, 2, 640x360 
0x12CB3460, 36963305671328160, 230978107, 230978111, 4, 640x360 
0x12CB3460, 36963305671647368, 230978145, 230978148, 3, 640x360 
0x12CB3460, 36963305671966824, 230978175, 230978178, 3, 640x360 
0x12CB3460, 36963305672287448, 230978205, 230978208, 3, 640x360 
0x12CB3460, 36963305672607560, 230978235, 230978238, 3, 640x360 
0x12CB3460, 36963305672928592, 230978266, 230978269, 3, 640x360 
0x12CB3460, 36963305673248768, 230978306, 230978308, 2, 640x360 
0x12CB3460, 36963305673568040, 230978335, 230978338, 3, 640x360 
0x12CB3460, 36963305673890752, 230978380, 230978383, 3, 640x360 
0x12CB3460, 36963305674208064, 230978395, 230978398, 3, 640x360 
0x12CB3460, 36963305674686792, 230978445, 230978448, 3, 640x360 
0x12CB3460, 36963305675009296, 230978477, 230978479, 2, 640x360 
0x12CB3460, 36963305675329128, 230978515, 230978518, 3, 640x360 
0x12CB3460, 36963305675646768, 230978545, 230978548, 3, 640x360 
0x12CB3460, 36963305675967584, 230978575, 230978578, 3, 640x360 
0x12CB3460, 36963305676287184, 230978605, 230978608, 3, 640x360 
0x12CB3460, 36963305676607304, 230978635, 230978638, 3, 640x360 
0x12CB3460, 36963305676927760, 230978675, 230978677, 2, 640x360 
0x12CB3460, 36963305677248840, 230978706, 230978709, 3, 640x360 
0x12CB3460, 36963305677571640, 230978735, 230978738, 3, 640x360 
0x12CB3460, 36963305677887376, 230978765, 230978768, 3, 640x360 
0x12CB3460, 36963305678366312, 230978815, 230978817, 2, 640x360 
0x12CB3460, 36963305678688088, 230978846, 230978869, 23, 640x360 
0x12CB3460, 36963305679007104, 230978879, 230978881, 2, 640x360 
0x12CB3460, 36963305679326568, 230978906, 230978910, 4, 640x360 
0x12CB3460, 36963305679649008, 230978945, 230978947, 2, 640x360 
0x12CB3460, 36963305679966952, 230978975, 230978978, 3, 640x360 
0x12CB3460, 36963305680288288, 230979005, 230979008, 3, 640x360 
0x12CB3460, 36963305680608200, 230979036, 230979039, 3, 640x360 
0x12CB3460, 36963305680926928, 230979066, 230979070, 4, 640x360 
0x12CB3460, 36963305681247448, 230979107, 230979109, 2, 640x360 
0x12CB3460, 36963305681567040, 230979135, 230979137, 2, 640x360 
0x12CB3460, 36963305681888096, 230979166, 230979168, 2, 640x360 
0x12CB3460, 36963305682368608, 230979216, 230979219, 3, 640x360 
0x12CB3460, 36963305682688824, 230979245, 230979248, 3, 640x360 
0x12CB3460, 36963305683006472, 230979277, 230979279, 2, 640x360 
0x12CB3460, 36963305683328336, 230979316, 230979318, 2, 640x360 
0x12CB3460, 36963305683648848, 230979387, 230979389, 2, 640x360 
0x12CB3460, 36963305684287536, 230979406, 230979408, 2, 640x360 
0x12CB3460, 36963305684607864, 230979435, 230979438, 3, 640x360 
0x12CB3460, 36963305684926168, 230979466, 230979469, 3, 640x360 
0x12CB3460, 36963305685247608, 230979506, 230979509, 3, 640x360 
0x12CB3460, 36963305685567384, 230979535, 230979537, 2, 640x360 
0x12CB3460, 36963305685887384, 230979566, 230979568, 2, 640x360 
0x12CB3460, 36963305686372480, 230979615, 230979618, 3, 640x360 
0x12CB3460, 36963305686689416, 230979645, 230979648, 3, 640x360 
0x12CB3460, 36963305687007768, 230979675, 230979680, 5, 640x360 
0x12CB3460, 36963305687328592, 230979706, 230979710, 4, 640x360 
0x12CB3460, 36963305687647056, 230979745, 230979748, 3, 640x360 
0x12CB3460, 36963305687968992, 230979776, 230979778, 2, 640x360 
0x12CB3460, 36963305688285920, 230979805, 230979807, 2, 640x360 
0x12CB3460, 36963305688606208, 230979836, 230979839, 3, 640x360 
0x12CB3460, 36963305688927440, 230979871, 230979874, 3, 640x360 
0x12CB3460, 36963305689246904, 230979905, 230979908, 3, 640x360 
0x12CB3460, 36963305689567240, 230979935, 230979937, 2, 640x360 
0x12CB3460, 36963305690048608, 230979986, 230979988, 2, 640x360 
0x12CB3460, 36963305690368640, 230980015, 230980017, 2, 640x360 
0x12CB3460, 36963305690688848, 230980044, 230980048, 4, 640x360 
0x12CB3460, 36963305691006808, 230980076, 230980079, 3, 640x360 
0x12CB3460, 36963305691327504, 230980106, 230980111, 5, 640x360 
0x12CB3460, 36963305691648328, 230980145, 230980148, 3, 640x360 
0x12CB3460, 36963305691967488, 230980175, 230980178, 3, 640x360 
0x12CB3460, 36963305692286360, 230980205, 230980209, 4, 640x360 
0x12CB3460, 36963305692608416, 230980236, 230980239, 3, 640x360 
0x12CB3460, 36963305692926904, 230980265, 230980269, 4, 640x360 
0x12CB3460, 36963305693247920, 230980305, 230980308, 3, 640x360 
0x12CB3460, 36963305693568248, 230980335, 230980337, 2, 640x360 
0x12CB3460, 36963305694047144, 230980395, 230980399, 4, 640x360 
0x12CB3460, 36963305694367336, 230980415, 230980417, 2, 640x360 
0x12CB3460, 36963305694686568, 230980446, 230980449, 3, 640x360 
0x12CB3460, 36963305695007736, 230980475, 230980478, 3, 640x360 
0x12CB3460, 36963305695327768, 230980506, 230980510, 4, 640x360 
0x12CB3460, 36963305695647360, 230980546, 230980548, 2, 640x360 
0x12CB3460, 36963305695968256, 230980575, 230980577, 2, 640x360 
0x12CB3460, 36963305696288008, 230980605, 230980608, 3, 640x360 
0x12CB3460, 36963305696608544, 230980635, 230980638, 3, 640x360 
0x12CB3460, 36963305696927760, 230980675, 230980678, 3, 640x360 
0x12CB3460, 36963305697248144, 230980706, 230980709, 3, 640x360 
0x12CB3460, 36963305697727944, 230980746, 230980749, 3, 640x360 
0x12CB3460, 36963305698046432, 230980786, 230980788, 2, 640x360 
0x12CB3460, 36963305698367256, 230980816, 230980819, 3, 640x360 
0x12CB3460, 36963305698687264, 230980845, 230980859, 14, 640x360 
0x12CB3460, 36963305699006728, 230980876, 230980878, 2, 640x360 
0x12CB3460, 36963305699327264, 230980906, 230980911, 5, 640x360 
0x12CB3460, 36963305699647688, 230980945, 230980948, 3, 640x360 
0x12CB3460, 36963305699967352, 230980975, 230980977, 2, 640x360 
0x12CB3460, 36963305700286432, 230981005, 230981008, 3, 640x360 
0x12CB3460, 36963305700607800, 230981036, 230981044, 8, 640x360 
0x12CB3460, 36963305700928704, 230981066, 230981069, 3, 640x360 
0x12CB3460, 36963305701247360, 230981105, 230981110, 5, 640x360 
0x12CB3460, 36963305701727896, 230981145, 230981149, 4, 640x360 
0x12CB3460, 36963305702048352, 230981185, 230981188, 3, 640x360 
0x12CB3460, 36963305702369584, 230981216, 230981219, 3, 640x360 
0x12CB3460, 36963305702687440, 230981245, 230981247, 2, 640x360 
0x12CB3460, 36963305703007920, 230981276, 230981278, 2, 640x360 
0x12CB3460, 36963305703326784, 230981306, 230981310, 4, 640x360 
0x12CB3460, 36963305703648632, 230981345, 230981368, 23, 640x360 
0x12CB3460, 36963305703966928, 230981376, 230981380, 4, 640x360 
0x12CB3460, 36963305704286336, 230981405, 230981423, 18, 640x360 
0x12CB3460, 36963305704608256, 230981436, 230981438, 2, 640x360 
0x12CB3460, 36963305704927728, 230981476, 230981479, 3, 640x360 
0x12CB3460, 36963305705249224, 230981505, 230981508, 3, 640x360 
0x12CB3460, 36963305705729056, 230981555, 230981558, 3, 640x360 
0x12CB3460, 36963305706049640, 230981586, 230981589, 3, 640x360 
0x12CB3460, 36963305706368904, 230981615, 230981618, 3, 640x360 
0x12CB3460, 36963305706689128, 230981645, 230981648, 3, 640x360 
0x12CB3460, 36963305707007112, 230981675, 230981678, 3, 640x360 
0x12CB3460, 36963305707329640, 230981716, 230981719, 3, 640x360 
0x12CB3460, 36963305707651048, 230981745, 230981748, 3, 640x360 
0x12CB3460, 36963305707969000, 230981775, 230981778, 3, 640x360 
0x12CB3460, 36963305708287408, 230981805, 230981807, 2, 640x360 
0x12CB3460, 36963305708607576, 230981835, 230981838, 3, 640x360 
0x12CB3460, 36963305708930568, 230981873, 230981876, 3, 640x360 
0x12CB3460, 36963305709407560, 230981916, 230981919, 3, 640x360 
0x12CB3460, 36963305709726720, 230981946, 230981950, 4, 640x360 
0x12CB3460, 36963305710049800, 230981986, 230981988, 2, 640x360 
0x12CB3460, 36963305710367440, 230982015, 230982018, 3, 640x360 
0x12CB3460, 36963305710686368, 230982045, 230982048, 3, 640x360 
0x12CB3460, 36963305711010192, 230982076, 230982079, 3, 640x360 
0x12CB3460, 36963305711326176, 230982115, 230982118, 3, 640x360 
0x12CB3460, 36963305711646344, 230982146, 230982148, 2, 640x360 
0x12CB3460, 36963305711969216, 230982174, 230982177, 3, 640x360 
0x12CB3460, 36963305712286496, 230982205, 230982210, 5, 640x360 
0x12CB3460, 36963305712606192, 230982235, 230982238, 3, 640x360 
0x12CB3460, 36963305712927312, 230982275, 230982278, 3, 640x360 
0x12CB3460, 36963305713407272, 230982315, 230982318, 3, 640x360 
0x12CB3460, 36963305713727552, 230982383, 230982387, 4, 640x360 
0x12CB3460, 36963305714366808, 230982415, 230982422, 7, 640x360 
0x12CB3460, 36963305714685928, 230982445, 230982449, 4, 640x360 
0x12CB3460, 36963305715008960, 230982476, 230982478, 2, 640x360 
0x12CB3460, 36963305715326208, 230982516, 230982519, 3, 640x360 
0x12CB3460, 36963305715646712, 230982546, 230982553, 7, 640x360 
0x12CB3460, 36963305715966000, 230982576, 230982579, 3, 640x360 
0x12CB3460, 36963305716286360, 230982606, 230982612, 6, 640x360 
0x12CB3460, 36963305716609832, 230982636, 230982639, 3, 640x360 
0x12CB3460, 36963305716932232, 230982668, 230982672, 4, 640x360 
0x12CB3460, 36963305717407840, 230982715, 230982718, 3, 640x360 
0x12CB3460, 36963305717728792, 230982747, 230982751, 4, 640x360 
0x12CB3460, 36963305718051224, 230982785, 230982788, 3, 640x360 
0x12CB3460, 36963305718365912, 230982815, 230982818, 3, 640x360 
0x12CB3460, 36963305718687096, 230982845, 230982852, 7, 640x360 
0x12CB3460, 36963305719012064, 230982883, 230982885, 2, 640x360 
0x12CB3460, 36963305719330264, 230982914, 230982917, 3, 640x360 
0x12CB3460, 36963305719647208, 230982945, 230982949, 4, 640x360 
0x12CB3460, 36963305719975128, 230982975, 230982978, 3, 640x360 
0x12CB3460, 36963305720287664, 230983005, 230983009, 4, 640x360 
0x12CB3460, 36963305720608272, 230983035, 230983039, 4, 640x360 
0x12CB3460, 36963305721085720, 230983085, 230983093, 8, 640x360 
0x12CB3460, 36963305721407216, 230983115, 230983118, 3, 640x360 
0x12CB3460, 36963305721725888, 230983148, 230983151, 3, 640x360 
0x12CB3460, 36963305722046776, 230983186, 230983189, 3, 640x360 
0x12CB3460, 36963305722367336, 230983216, 230983218, 2, 640x360 
0x12CB3460, 36963305722687208, 230983245, 230983248, 3, 640x360 
0x12CB3460, 36963305723008208, 230983276, 230983279, 3, 640x360 
0x12CB3460, 36963305723326560, 230983310, 230983313, 3, 640x360 
0x12CB3460, 36963305723646424, 230983348, 230983351, 3, 640x360 
0x12CB3460, 36963305723966680, 230983375, 230983379, 4, 640x360 
0x12CB3460, 36963305724286744, 230983406, 230983408, 2, 640x360 
0x12CB3460, 36963305724608760, 230983436, 230983438, 2, 640x360 
0x12CB3460, 36963305725086112, 230983485, 230983487, 2, 640x360 
0x12CB3460, 36963305725408288, 230983516, 230983519, 3, 640x360 
0x12CB3460, 36963305725728936, 230983558, 230983561, 3, 640x360 
0x12CB3460, 36963305726047776, 230983586, 230983603, 17, 640x360 
0x12CB3460, 36963305726368176, 230983615, 230983617, 2, 640x360 
0x12CB3460, 36963305726687088, 230983646, 230983648, 2, 640x360 
0x12CB3460, 36963305727009672, 230983676, 230983681, 5, 640x360 
0x12CB3460, 36963305727326296, 230983706, 230983717, 11, 640x360 
0x12CB3460, 36963305727647752, 230983746, 230983749, 3, 640x360 
0x12CB3460, 36963305727971288, 230983775, 230983778, 3, 640x360 
0x12CB3460, 36963305728286592, 230983806, 230983824, 18, 640x360 
0x12CB3460, 36963305728780040, 230983896, 230983899, 3, 640x360 
0x12CB3460, 36963305729412152, 230983916, 230983919, 3, 640x360 
0x12CB3460, 36963305729730272, 230983955, 230983962, 7, 640x360 
0x12CB3460, 36963305730054256, 230983986, 230983990, 4, 640x360 
0x12CB3460, 36963305730371088, 230984015, 230984018, 3, 640x360 
0x12CB3460, 36963305730686784, 230984055, 230984060, 5, 640x360 
0x12CB3460, 36963305731007768, 230984075, 230984078, 3, 640x360 
0x12CB3460, 36963305731326920, 230984115, 230984118, 3, 640x360 
0x12CB3460, 36963305731646504, 230984145, 230984147, 2, 640x360 
0x12CB3460, 36963305731967768, 230984176, 230984179, 3, 640x360 
0x12CB3460, 36963305732287144, 230984207, 230984215, 8, 640x360 
0x12CB3460, 36963305732767488, 230984256, 230984260, 4, 640x360 
0x12CB3460, 36963305733085528, 230984285, 230984288, 3, 640x360 
0x12CB3460, 36963305733405680, 230984316, 230984319, 3, 640x360 
0x12CB3460, 36963305733727104, 230984383, 230984392, 9, 640x360 
0x12CB3460, 36963305734372224, 230984416, 230984419, 3, 640x360 
0x12CB3460, 36963305734686680, 230984445, 230984448, 3, 640x360 
0x12CB3460, 36963305735006912, 230984475, 230984478, 3, 640x360 
0x12CB3460, 36963305735331144, 230984516, 230984518, 2, 640x360 
0x12CB3460, 36963305735647936, 230984545, 230984547, 2, 640x360 
0x12CB3460, 36963305735967824, 230984576, 230984578, 2, 640x360 
0x12CB3460, 36963305736288344, 230984605, 230984608, 3, 640x360 
0x12CB3460, 36963305736768696, 230984656, 230984660, 4, 640x360 
0x12CB3460, 36963305737086816, 230984686, 230984689, 3, 640x360 
0x12CB3460, 36963305737408752, 230984715, 230984719, 4, 640x360 
0x12CB3460, 36963305737726984, 230984755, 230984759, 4, 640x360 
0x12CB3460, 36963305738045928, 230984785, 230984787, 2, 640x360 
0x12CB3460, 36963305738367192, 230984816, 230984819, 3, 640x360 
0x12CB3460, 36963305738686584, 230984845, 230984848, 3, 640x360 
0x12CB3460, 36963305739067824, 230984885, 230984889, 4, 640x360 
0x12CB3460, 36963305739326776, 230984914, 230984917, 3, 640x360 
0x12CB3460, 36963305739646768, 230984945, 230984947, 2, 640x360 
0x12CB3460, 36963305739966616, 230984975, 230984978, 3, 640x360 
0x12CB3460, 36963305740448768, 230985025, 230985029, 4, 640x360 
0x12CB3460, 36963305740768112, 230985056, 230985060, 4, 640x360 
0x12CB3460, 36963305741086144, 230985085, 230985088, 3, 640x360 
0x12CB3460, 36963305741407688, 230985116, 230985118, 2, 640x360 
0x12CB3460, 36963305741728416, 230985155, 230985159, 4, 640x360 
0x12CB3460, 36963305742048280, 230985185, 230985190, 5, 640x360 
0x12CB3460, 36963305742369608, 230985215, 230985218, 3, 640x360 
0x12CB3460, 36963305742687664, 230985244, 230985247, 3, 640x360 
0x12CB3460, 36963305743006496, 230985276, 230985279, 3, 640x360 
0x12CB3460, 36963305743327048, 230985315, 230985318, 3, 640x360 
0x12CB3460, 36963305743647280, 230985345, 230985377, 32, 640x360 
0x12CB3460, 36963305744057264, 230985386, 230985392, 6, 640x360 
0x12CB3460, 36963305744448024, 230985425, 230985428, 3, 640x360 
0x12CB3460, 36963305744767672, 230985455, 230985458, 3, 640x360 
0x12CB3460, 36963305745087232, 230985486, 230985488, 2, 640x360 
0x12CB3460, 36963305745408592, 230985516, 230985518, 2, 640x360 
0x12CB3460, 36963305745726416, 230985556, 230985559, 3, 640x360 
0x12CB3460, 36963305746047656, 230985585, 230985587, 2, 640x360 
0x12CB3460, 36963305746368064, 230985616, 230985619, 3, 640x360 
0x12CB3460, 36963305746688672, 230985646, 230985649, 3, 640x360 
0x12CB3460, 36963305747009848, 230985676, 230985680, 4, 640x360 
0x12CB3460, 36963305747330736, 230985719, 230985723, 4, 640x360 
0x12CB3460, 36963305747648400, 230985745, 230985751, 6, 640x360 
0x12CB3460, 36963305747967544, 230985775, 230985778, 3, 640x360 
0x12CB3460, 36963305748447672, 230985825, 230985828, 3, 640x360 
0x12CB3460, 36963305748768032, 230985876, 230985879, 3, 640x360 
0x12CB3460, 36963305749086632, 230985885, 230985888, 3, 640x360 
0x12CB3460, 36963305749407296, 230985916, 230985919, 3, 640x360 
0x12CB3460, 36963305749725784, 230985946, 230985949, 3, 640x360 
0x12CB3460, 36963305750048128, 230985985, 230985998, 13, 640x360 
0x12CB3460, 36963305750368600, 230986016, 230986018, 2, 640x360 
0x12CB3460, 36963305750689000, 230986046, 230986049, 3, 640x360 
0x12CB3460, 36963305751007032, 230986075, 230986078, 3, 640x360 
0x12CB3460, 36963305751327056, 230986106, 230986110, 4, 640x360 
0x12CB3460, 36963305751647184, 230986146, 230986148, 2, 640x360 
0x12CB3460, 36963305752128776, 230986196, 230986201, 5, 640x360 
0x12CB3460, 36963305752447488, 230986226, 230986228, 2, 640x360 
0x12CB3460, 36963305752767632, 230986255, 230986259, 4, 640x360 
0x12CB3460, 36963305753086664, 230986286, 230986303, 17, 640x360 
0x12CB3460, 36963305753409656, 230986317, 230986320, 3, 640x360 
0x12CB3460, 36963305753728520, 230986381, 230986388, 7, 640x360 
0x12CB3460, 36963305754132136, 230986388, 230986396, 8, 640x360 
0x12CB3460, 36963305754366128, 230986416, 230986418, 2, 640x360 
0x12CB3460, 36963305754686280, 230986445, 230986448, 3, 640x360 
0x12CB3460, 36963305755007784, 230986476, 230986481, 5, 640x360 
0x12CB3460, 36963305755328248, 230986514, 230986517, 3, 640x360 
0x12CB3460, 36963305755647880, 230986545, 230986549, 4, 640x360 
0x12CB3460, 36963305756126904, 230986595, 230986598, 3, 640x360 
0x12CB3460, 36963305756448768, 230986625, 230986627, 2, 640x360 
0x12CB3460, 36963305756766560, 230986656, 230986659, 3, 640x360 
0x12CB3460, 36963305757095304, 230986687, 230986690, 3, 640x360 
0x12CB3460, 36963305757406656, 230986716, 230986718, 2, 640x360 
0x12CB3460, 36963305757727544, 230986755, 230986759, 4, 640x360 
0x12CB3460, 36963305758048632, 230986786, 230986798, 12, 640x360 
0x12CB3460, 36963305758366312, 230986817, 230986820, 3, 640x360 
0x12CB3460, 36963305758686432, 230986845, 230986882, 37, 640x360 
0x12CB3460, 36963305759115112, 230986887, 230986897, 10, 640x360 
0x12CB3460, 36963305759326264, 230986906, 230986911, 5, 640x360 
0x12CB3460, 36963305759648168, 230986947, 230986949, 2, 640x360 
0x12CB3460, 36963305760125928, 230986996, 230986999, 3, 640x360 
0x12CB3460, 36963305760447496, 230987026, 230987030, 4, 640x360 
0x12CB3460, 36963305760766600, 230987056, 230987064, 8, 640x360 
0x12CB3460, 36963305761089200, 230987086, 230987095, 9, 640x360 
0x12CB3460, 36963305761408304, 230987115, 230987118, 3, 640x360 
0x12CB3460, 36963305761726816, 230987156, 230987159, 3, 640x360 
0x12CB3460, 36963305762055984, 230987185, 230987187, 2, 640x360 
0x12CB3460, 36963305762369712, 230987216, 230987218, 2, 640x360 
0x12CB3460, 36963305762687464, 230987245, 230987247, 2, 640x360 
0x12CB3460, 36963305763006616, 230987276, 230987278, 2, 640x360 
0x12CB3460, 36963305763328784, 230987317, 230987320, 3, 640x360 
0x12CB3460, 36963305764131088, 230987395, 230987401, 6, 640x360 
0x12CB3460, 36963305764447832, 230987425, 230987432, 7, 640x360 
0x12CB3460, 36963305764767904, 230987455, 230987459, 4, 640x360 
0x12CB3460, 36963305765087168, 230987486, 230987488, 2, 640x360 
0x12CB3460, 36963305765409296, 230987516, 230987519, 3, 640x360 
0x12CB3460, 36963305765730096, 230987556, 230987562, 6, 640x360 
0x12CB3460, 36963305766046352, 230987585, 230987588, 3, 640x360 
0x12CB3460, 36963305766368112, 230987614, 230987617, 3, 640x360 
0x12CB3460, 36963305766688976, 230987646, 230987648, 2, 640x360 
0x12CB3460, 36963305767011368, 230987675, 230987680, 5, 640x360 
0x12CB3460, 36963305767332240, 230987716, 230987718, 2, 640x360 
0x12CB3460, 36963305767806880, 230987756, 230987759, 3, 640x360 
0x12CB3460, 36963305768128088, 230987795, 230987798, 3, 640x360 
0x12CB3460, 36963305768445944, 230987825, 230987828, 3, 640x360 
0x12CB3460, 36963305768766736, 230987866, 230987870, 4, 640x360 
0x12CB3460, 36963305769095120, 230987886, 230987889, 3, 640x360 
0x12CB3460, 36963305769406928, 230987915, 230987918, 3, 640x360 
0x12CB3460, 36963305769726432, 230987945, 230987948, 3, 640x360 
0x12CB3460, 36963305770048000, 230987985, 230987988, 3, 640x360 
0x12CB3460, 36963305770369136, 230988016, 230988022, 6, 640x360 
0x12CB3460, 36963305770687336, 230988046, 230988049, 3, 640x360 
0x12CB3460, 36963305771006984, 230988076, 230988078, 2, 640x360 
0x12CB3460, 36963305771487536, 230988125, 230988128, 3, 640x360 
0x12CB3460, 36963305771807120, 230988155, 230988158, 3, 640x360 
0x12CB3460, 36963305772127264, 230988186, 230988189, 3, 640x360 
0x12CB3460, 36963305772447080, 230988225, 230988227, 2, 640x360 
0x12CB3460, 36963305772767592, 230988255, 230988258, 3, 640x360 
0x12CB3460, 36963305773086472, 230988286, 230988288, 2, 640x360 
0x12CB3460, 36963305773409200, 230988316, 230988319, 3, 640x360 
0x12CB3460, 36963305773728160, 230988376, 230988380, 4, 640x360 
0x12CB3460, 36963305774046464, 230988387, 230988392, 5, 640x360 
0x12CB3460, 36963305774368424, 230988415, 230988417, 2, 640x360 
0x12CB3460, 36963305774687552, 230988445, 230988457, 12, 640x360 
0x12CB3460, 36963305775008432, 230988475, 230988478, 3, 640x360 
0x12CB3460, 36963305775489016, 230988527, 230988529, 2, 640x360 
0x12CB3460, 36963305775807480, 230988558, 230988561, 3, 640x360 
0x12CB3460, 36963305776128984, 230988587, 230988590, 3, 640x360 
0x12CB3460, 36963305776447024, 230988625, 230988628, 3, 640x360 
0x12CB3460, 36963305776770264, 230988656, 230988660, 4, 640x360 
0x12CB3460, 36963305777090024, 230988696, 230988701, 5, 640x360 
0x12CB3460, 36963305777408592, 230988716, 230988719, 3, 640x360 
0x12CB3460, 36963305777726976, 230988755, 230988759, 4, 640x360 
0x12CB3460, 36963305778046960, 230988785, 230988788, 3, 640x360 
0x12CB3460, 36963305778367560, 230988815, 230988818, 3, 640x360 
0x12CB3460, 36963305778686272, 230988845, 230988847, 2, 640x360 
0x12CB3460, 36963305779085664, 230988886, 230988889, 3, 640x360 
0x12CB3460, 36963305779486896, 230988925, 230988928, 3, 640x360 
0x12CB3460, 36963305779807136, 230988956, 230988958, 2, 640x360 
0x12CB3460, 36963305780126976, 230988987, 230988990, 3, 640x360 
0x12CB3460, 36963305780447720, 230989026, 230989028, 2, 640x360 
0x12CB3460, 36963305780768320, 230989055, 230989058, 3, 640x360 
0x12CB3460, 36963305781086552, 230989085, 230989088, 3, 640x360 
0x12CB3460, 36963305781407456, 230989115, 230989117, 2, 640x360 
0x12CB3460, 36963305781727952, 230989156, 230989159, 3, 640x360 
0x12CB3460, 36963305782048872, 230989185, 230989188, 3, 640x360 
0x12CB3460, 36963305782366632, 230989216, 230989220, 4, 640x360 
0x12CB3460, 36963305782686472, 230989245, 230989247, 2, 640x360 
0x12CB3460, 36963305783167096, 230989295, 230989298, 3, 640x360 
0x12CB3460, 36963305783485640, 230989326, 230989328, 2, 640x360 
0x12CB3460, 36963305783806544, 230989396, 230989402, 6, 640x360 
0x12CB3460, 36963305784213488, 230989405, 230989422, 17, 640x360 
0x12CB3460, 36963305784451816, 230989423, 230989432, 9, 640x360 
0x12CB3460, 36963305784765432, 230989457, 230989472, 15, 640x360 
0x12CB3460, 36963305785085368, 230989485, 230989494, 9, 640x360 
0x12CB3460, 36963305785410680, 230989516, 230989519, 3, 640x360 
0x12CB3460, 36963305785726464, 230989546, 230989549, 3, 640x360 
0x12CB3460, 36963305786049416, 230989586, 230989598, 12, 640x360 
0x12CB3460, 36963305786370464, 230989616, 230989623, 7, 640x360 
0x12CB3460, 36963305786687032, 230989645, 230989653, 8, 640x360 
0x12CB3460, 36963305787166208, 230989696, 230989708, 12, 640x360 
0x12CB3460, 36963305787485768, 230989725, 230989729, 4, 640x360 
0x12CB3460, 36963305787806080, 230989756, 230989758, 2, 640x360 
0x12CB3460, 36963305788128096, 230989795, 230989798, 3, 640x360 
0x12CB3460, 36963305788446624, 230989825, 230989827, 2, 640x360 
0x12CB3460, 36963305789008200, 230989878, 230989886, 8, 640x360 
0x12CB3460, 36963305789106632, 230989887, 230989892, 5, 640x360 
0x12CB3460, 36963305789405416, 230989916, 230989918, 2, 640x360 
0x12CB3460, 36963305789726752, 230989945, 230989949, 4, 640x360 
0x12CB3460, 36963305790047744, 230989985, 230989987, 2, 640x360 
0x12CB3460, 36963305790367984, 230990015, 230990018, 3, 640x360 
0x12CB3460, 36963305790687520, 230990046, 230990049, 3, 640x360 
0x12CB3460, 36963305791166720, 230990095, 230990098, 3, 640x360 
0x12CB3460, 36963305791485328, 230990125, 230990128, 3, 640x360 
0x12CB3460, 36963305791808304, 230990156, 230990159, 3, 640x360 
0x12CB3460, 36963305792127440, 230990195, 230990198, 3, 640x360 
0x12CB3460, 36963305792451304, 230990225, 230990232, 7, 640x360 
0x12CB3460, 36963305792765440, 230990255, 230990259, 4, 640x360 
0x12CB3460, 36963305793085784, 230990285, 230990288, 3, 640x360 
0x12CB3460, 36963305793407368, 230990315, 230990318, 3, 640x360 
0x12CB3460, 36963305793726272, 230990389, 230990393, 4, 640x360 
0x12CB3460, 36963305794201552, 230990399, 230990403, 4, 640x360 
0x12CB3460, 36963305794372000, 230990416, 230990418, 2, 640x360 
0x12CB3460, 36963305794845408, 230990465, 230990467, 2, 640x360 
0x12CB3460, 36963305795168032, 230990495, 230990498, 3, 640x360 
0x12CB3460, 36963305795487232, 230990525, 230990527, 2, 640x360 
0x12CB3460, 36963305795806080, 230990556, 230990559, 3, 640x360 
0x12CB3460, 36963305796125784, 230990595, 230990598, 3, 640x360 
0x12CB3460, 36963305796446328, 230990625, 230990627, 2, 640x360 
0x12CB3460, 36963305796767576, 230990656, 230990658, 2, 640x360 
0x12CB3460, 36963305797086352, 230990685, 230990687, 2, 640x360 
0x12CB3460, 36963305797407432, 230990716, 230990722, 6, 640x360 
0x12CB3460, 36963305797725408, 230990755, 230990759, 4, 640x360 
0x12CB3460, 36963305798047296, 230990785, 230990787, 2, 640x360 
0x12CB3460, 36963305798367160, 230990816, 230990818, 2, 640x360 
0x12CB3460, 36963305799006184, 230990886, 230990892, 6, 640x360 
0x12CB3460, 36963305799168984, 230990895, 230990897, 2, 640x360 
0x12CB3460, 36963305799487128, 230990925, 230990928, 3, 640x360 
0x12CB3460, 36963305799807848, 230990957, 230990960, 3, 640x360 
0x12CB3460, 36963305800126024, 230990995, 230990997, 2, 640x360 
0x12CB3460, 36963305800447128, 230991025, 230991028, 3, 640x360 
0x12CB3460, 36963305800766808, 230991055, 230991059, 4, 640x360 
0x12CB3460, 36963305801085656, 230991086, 230991088, 2, 640x360 
0x12CB3460, 36963305801406600, 230991116, 230991119, 3, 640x360 
0x12CB3460, 36963305801726328, 230991155, 230991158, 3, 640x360 
0x12CB3460, 36963305802045904, 230991185, 230991188, 3, 640x360 
0x12CB3460, 36963305802524880, 230991235, 230991237, 2, 640x360 
0x12CB3460, 36963305802845568, 230991265, 230991268, 3, 640x360 
0x12CB3460, 36963305803167208, 230991295, 230991298, 3, 640x360 
0x12CB3460, 36963305803486656, 230991325, 230991328, 3, 640x360 
0x12CB3460, 36963305804026072, 230991375, 230991378, 3, 640x360 
0x12CB3460, 36963305804130176, 230991387, 230991392, 5, 640x360 
0x12CB3460, 36963305804446072, 230991425, 230991428, 3, 640x360 
0x12CB3460, 36963305804767304, 230991455, 230991458, 3, 640x360 
0x12CB3460, 36963305805086928, 230991485, 230991489, 4, 640x360 
0x12CB3460, 36963305805409600, 230991517, 230991520, 3, 640x360 
0x12CB3460, 36963305805729008, 230991556, 230991562, 6, 640x360 
0x12CB3460, 36963305806046576, 230991584, 230991587, 3, 640x360 
0x12CB3460, 36963305806527560, 230991635, 230991638, 3, 640x360 
0x12CB3460, 36963305806845960, 230991665, 230991668, 3, 640x360 
0x12CB3460, 36963305807168864, 230991697, 230991700, 3, 640x360 
0x12CB3460, 36963305807491392, 230991725, 230991728, 3, 640x360 
0x12CB3460, 36963305807806608, 230991755, 230991758, 3, 640x360 
0x12CB3460, 36963305808127520, 230991786, 230991789, 3, 640x360 
0x12CB3460, 36963305808446152, 230991825, 230991828, 3, 640x360 
0x12CB3460, 36963305808765840, 230991878, 230991882, 4, 640x360 
0x12CB3460, 36963305809111608, 230991886, 230991890, 4, 640x360 
0x12CB3460, 36963305809405824, 230991916, 230991918, 2, 640x360 
0x12CB3460, 36963305809726960, 230991946, 230991949, 3, 640x360 
0x12CB3460, 36963305810046464, 230991986, 230991988, 2, 640x360 
0x12CB3460, 36963305810527232, 230992026, 230992029, 3, 640x360 
0x12CB3460, 36963305810846024, 230992065, 230992068, 3, 640x360 
0x12CB3460, 36963305811165744, 230992095, 230992097, 2, 640x360 
0x12CB3460, 36963305811486960, 230992125, 230992127, 2, 640x360 
0x12CB3460, 36963305811806704, 230992155, 230992157, 2, 640x360 
0x12CB3460, 36963305812126352, 230992195, 230992198, 3, 640x360 
0x12CB3460, 36963305812446432, 230992225, 230992228, 3, 640x360 
0x12CB3460, 36963305812766800, 230992256, 230992259, 3, 640x360 
0x12CB3460, 36963305813087040, 230992285, 230992288, 3, 640x360 
0x12CB3460, 36963305813408216, 230992314, 230992318, 4, 640x360 
0x12CB3460, 36963305813727160, 230992355, 230992382, 27, 640x360 
0x12CB3460, 36963305814207728, 230992396, 230992399, 3, 640x360 
0x12CB3460, 36963305814525496, 230992435, 230992438, 3, 640x360 
0x12CB3460, 36963305814847160, 230992465, 230992467, 2, 640x360 
0x12CB3460, 36963305815168928, 230992496, 230992498, 2, 640x360 
0x12CB3460, 36963305815491472, 230992528, 230992531, 3, 640x360 
0x12CB3460, 36963305815809184, 230992556, 230992559, 3, 640x360 
0x12CB3460, 36963305816128000, 230992586, 230992589, 3, 640x360 
0x12CB3460, 36963305816446680, 230992624, 230992627, 3, 640x360 
0x12CB3460, 36963305816769392, 230992657, 230992660, 3, 640x360 
0x12CB3460, 36963305817087512, 230992686, 230992689, 3, 640x360 
0x12CB3460, 36963305817411280, 230992726, 230992729, 3, 640x360 
0x12CB3460, 36963305817726200, 230992755, 230992759, 4, 640x360 
0x12CB3460, 36963305818207696, 230992796, 230992799, 3, 640x360 
0x12CB3460, 36963305818527088, 230992835, 230992838, 3, 640x360 
0x12CB3460, 36963305818981608, 230992875, 230992878, 3, 640x360 
0x12CB3460, 36963305819167080, 230992895, 230992898, 3, 640x360 
0x12CB3460, 36963305819485592, 230992925, 230992927, 2, 640x360 
0x12CB3460, 36963305819806432, 230992955, 230992959, 4, 640x360 
0x12CB3460, 36963305820127496, 230992996, 230992998, 2, 640x360 
0x12CB3460, 36963305820447600, 230993026, 230993028, 2, 640x360 
0x12CB3460, 36963305820767384, 230993056, 230993058, 2, 640x360 
0x12CB3460, 36963305821091520, 230993086, 230993089, 3, 640x360 
0x12CB3460, 36963305821405704, 230993115, 230993118, 3, 640x360 
0x12CB3460, 36963305821726440, 230993146, 230993149, 3, 640x360 
0x12CB3460, 36963305822210248, 230993205, 230993209, 4, 640x360 
0x12CB3460, 36963305822525632, 230993235, 230993237, 2, 640x360 
0x12CB3460, 36963305822846384, 230993264, 230993267, 3, 640x360 
0x12CB3460, 36963305823167832, 230993296, 230993298, 2, 640x360 
0x12CB3460, 36963305823488168, 230993325, 230993329, 4, 640x360 
0x12CB3460, 36963305823806608, 230993391, 230993394, 3, 640x360 
0x12CB3460, 36963305824446176, 230993425, 230993428, 3, 640x360 
0x12CB3460, 36963305824765672, 230993455, 230993458, 3, 640x360 
0x12CB3460, 36963305825087536, 230993485, 230993488, 3, 640x360 
0x12CB3460, 36963305825407256, 230993515, 230993518, 3, 640x360 
0x12CB3460, 36963305825885944, 230993566, 230993569, 3, 640x360 
0x12CB3460, 36963305826205264, 230993604, 230993607, 3, 640x360 
0x12CB3460, 36963305826526064, 230993635, 230993638, 3, 640x360 
0x12CB3460, 36963305826848048, 230993665, 230993668, 3, 640x360 
0x12CB3460, 36963305827166616, 230993696, 230993698, 2, 640x360 
0x12CB3460, 36963305827485608, 230993725, 230993728, 3, 640x360 
0x12CB3460, 36963305827806432, 230993755, 230993758, 3, 640x360 
0x12CB3460, 36963305828126648, 230993795, 230993800, 5, 640x360 
0x12CB3460, 36963305828445432, 230993827, 230993830, 3, 640x360 
0x12CB3460, 36963305828766424, 230993876, 230993893, 17, 640x360 
0x12CB3460, 36963305829092640, 230993893, 230993908, 15, 640x360 
0x12CB3460, 36963305829406656, 230993915, 230993919, 4, 640x360 
0x12CB3460, 36963305829889432, 230993966, 230993973, 7, 640x360 
0x12CB3460, 36963305830206488, 230993995, 230994012, 17, 640x360 
0x12CB3460, 36963305830530208, 230994036, 230994048, 12, 640x360 
0x12CB3460, 36963305830846192, 230994066, 230994071, 5, 640x360 
0x12CB3460, 36963305831166544, 230994097, 230994102, 5, 640x360 
0x12CB3460, 36963305831485904, 230994125, 230994128, 3, 640x360 
0x12CB3460, 36963305831806520, 230994157, 230994175, 18, 640x360 
0x12CB3460, 36963305832125552, 230994186, 230994190, 4, 640x360 
0x12CB3460, 36963305832445992, 230994225, 230994230, 5, 640x360 
0x12CB3460, 36963305832765528, 230994254, 230994257, 3, 640x360 
0x12CB3460, 36963305833087624, 230994285, 230994288, 3, 640x360 
0x12CB3460, 36963305833407696, 230994316, 230994319, 3, 640x360 
0x12CB3460, 36963305834060752, 230994385, 230994388, 3, 640x360 
0x12CB3460, 36963305834206952, 230994395, 230994398, 3, 640x360 
0x12CB3460, 36963305834527160, 230994434, 230994437, 3, 640x360 
0x12CB3460, 36963305834846248, 230994465, 230994468, 3, 640x360 
0x12CB3460, 36963305835168480, 230994495, 230994498, 3, 640x360 
0x12CB3460, 36963305835487200, 230994526, 230994528, 2, 640x360 
0x12CB3460, 36963305835806472, 230994556, 230994560, 4, 640x360 
0x12CB3460, 36963305836126152, 230994586, 230994589, 3, 640x360 
0x12CB3460, 36963305836447368, 230994626, 230994628, 2, 640x360 
0x12CB3460, 36963305836767792, 230994656, 230994659, 3, 640x360 
0x12CB3460, 36963305837089312, 230994686, 230994689, 3, 640x360 
0x12CB3460, 36963305837567184, 230994735, 230994737, 2, 640x360 
0x12CB3460, 36963305837886976, 230994766, 230994768, 2, 640x360 
0x12CB3460, 36963305838207640, 230994796, 230994798, 2, 640x360 
0x12CB3460, 36963305838525608, 230994826, 230994830, 4, 640x360 
0x12CB3460, 36963305839117224, 230994896, 230994903, 7, 640x360 
0x12CB3460, 36963305839485136, 230994925, 230994928, 3, 640x360 
0x12CB3460, 36963305839805312, 230994956, 230994961, 5, 640x360 
0x12CB3460, 36963305840127064, 230994995, 230995007, 12, 640x360 
0x12CB3460, 36963305840766440, 230995056, 230995066, 10, 640x360 
0x12CB3460, 36963305841095040, 230995087, 230995101, 14, 640x360 
0x12CB3460, 36963305841565944, 230995136, 230995150, 14, 640x360 
0x12CB3460, 36963305841889104, 230995166, 230995174, 8, 640x360 
0x12CB3460, 36963305842206864, 230995195, 230995199, 4, 640x360 
0x12CB3460, 36963305842531376, 230995235, 230995249, 14, 640x360 
0x12CB3460, 36963305842846216, 230995266, 230995270, 4, 640x360 
0x12CB3460, 36963305843165400, 230995296, 230995300, 4, 640x360 
0x12CB3460, 36963305843487760, 230995325, 230995328, 3, 640x360 
0x12CB3460, 36963305844029400, 230995385, 230995389, 4, 640x360 
0x12CB3460, 36963305844128040, 230995395, 230995397, 2, 640x360 
0x12CB3460, 36963305844447784, 230995425, 230995428, 3, 640x360 
0x12CB3460, 36963305844765640, 230995456, 230995459, 3, 640x360 
0x12CB3460, 36963305845245104, 230995507, 230995512, 5, 640x360 
0x12CB3460, 36963305845566456, 230995536, 230995539, 3, 640x360 
0x12CB3460, 36963305845887160, 230995565, 230995568, 3, 640x360 
0x12CB3460, 36963305846206672, 230995595, 230995598, 3, 640x360 
0x12CB3460, 36963305846526720, 230995635, 230995637, 2, 640x360 
0x12CB3460, 36963305846846336, 230995666, 230995668, 2, 640x360 
0x12CB3460, 36963305847167552, 230995695, 230995698, 3, 640x360 
0x12CB3460, 36963305847492360, 230995726, 230995728, 2, 640x360 
0x12CB3460, 36963305847806776, 230995757, 230995762, 5, 640x360 
0x12CB3460, 36963305848125288, 230995794, 230995797, 3, 640x360 
0x12CB3460, 36963305848445936, 230995825, 230995827, 2, 640x360 
0x12CB3460, 36963305849012760, 230995876, 230995880, 4, 640x360 
0x12CB3460, 36963305849246576, 230995906, 230995910, 4, 640x360 
0x12CB3460, 36963305849566976, 230995936, 230995938, 2, 640x360 
0x12CB3460, 36963305849886624, 230995965, 230995968, 3, 640x360 
0x12CB3460, 36963305850207176, 230995995, 230995998, 3, 640x360 
0x12CB3460, 36963305850527976, 230996035, 230996037, 2, 640x360 
0x12CB3460, 36963305850846600, 230996066, 230996069, 3, 640x360 
0x12CB3460, 36963305851166216, 230996095, 230996097, 2, 640x360 
0x12CB3460, 36963305851485352, 230996125, 230996128, 3, 640x360 
0x12CB3460, 36963305851816872, 230996165, 230996168, 3, 640x360 
0x12CB3460, 36963305852130032, 230996195, 230996198, 3, 640x360 
0x12CB3460, 36963305852474896, 230996227, 230996233, 6, 640x360 
0x12CB3460, 36963305852765880, 230996254, 230996258, 4, 640x360 
0x12CB3460, 36963305853244520, 230996305, 230996308, 3, 640x360 
0x12CB3460, 36963305853566600, 230996335, 230996338, 3, 640x360 
0x12CB3460, 36963305854280688, 230996415, 230996417, 2, 640x360 
0x12CB3460, 36963305854526808, 230996435, 230996438, 3, 640x360 
0x12CB3460, 36963305854865240, 230996464, 230996467, 3, 640x360 
0x12CB3460, 36963305855165640, 230996495, 230996498, 3, 640x360 
0x12CB3460, 36963305855486128, 230996525, 230996527, 2, 640x360 
0x12CB3460, 36963305855807872, 230996565, 230996569, 4, 640x360 
0x12CB3460, 36963305856126680, 230996595, 230996597, 2, 640x360 
0x12CB3460, 36963305856924728, 230996667, 230996670, 3, 640x360 
0x12CB3460, 36963305857245408, 230996704, 230996707, 3, 640x360 
0x12CB3460, 36963305857565248, 230996736, 230996739, 3, 640x360 
0x12CB3460, 36963305857885568, 230996765, 230996768, 3, 640x360 
0x12CB3460, 36963305858206864, 230996796, 230996799, 3, 640x360 
0x12CB3460, 36963305858526128, 230996826, 230996830, 4, 640x360 
0x12CB3460, 36963305858971888, 230996875, 230996878, 3, 640x360 
0x12CB3460, 36963305859166088, 230996895, 230996897, 2, 640x360 
0x12CB3460, 36963305859485864, 230996925, 230996928, 3, 640x360 
0x12CB3460, 36963305859805376, 230996955, 230996960, 5, 640x360 
0x12CB3460, 36963305860130648, 230996995, 230996998, 3, 640x360 
0x12CB3460, 36963305860461552, 230997027, 230997038, 11, 640x360 
0x12CB3460, 36963305860929248, 230997076, 230997078, 2, 640x360 
0x12CB3460, 36963305861247808, 230997105, 230997108, 3, 640x360 
0x12CB3460, 36963305861565696, 230997135, 230997138, 3, 640x360 
0x12CB3460, 36963305861885968, 230997166, 230997169, 3, 640x360 
0x12CB3460, 36963305862205696, 230997195, 230997198, 3, 640x360 
0x12CB3460, 36963305862526824, 230997226, 230997230, 4, 640x360 
0x12CB3460, 36963305862847392, 230997265, 230997268, 3, 640x360 
0x12CB3460, 36963305863167856, 230997294, 230997297, 3, 640x360 
0x12CB3460, 36963305863486936, 230997325, 230997327, 2, 640x360 
0x12CB3460, 36963305863979056, 230997375, 230997379, 4, 640x360 
0x12CB3460, 36963305864128904, 230997395, 230997397, 2, 640x360 
0x12CB3460, 36963305864445912, 230997426, 230997428, 2, 640x360 
0x12CB3460, 36963305864925984, 230997475, 230997478, 3, 640x360 
0x12CB3460, 36963305865247152, 230997506, 230997509, 3, 640x360 
0x12CB3460, 36963305865568040, 230997536, 230997538, 2, 640x360 
0x12CB3460, 36963305865890144, 230997565, 230997569, 4, 640x360 
0x12CB3460, 36963305866205232, 230997596, 230997598, 2, 640x360 
0x12CB3460, 36963305866525088, 230997636, 230997640, 4, 640x360 
0x12CB3460, 36963305866846848, 230997665, 230997668, 3, 640x360 
0x12CB3460, 36963305867171088, 230997695, 230997698, 3, 640x360 
0x12CB3460, 36963305867485944, 230997726, 230997729, 3, 640x360 
0x12CB3460, 36963305867807064, 230997756, 230997759, 3, 640x360 
0x12CB3460, 36963305868125896, 230997796, 230997798, 2, 640x360 
0x12CB3460, 36963305868605272, 230997837, 230997841, 4, 640x360 
0x12CB3460, 36963305869085112, 230997897, 230997901, 4, 640x360 
0x12CB3460, 36963305869249384, 230997907, 230997917, 10, 640x360 
0x12CB3460, 36963305869566944, 230997935, 230997938, 3, 640x360 
0x12CB3460, 36963305869887968, 230997965, 230997967, 2, 640x360 
0x12CB3460, 36963305870206888, 230997996, 230997998, 2, 640x360 
0x12CB3460, 36963305870527520, 230998035, 230998038, 3, 640x360 
0x12CB3460, 36963305870848704, 230998066, 230998070, 4, 640x360 
0x12CB3460, 36963305871165304, 230998095, 230998098, 3, 640x360 
0x12CB3460, 36963305871486608, 230998125, 230998127, 2, 640x360 
0x12CB3460, 36963305871807448, 230998156, 230998159, 3, 640x360 
0x12CB3460, 36963305872127888, 230998195, 230998198, 3, 640x360 
0x12CB3460, 36963305872606144, 230998236, 230998253, 17, 640x360 
0x12CB3460, 36963305872925824, 230998265, 230998269, 4, 640x360 
0x12CB3460, 36963305873245120, 230998305, 230998308, 3, 640x360 
0x12CB3460, 36963305873565104, 230998335, 230998337, 2, 640x360 
0x12CB3460, 36963305873987192, 230998376, 230998379, 3, 640x360 
0x12CB3460, 36963305874205232, 230998395, 230998397, 2, 640x360 
0x12CB3460, 36963305874528264, 230998435, 230998439, 4, 640x360 
0x12CB3460, 36963305874854960, 230998466, 230998469, 3, 640x360 
0x12CB3460, 36963305875172384, 230998496, 230998499, 3, 640x360 
0x12CB3460, 36963305875485504, 230998525, 230998528, 3, 640x360 
0x12CB3460, 36963305875807632, 230998556, 230998565, 9, 640x360 
0x12CB3460, 36963305876132552, 230998596, 230998598, 2, 640x360 
0x12CB3460, 36963305876611904, 230998637, 230998640, 3, 640x360 
0x12CB3460, 36963305876924936, 230998666, 230998670, 4, 640x360 
0x12CB3460, 36963305877246888, 230998707, 230998713, 6, 640x360 
0x12CB3460, 36963305877565088, 230998734, 230998737, 3, 640x360 
0x12CB3460, 36963305877885048, 230998765, 230998768, 3, 640x360 
0x12CB3460, 36963305878205192, 230998794, 230998798, 4, 640x360 
0x12CB3460, 36963305878525208, 230998826, 230998829, 3, 640x360 
0x12CB3460, 36963305878983848, 230998875, 230998879, 4, 640x360 
0x12CB3460, 36963305879167432, 230998895, 230998898, 3, 640x360 
0x12CB3460, 36963305879485064, 230998926, 230998928, 2, 640x360 
0x12CB3460, 36963305879805768, 230998956, 230998959, 3, 640x360 
0x12CB3460, 36963305880286232, 230999006, 230999009, 3, 640x360 
0x12CB3460, 36963305880604880, 230999035, 230999038, 3, 640x360 
0x12CB3460, 36963305880925664, 230999066, 230999069, 3, 640x360 
0x12CB3460, 36963305881246680, 230999106, 230999109, 3, 640x360 
0x12CB3460, 36963305881566624, 230999134, 230999137, 3, 640x360 
0x12CB3460, 36963305881885656, 230999167, 230999172, 5, 640x360 
0x12CB3460, 36963305882206080, 230999195, 230999198, 3, 640x360 
0x12CB3460, 36963305882524616, 230999235, 230999238, 3, 640x360 
0x12CB3460, 36963305882844736, 230999265, 230999268, 3, 640x360 
0x12CB3460, 36963305883166312, 230999295, 230999297, 2, 640x360 
0x12CB3460, 36963305883485008, 230999325, 230999328, 3, 640x360 
0x12CB3460, 36963305884021952, 230999375, 230999378, 3, 640x360 
0x12CB3460, 36963305884286736, 230999406, 230999412, 6, 640x360 
0x12CB3460, 36963305884605032, 230999436, 230999443, 7, 640x360 
0x12CB3460, 36963305884926088, 230999466, 230999470, 4, 640x360 
0x12CB3460, 36963305885247496, 230999506, 230999510, 4, 640x360 
0x12CB3460, 36963305885567264, 230999535, 230999538, 3, 640x360 
0x12CB3460, 36963305885886168, 230999565, 230999568, 3, 640x360 
0x12CB3460, 36963305886208832, 230999596, 230999598, 2, 640x360 
0x12CB3460, 36963305886526016, 230999635, 230999638, 3, 640x360 
0x12CB3460, 36963305886845928, 230999665, 230999668, 3, 640x360 
0x12CB3460, 36963305887167624, 230999695, 230999698, 3, 640x360 
0x12CB3460, 36963305887493616, 230999736, 230999740, 4, 640x360 
0x12CB3460, 36963305887965464, 230999775, 230999779, 4, 640x360 
0x12CB3460, 36963305888286072, 230999805, 230999809, 4, 640x360 
0x12CB3460, 36963305888612008, 230999835, 230999840, 5, 640x360 
0x12CB3460, 36963305889045584, 230999885, 230999894, 9, 640x360 
0x12CB3460, 36963305889245168, 230999906, 230999911, 5, 640x360 
0x12CB3460, 36963305889566104, 230999934, 230999937, 3, 640x360 
0x12CB3460, 36963305889886624, 230999966, 230999968, 2, 640x360 
0x12CB3460, 36963305890207048, 230999995, 230999998, 3, 640x360 
0x12CB3460, 36963305890527024, 231000035, 231000038, 3, 640x360 
0x12CB3460, 36963305890846768, 231000066, 231000070, 4, 640x360 
0x12CB3460, 36963305891168000, 231000095, 231000098, 3, 640x360 
0x12CB3460, 36963305891486968, 231000124, 231000127, 3, 640x360 
0x12CB3460, 36963305891970584, 231000175, 231000178, 3, 640x360 
0x12CB3460, 36963305892284928, 231000205, 231000212, 7, 640x360 
0x12CB3460, 36963305892604696, 231000236, 231000239, 3, 640x360 
0x12CB3460, 36963305892926104, 231000276, 231000278, 2, 640x360 
0x12CB3460, 36963305893245536, 231000304, 231000308, 4, 640x360 
0x12CB3460, 36963305893566040, 231000336, 231000338, 2, 640x360 
0x12CB3460, 36963305894046648, 231000385, 231000389, 4, 640x360 
0x12CB3460, 36963305894207064, 231000396, 231000399, 3, 640x360 
0x12CB3460, 36963305894526080, 231000435, 231000438, 3, 640x360 
0x12CB3460, 36963305894848368, 231000465, 231000468, 3, 640x360 
0x12CB3460, 36963305895165832, 231000496, 231000498, 2, 640x360 
0x12CB3460, 36963305895487616, 231000525, 231000528, 3, 640x360 
0x12CB3460, 36963305895966088, 231000575, 231000578, 3, 640x360 
0x12CB3460, 36963305896286000, 231000605, 231000608, 3, 640x360 
0x12CB3460, 36963305896605448, 231000636, 231000638, 2, 640x360 
0x12CB3460, 36963305896925968, 231000676, 231000679, 3, 640x360 
0x12CB3460, 36963305897247416, 231000707, 231000712, 5, 640x360 
0x12CB3460, 36963305897567232, 231000734, 231000738, 4, 640x360 
0x12CB3460, 36963305897884888, 231000765, 231000768, 3, 640x360 
0x12CB3460, 36963305898205424, 231000795, 231000798, 3, 640x360 
0x12CB3460, 36963305898525784, 231000835, 231000838, 3, 640x360 
0x12CB3460, 36963305899078656, 231000885, 231000890, 5, 640x360 
0x12CB3460, 36963305899169160, 231000895, 231000898, 3, 640x360 
0x12CB3460, 36963305899644952, 231000946, 231000948, 2, 640x360 
0x12CB3460, 36963305899964856, 231000975, 231000978, 3, 640x360 
0x12CB3460, 36963305900285264, 231001007, 231001011, 4, 640x360 
0x12CB3460, 36963305900604816, 231001036, 231001039, 3, 640x360 
0x12CB3460, 36963305900928096, 231001066, 231001074, 8, 640x360 
0x12CB3460, 36963305901246592, 231001105, 231001109, 4, 640x360 
0x12CB3460, 36963305901565360, 231001134, 231001137, 3, 640x360 
0x12CB3460, 36963305901886208, 231001165, 231001167, 2, 640x360 
0x12CB3460, 36963305902205688, 231001196, 231001199, 3, 640x360 
0x12CB3460, 36963305902525576, 231001235, 231001237, 2, 640x360 
0x12CB3460, 36963305902845824, 231001265, 231001269, 4, 640x360 
0x12CB3460, 36963305903167528, 231001295, 231001297, 2, 640x360 
0x12CB3460, 36963305903650264, 231001345, 231001379, 34, 640x360 
0x12CB3460, 36963305904075720, 231001386, 231001390, 4, 640x360 
0x12CB3460, 36963305904284464, 231001405, 231001409, 4, 640x360 
0x12CB3460, 36963305904608592, 231001436, 231001439, 3, 640x360 
0x12CB3460, 36963305904925896, 231001466, 231001469, 3, 640x360 
0x12CB3460, 36963305905245144, 231001506, 231001512, 6, 640x360 
0x12CB3460, 36963305905566192, 231001535, 231001538, 3, 640x360 
0x12CB3460, 36963305905884784, 231001565, 231001568, 3, 640x360 
0x12CB3460, 36963305906205864, 231001595, 231001598, 3, 640x360 
0x12CB3460, 36963305906525816, 231001635, 231001637, 2, 640x360 
0x12CB3460, 36963305906845616, 231001666, 231001668, 2, 640x360 
0x12CB3460, 36963305907167416, 231001696, 231001700, 4, 640x360 
0x12CB3460, 36963305907645664, 231001745, 231001748, 3, 640x360 
0x12CB3460, 36963305907965408, 231001776, 231001779, 3, 640x360 
0x12CB3460, 36963305908286296, 231001805, 231001809, 4, 640x360 
0x12CB3460, 36963305908607736, 231001837, 231001840, 3, 640x360 
0x12CB3460, 36963305909086000, 231001886, 231001889, 3, 640x360 
0x12CB3460, 36963305909248968, 231001904, 231001908, 4, 640x360 
0x12CB3460, 36963305909564664, 231001935, 231001938, 3, 640x360 
0x12CB3460, 36963305909885008, 231001965, 231001967, 2, 640x360 
0x12CB3460, 36963305910206776, 231001996, 231001999, 3, 640x360 
0x12CB3460, 36963305910525400, 231002026, 231002029, 3, 640x360 
0x12CB3460, 36963305910846240, 231002066, 231002068, 2, 640x360 
0x12CB3460, 36963305911326368, 231002115, 231002118, 3, 640x360 
0x12CB3460, 36963305911646416, 231002146, 231002149, 3, 640x360 
0x12CB3460, 36963305911965744, 231002176, 231002179, 3, 640x360 
0x12CB3460, 36963305912288024, 231002207, 231002210, 3, 640x360 
0x12CB3460, 36963305912605328, 231002236, 231002239, 3, 640x360 
0x12CB3460, 36963305912926072, 231002275, 231002278, 3, 640x360 
0x12CB3460, 36963305913245624, 231002305, 231002308, 3, 640x360 
0x12CB3460, 36963305913565888, 231002335, 231002338, 3, 640x360 
0x12CB3460, 36963305914047936, 231002385, 231002390, 5, 640x360 
0x12CB3460, 36963305914205264, 231002396, 231002400, 4, 640x360 
0x12CB3460, 36963305914525120, 231002435, 231002437, 2, 640x360 
0x12CB3460, 36963305914847192, 231002464, 231002467, 3, 640x360 
0x12CB3460, 36963305915326056, 231002508, 231002510, 2, 640x360 
0x12CB3460, 36963305915647944, 231002544, 231002547, 3, 640x360 
0x12CB3460, 36963305915968640, 231002575, 231002578, 3, 640x360 
0x12CB3460, 36963305916285928, 231002605, 231002607, 2, 640x360 
0x12CB3460, 36963305916605472, 231002635, 231002638, 3, 640x360 
0x12CB3460, 36963305916929824, 231002676, 231002679, 3, 640x360 
0x12CB3460, 36963305917247472, 231002705, 231002709, 4, 640x360 
0x12CB3460, 36963305917569176, 231002735, 231002740, 5, 640x360 
0x12CB3460, 36963305917912840, 231002766, 231002774, 8, 640x360 
0x12CB3460, 36963305918206264, 231002796, 231002799, 3, 640x360 
0x12CB3460, 36963305918526072, 231002826, 231002831, 5, 640x360 
0x12CB3460, 36963305919013992, 231002876, 231002881, 5, 640x360 
0x12CB3460, 36963305919325992, 231002915, 231002918, 3, 640x360 
0x12CB3460, 36963305919646640, 231002946, 231002949, 3, 640x360 
0x12CB3460, 36963305919967200, 231002976, 231002978, 2, 640x360 
0x12CB3460, 36963305920286216, 231003005, 231003009, 4, 640x360 
0x12CB3460, 36963305920607016, 231003036, 231003039, 3, 640x360 
0x12CB3460, 36963305920925848, 231003066, 231003069, 3, 640x360 
0x12CB3460, 36963305921245240, 231003105, 231003109, 4, 640x360 
0x12CB3460, 36963305921566288, 231003135, 231003137, 2, 640x360 
0x12CB3460, 36963305921885272, 231003165, 231003168, 3, 640x360 
0x12CB3460, 36963305922205544, 231003195, 231003198, 3, 640x360 
0x12CB3460, 36963305922525248, 231003226, 231003233, 7, 640x360 
0x12CB3460, 36963305923005872, 231003275, 231003278, 3, 640x360 
0x12CB3460, 36963305923325448, 231003306, 231003311, 5, 640x360 
0x12CB3460, 36963305923645848, 231003364, 231003371, 7, 640x360 
0x12CB3460, 36963305924002504, 231003376, 231003379, 3, 640x360 
0x12CB3460, 36963305924285504, 231003406, 231003411, 5, 640x360 
0x12CB3460, 36963305924604792, 231003436, 231003439, 3, 640x360 
0x12CB3460, 36963305924925608, 231003476, 231003482, 6, 640x360 
0x12CB3460, 36963305925265640, 231003505, 231003510, 5, 640x360 
0x12CB3460, 36963305925566128, 231003536, 231003539, 3, 640x360 
0x12CB3460, 36963305925886112, 231003565, 231003568, 3, 640x360 
0x12CB3460, 36963305926205704, 231003596, 231003598, 2, 640x360 
0x12CB3460, 36963305926526984, 231003635, 231003638, 3, 640x360 
0x12CB3460, 36963305927005920, 231003676, 231003682, 6, 640x360 
0x12CB3460, 36963305927325864, 231003716, 231003718, 2, 640x360 
0x12CB3460, 36963305927650464, 231003744, 231003747, 3, 640x360 
0x12CB3460, 36963305927966120, 231003775, 231003778, 3, 640x360 
0x12CB3460, 36963305928285856, 231003804, 231003808, 4, 640x360 
0x12CB3460, 36963305928604560, 231003836, 231003838, 2, 640x360 
0x12CB3460, 36963305929068104, 231003885, 231003888, 3, 640x360 
0x12CB3460, 36963305929244920, 231003905, 231003907, 2, 640x360 
0x12CB3460, 36963305929566040, 231003935, 231003938, 3, 640x360 
0x12CB3460, 36963305929886112, 231003965, 231003968, 3, 640x360 
0x12CB3460, 36963305930207512, 231003995, 231004000, 5, 640x360 
0x12CB3460, 36963305930686008, 231004045, 231004048, 3, 640x360 
0x12CB3460, 36963305931004592, 231004076, 231004079, 3, 640x360 
0x12CB3460, 36963305931325912, 231004105, 231004110, 5, 640x360 
0x12CB3460, 36963305931648168, 231004145, 231004147, 2, 640x360 
0x12CB3460, 36963305931965944, 231004175, 231004186, 11, 640x360 
0x12CB3460, 36963305932286352, 231004205, 231004209, 4, 640x360 
0x12CB3460, 36963305932604736, 231004236, 231004239, 3, 640x360 
0x12CB3460, 36963305932924504, 231004276, 231004278, 2, 640x360 
0x12CB3460, 36963305933246424, 231004306, 231004309, 3, 640x360 
0x12CB3460, 36963305933567232, 231004336, 231004340, 4, 640x360 
0x12CB3460, 36963305934046488, 231004386, 231004389, 3, 640x360 
0x12CB3460, 36963305934205264, 231004395, 231004399, 4, 640x360 
0x12CB3460, 36963305934684672, 231004445, 231004448, 3, 640x360 
0x12CB3460, 36963305935006288, 231004475, 231004478, 3, 640x360 
0x12CB3460, 36963305935326536, 231004515, 231004518, 3, 640x360 
0x12CB3460, 36963305935646944, 231004546, 231004549, 3, 640x360 
0x12CB3460, 36963305935966736, 231004577, 231004581, 4, 640x360 
0x12CB3460, 36963305936285712, 231004605, 231004608, 3, 640x360 
0x12CB3460, 36963305936607008, 231004636, 231004639, 3, 640x360 
0x12CB3460, 36963305936925488, 231004676, 231004678, 2, 640x360 
0x12CB3460, 36963305937252408, 231004705, 231004709, 4, 640x360 
0x12CB3460, 36963305937565744, 231004735, 231004739, 4, 640x360 
0x12CB3460, 36963305937885224, 231004766, 231004768, 2, 640x360 
0x12CB3460, 36963305938206696, 231004795, 231004798, 3, 640x360 
0x12CB3460, 36963305938685744, 231004864, 231004869, 5, 640x360 
0x12CB3460, 36963305939004848, 231004876, 231004879, 3, 640x360 
0x12CB3460, 36963305939324560, 231004906, 231004911, 5, 640x360 
0x12CB3460, 36963305939646504, 231004945, 231004948, 3, 640x360 
0x12CB3460, 36963305939965480, 231004974, 231004977, 3, 640x360 
0x12CB3460, 36963305940286024, 231005005, 231005009, 4, 640x360 
0x12CB3460, 36963305940606744, 231005035, 231005038, 3, 640x360 
0x12CB3460, 36963305940925472, 231005065, 231005069, 4, 640x360 
0x12CB3460, 36963305941245680, 231005105, 231005108, 3, 640x360 
0x12CB3460, 36963305941565352, 231005134, 231005137, 3, 640x360 
0x12CB3460, 36963305941885904, 231005166, 231005169, 3, 640x360 
0x12CB3460, 36963305942389264, 231005219, 231005222, 3, 640x360 
0x12CB3460, 36963305942684616, 231005244, 231005247, 3, 640x360 
0x12CB3460, 36963305943006592, 231005275, 231005278, 3, 640x360 
0x12CB3460, 36963305943327168, 231005315, 231005318, 3, 640x360 
0x12CB3460, 36963305943646144, 231005345, 231005348, 3, 640x360 
0x12CB3460, 36963305944033528, 231005385, 231005389, 4, 640x360 
0x12CB3460, 36963305944286360, 231005406, 231005410, 4, 640x360 
0x12CB3460, 36963305944605008, 231005435, 231005447, 12, 640x360 
0x12CB3460, 36963305944925896, 231005475, 231005477, 2, 640x360 
0x12CB3460, 36963305945246632, 231005505, 231005508, 3, 640x360 
0x12CB3460, 36963305945568136, 231005535, 231005537, 2, 640x360 
0x12CB3460, 36963305945886496, 231005565, 231005568, 3, 640x360 
0x12CB3460, 36963305946367256, 231005615, 231005618, 3, 640x360 
0x12CB3460, 36963305946688472, 231005645, 231005648, 3, 640x360 
0x12CB3460, 36963305947008128, 231005677, 231005682, 5, 640x360 
0x12CB3460, 36963305947327352, 231005716, 231005721, 5, 640x360 
0x12CB3460, 36963305947651288, 231005745, 231005748, 3, 640x360 
0x12CB3460, 36963305947966184, 231005776, 231005779, 3, 640x360 
0x12CB3460, 36963305948285576, 231005806, 231005815, 9, 640x360 
0x12CB3460, 36963305948608392, 231005836, 231005841, 5, 640x360 
0x12CB3460, 36963305949022952, 231005886, 231005898, 12, 640x360 
0x12CB3460, 36963305949247944, 231005898, 231005902, 4, 640x360 
0x12CB3460, 36963305949567992, 231005936, 231005944, 8, 640x360 
0x12CB3460, 36963305949890216, 231005966, 231005975, 9, 640x360 
0x12CB3460, 36963305950364576, 231006016, 231006022, 6, 640x360 
0x12CB3460, 36963305950684496, 231006046, 231006055, 9, 640x360 
0x12CB3460, 36963305951008696, 231006078, 231006101, 23, 640x360 
0x12CB3460, 36963305951326688, 231006115, 231006118, 3, 640x360 
0x12CB3460, 36963305951645120, 231006144, 231006147, 3, 640x360 
0x12CB3460, 36963305951966832, 231006175, 231006178, 3, 640x360 
0x12CB3460, 36963305952286504, 231006205, 231006209, 4, 640x360 
0x12CB3460, 36963305952604936, 231006236, 231006241, 5, 640x360 
0x12CB3460, 36963305952926200, 231006275, 231006278, 3, 640x360 
0x12CB3460, 36963305953245552, 231006305, 231006309, 4, 640x360 
0x12CB3460, 36963305953567064, 231006336, 231006339, 3, 640x360 
0x12CB3460, 36963305954091096, 231006386, 231006390, 4, 640x360 
0x12CB3460, 36963305954366888, 231006415, 231006417, 2, 640x360 
0x12CB3460, 36963305954685984, 231006445, 231006448, 3, 640x360 
0x12CB3460, 36963305955007424, 231006476, 231006478, 2, 640x360 
0x12CB3460, 36963305955328968, 231006517, 231006521, 4, 640x360 
0x12CB3460, 36963305955645936, 231006547, 231006551, 4, 640x360 
0x12CB3460, 36963305955965088, 231006574, 231006577, 3, 640x360 
0x12CB3460, 36963305956285656, 231006605, 231006608, 3, 640x360 
0x12CB3460, 36963305956605496, 231006635, 231006640, 5, 640x360 
0x12CB3460, 36963305956925624, 231006665, 231006670, 5, 640x360 
0x12CB3460, 36963305957245760, 231006706, 231006710, 4, 640x360 
0x12CB3460, 36963305957566072, 231006736, 231006740, 4, 640x360 
0x12CB3460, 36963305958046112, 231006786, 231006789, 3, 640x360 
0x12CB3460, 36963305958370048, 231006815, 231006818, 3, 640x360 
0x12CB3460, 36963305958685096, 231006845, 231006848, 3, 640x360 
0x12CB3460, 36963305959005312, 231006886, 231006889, 3, 640x360 
0x12CB3460, 36963305959326832, 231006914, 231006918, 4, 640x360 
0x12CB3460, 36963305959649952, 231006945, 231006962, 17, 640x360 
0x12CB3460, 36963305959966624, 231006976, 231006987, 11, 640x360 
0x12CB3460, 36963305960287144, 231007010, 231007017, 7, 640x360 
0x12CB3460, 36963305960607032, 231007036, 231007045, 9, 640x360 
0x12CB3460, 36963305960925456, 231007066, 231007069, 3, 640x360 
0x12CB3460, 36963305961245752, 231007106, 231007112, 6, 640x360 
0x12CB3460, 36963305961723920, 231007145, 231007148, 3, 640x360 
0x12CB3460, 36963305962045312, 231007185, 231007188, 3, 640x360 
0x12CB3460, 36963305962366712, 231007216, 231007218, 2, 640x360 
0x12CB3460, 36963305962685736, 231007245, 231007247, 2, 640x360 
0x12CB3460, 36963305963004936, 231007276, 231007279, 3, 640x360 
0x12CB3460, 36963305963325600, 231007306, 231007309, 3, 640x360 
0x12CB3460, 36963305963650088, 231007346, 231007370, 24, 640x360 
0x12CB3460, 36963305963964688, 231007383, 231007387, 4, 640x360 
0x12CB3460, 36963305964284416, 231007406, 231007412, 6, 640x360 
0x12CB3460, 36963305964604528, 231007435, 231007438, 3, 640x360 
0x12CB3460, 36963305964926232, 231007475, 231007477, 2, 640x360 
0x12CB3460, 36963305965245560, 231007506, 231007514, 8, 640x360 
0x12CB3460, 36963305965726400, 231007546, 231007552, 6, 640x360 
0x12CB3460, 36963305966045360, 231007586, 231007588, 2, 640x360 
0x12CB3460, 36963305966370488, 231007616, 231007623, 7, 640x360 
0x12CB3460, 36963305966685576, 231007646, 231007648, 2, 640x360 
0x12CB3460, 36963305967005728, 231007676, 231007678, 2, 640x360 
0x12CB3460, 36963305967324896, 231007710, 231007713, 3, 640x360 
0x12CB3460, 36963305967646232, 231007745, 231007748, 3, 640x360 
0x12CB3460, 36963305967966112, 231007774, 231007777, 3, 640x360 
0x12CB3460, 36963305968285112, 231007805, 231007808, 3, 640x360 
0x12CB3460, 36963305968605080, 231007835, 231007838, 3, 640x360 
0x12CB3460, 36963305968926392, 231007874, 231007877, 3, 640x360 
0x12CB3460, 36963305969245784, 231007906, 231007913, 7, 640x360 
0x12CB3460, 36963305969725192, 231007945, 231007949, 4, 640x360 
0x12CB3460, 36963305970046104, 231007984, 231007987, 3, 640x360 
0x12CB3460, 36963305970366216, 231008015, 231008018, 3, 640x360 
0x12CB3460, 36963305970686072, 231008045, 231008047, 2, 640x360 
0x12CB3460, 36963305971004720, 231008076, 231008079, 3, 640x360 
0x12CB3460, 36963305971325680, 231008116, 231008118, 2, 640x360 
0x12CB3460, 36963305971644904, 231008145, 231008148, 3, 640x360 
0x12CB3460, 36963305971965936, 231008176, 231008179, 3, 640x360 
0x12CB3460, 36963305972288712, 231008207, 231008210, 3, 640x360 
0x12CB3460, 36963305972608352, 231008236, 231008239, 3, 640x360 
0x12CB3460, 36963305972925576, 231008266, 231008270, 4, 640x360 
0x12CB3460, 36963305973406232, 231008316, 231008319, 3, 640x360 
0x12CB3460, 36963305973727832, 231008380, 231008382, 2, 640x360 
0x12CB3460, 36963305974366368, 231008415, 231008417, 2, 640x360 
0x12CB3460, 36963305974685440, 231008445, 231008447, 2, 640x360 
0x12CB3460, 36963305975005632, 231008474, 231008478, 4, 640x360 
0x12CB3460, 36963305975325816, 231008506, 231008511, 5, 640x360 
0x12CB3460, 36963305975646224, 231008545, 231008548, 3, 640x360 
0x12CB3460, 36963305975967664, 231008575, 231008579, 4, 640x360 
0x12CB3460, 36963305976286464, 231008604, 231008607, 3, 640x360 
0x12CB3460, 36963305976605848, 231008635, 231008638, 3, 640x360 
0x12CB3460, 36963305976928952, 231008677, 231008680, 3, 640x360 
0x12CB3460, 36963305977411168, 231008718, 231008722, 4, 640x360 
0x12CB3460, 36963305977725104, 231008746, 231008750, 4, 640x360 
0x12CB3460, 36963305978045824, 231008785, 231008788, 3, 640x360 
0x12CB3460, 36963305978370304, 231008815, 231008818, 3, 640x360 
0x12CB3460, 36963305978684904, 231008845, 231008849, 4, 640x360 
0x12CB3460, 36963305979005312, 231008875, 231008878, 3, 640x360 
0x12CB3460, 36963305979326336, 231008906, 231008911, 5, 640x360 
0x12CB3460, 36963305979644712, 231008945, 231008948, 3, 640x360 
0x12CB3460, 36963305979964560, 231008975, 231008977, 2, 640x360 
0x12CB3460, 36963305980286072, 231009006, 231009009, 3, 640x360 
0x12CB3460, 36963305980605272, 231009035, 231009038, 3, 640x360 
0x12CB3460, 36963305980925544, 231009075, 231009078, 3, 640x360 
0x12CB3460, 36963305981405888, 231009115, 231009118, 3, 640x360 
0x12CB3460, 36963305981724912, 231009146, 231009150, 4, 640x360 
0x12CB3460, 36963305982046056, 231009186, 231009189, 3, 640x360 
0x12CB3460, 36963305982367384, 231009215, 231009218, 3, 640x360 
0x12CB3460, 36963305982687280, 231009246, 231009253, 7, 640x360 
0x12CB3460, 36963305983004432, 231009275, 231009278, 3, 640x360 
0x12CB3460, 36963305983325288, 231009307, 231009311, 4, 640x360 
0x12CB3460, 36963305983646272, 231009345, 231009349, 4, 640x360 
0x12CB3460, 36963305983965360, 231009376, 231009379, 3, 640x360 
0x12CB3460, 36963305984284512, 231009405, 231009407, 2, 640x360 
0x12CB3460, 36963305984605024, 231009435, 231009438, 3, 640x360 
0x12CB3460, 36963305985086392, 231009485, 231009488, 3, 640x360 
0x12CB3460, 36963305985406472, 231009517, 231009520, 3, 640x360 
0x12CB3460, 36963305985727168, 231009549, 231009552, 3, 640x360 
0x12CB3460, 36963305986044968, 231009585, 231009589, 4, 640x360 
0x12CB3460, 36963305986366496, 231009614, 231009617, 3, 640x360 
0x12CB3460, 36963305986685824, 231009645, 231009648, 3, 640x360 
0x12CB3460, 36963305987005312, 231009675, 231009679, 4, 640x360 
0x12CB3460, 36963305987325176, 231009707, 231009711, 4, 640x360 
0x12CB3460, 36963305987645184, 231009746, 231009748, 2, 640x360 
0x12CB3460, 36963305987965344, 231009775, 231009778, 3, 640x360 
0x12CB3460, 36963305988285488, 231009806, 231009809, 3, 640x360 
0x12CB3460, 36963305988605816, 231009835, 231009838, 3, 640x360 
0x12CB3460, 36963305989084064, 231009885, 231009888, 3, 640x360 
0x12CB3460, 36963305989406040, 231009916, 231009920, 4, 640x360 
0x12CB3460, 36963305989724136, 231009945, 231009949, 4, 640x360 
0x12CB3460, 36963305990046840, 231009987, 231009990, 3, 640x360 
0x12CB3460, 36963305990366768, 231010015, 231010018, 3, 640x360 
0x12CB3460, 36963305990686360, 231010046, 231010049, 3, 640x360 
0x12CB3460, 36963305991015288, 231010087, 231010095, 8, 640x360 
0x12CB3460, 36963305991325864, 231010125, 231010128, 3, 640x360 
0x12CB3460, 36963305991648344, 231010144, 231010148, 4, 640x360 
0x12CB3460, 36963305991965312, 231010175, 231010178, 3, 640x360 
0x12CB3460, 36963305992286992, 231010205, 231010211, 6, 640x360 
0x12CB3460, 36963305992605008, 231010235, 231010238, 3, 640x360 
0x12CB3460, 36963305993086520, 231010284, 231010287, 3, 640x360 
0x12CB3460, 36963305993406104, 231010316, 231010318, 2, 640x360 
0x12CB3460, 36963305993726928, 231010386, 231010390, 4, 640x360 
0x12CB3460, 36963305994368072, 231010415, 231010417, 2, 640x360 
0x12CB3460, 36963305994685400, 231010445, 231010448, 3, 640x360 
0x12CB3460, 36963305995005448, 231010474, 231010478, 4, 640x360 
0x12CB3460, 36963305995325944, 231010516, 231010519, 3, 640x360 
0x12CB3460, 36963305995645640, 231010546, 231010549, 3, 640x360 
0x12CB3460, 36963305995965384, 231010575, 231010578, 3, 640x360 
0x12CB3460, 36963305996285024, 231010604, 231010607, 3, 640x360 
0x12CB3460, 36963305996766424, 231010655, 231010658, 3, 640x360 
0x12CB3460, 36963305997085424, 231010685, 231010689, 4, 640x360 
0x12CB3460, 36963305997405672, 231010715, 231010719, 4, 640x360 
0x12CB3460, 36963305997724496, 231010755, 231010762, 7, 640x360 
0x12CB3460, 36963305998046872, 231010786, 231010796, 10, 640x360 
0x12CB3460, 36963305998368072, 231010815, 231010831, 16, 640x360 
0x12CB3460, 36963305998688520, 231010887, 231010899, 12, 640x360 
0x12CB3460, 36963305999195560, 231010900, 231010916, 16, 640x360 
0x12CB3460, 36963305999330760, 231010917, 231010933, 16, 640x360 
0x12CB3460, 36963305999647072, 231010946, 231010950, 4, 640x360 
0x12CB3460, 36963305999964920, 231010975, 231010979, 4, 640x360 
0x12CB3460, 36963306000287392, 231011005, 231011020, 15, 640x360 
0x12CB3460, 36963306000765176, 231011055, 231011064, 9, 640x360 
0x12CB3460, 36963306001084832, 231011086, 231011093, 7, 640x360 
0x12CB3460, 36963306001405984, 231011115, 231011118, 3, 640x360 
0x12CB3460, 36963306001725792, 231011155, 231011158, 3, 640x360 
0x12CB3460, 36963306002046240, 231011185, 231011188, 3, 640x360 
0x12CB3460, 36963306002372152, 231011215, 231011218, 3, 640x360 
0x12CB3460, 36963306002689640, 231011244, 231011247, 3, 640x360 
0x12CB3460, 36963306003004544, 231011275, 231011278, 3, 640x360 
0x12CB3460, 36963306003325752, 231011305, 231011311, 6, 640x360 
0x12CB3460, 36963306003646344, 231011372, 231011379, 7, 640x360 
0x12CB3460, 36963306004035752, 231011386, 231011391, 5, 640x360 
0x12CB3460, 36963306004447096, 231011425, 231011428, 3, 640x360 
0x12CB3460, 36963306004765360, 231011455, 231011458, 3, 640x360 
0x12CB3460, 36963306005086112, 231011486, 231011488, 2, 640x360 
0x12CB3460, 36963306005404624, 231011517, 231011519, 2, 640x360 
0x12CB3460, 36963306005725312, 231011555, 231011559, 4, 640x360 
0x12CB3460, 36963306006044632, 231011585, 231011590, 5, 640x360 
0x12CB3460, 36963306006366040, 231011615, 231011618, 3, 640x360 
0x12CB3460, 36963306006684144, 231011645, 231011647, 2, 640x360 
0x12CB3460, 36963306007006656, 231011677, 231011679, 2, 640x360 
0x12CB3460, 36963306007325320, 231011705, 231011710, 5, 640x360 
0x12CB3460, 36963306007645640, 231011745, 231011748, 3, 640x360 
0x12CB3460, 36963306007966104, 231011777, 231011780, 3, 640x360 
0x12CB3460, 36963306008443872, 231011824, 231011827, 3, 640x360 
0x12CB3460, 36963306008988312, 231011876, 231011881, 5, 640x360 
0x12CB3460, 36963306009085288, 231011885, 231011889, 4, 640x360 
0x12CB3460, 36963306009403832, 231011916, 231011918, 2, 640x360 
0x12CB3460, 36963306009726392, 231011945, 231011948, 3, 640x360 
0x12CB3460, 36963306010044944, 231011985, 231011987, 2, 640x360 
0x12CB3460, 36963306010367888, 231012015, 231012018, 3, 640x360 
0x12CB3460, 36963306010685864, 231012045, 231012048, 3, 640x360 
0x12CB3460, 36963306011005704, 231012076, 231012079, 3, 640x360 
0x12CB3460, 36963306011325296, 231012106, 231012111, 5, 640x360 
0x12CB3460, 36963306011966344, 231012175, 231012178, 3, 640x360 
0x12CB3460, 36963306012444464, 231012224, 231012227, 3, 640x360 
0x12CB3460, 36963306012765256, 231012255, 231012259, 4, 640x360 
0x12CB3460, 36963306013086216, 231012296, 231012298, 2, 640x360 
0x12CB3460, 36963306013404832, 231012316, 231012319, 3, 640x360 
0x12CB3460, 36963306013724880, 231012379, 231012386, 7, 640x360 
0x12CB3460, 36963306014117336, 231012397, 231012404, 7, 640x360 
0x12CB3460, 36963306014367192, 231012416, 231012419, 3, 640x360 
0x12CB3460, 36963306014684048, 231012445, 231012448, 3, 640x360 
0x12CB3460, 36963306015004712, 231012474, 231012478, 4, 640x360 
0x12CB3460, 36963306015325968, 231012516, 231012519, 3, 640x360 
0x12CB3460, 36963306015644920, 231012545, 231012548, 3, 640x360 
0x12CB3460, 36963306016123408, 231012594, 231012597, 3, 640x360 
0x12CB3460, 36963306016446248, 231012625, 231012627, 2, 640x360 
0x12CB3460, 36963306016765952, 231012655, 231012658, 3, 640x360 
0x12CB3460, 36963306017086216, 231012685, 231012689, 4, 640x360 
0x12CB3460, 36963306017405264, 231012715, 231012719, 4, 640x360 
0x12CB3460, 36963306017724744, 231012746, 231012749, 3, 640x360 
0x12CB3460, 36963306018044136, 231012785, 231012788, 3, 640x360 
0x12CB3460, 36963306018366224, 231012814, 231012817, 3, 640x360 
0x12CB3460, 36963306018686672, 231012846, 231012849, 3, 640x360 
0x12CB3460, 36963306019154536, 231012895, 231012903, 8, 640x360 
0x12CB3460, 36963306019324872, 231012915, 231012919, 4, 640x360 
0x12CB3460, 36963306019645992, 231012945, 231012947, 2, 640x360 
0x12CB3460, 36963306020125864, 231012996, 231012998, 2, 640x360 
0x12CB3460, 36963306020447312, 231013027, 231013030, 3, 640x360 
0x12CB3460, 36963306020765432, 231013056, 231013059, 3, 640x360 
0x12CB3460, 36963306021084816, 231013085, 231013089, 4, 640x360 
0x12CB3460, 36963306021405320, 231013114, 231013119, 5, 640x360 
0x12CB3460, 36963306021725672, 231013146, 231013149, 3, 640x360 
0x12CB3460, 36963306022046648, 231013186, 231013189, 3, 640x360 
0x12CB3460, 36963306022365648, 231013215, 231013218, 3, 640x360 
0x12CB3460, 36963306022684520, 231013244, 231013247, 3, 640x360 
0x12CB3460, 36963306023005112, 231013276, 231013279, 3, 640x360 
0x12CB3460, 36963306023325712, 231013315, 231013318, 3, 640x360 
0x12CB3460, 36963306023647360, 231013372, 231013375, 3, 640x360 
0x12CB3460, 36963306024125048, 231013395, 231013398, 3, 640x360 
0x12CB3460, 36963306024446120, 231013425, 231013428, 3, 640x360 
0x12CB3460, 36963306024765392, 231013456, 231013459, 3, 640x360 
0x12CB3460, 36963306025085632, 231013485, 231013488, 3, 640x360 
0x12CB3460, 36963306025406104, 231013516, 231013520, 4, 640x360 
0x12CB3460, 36963306025725464, 231013555, 231013560, 5, 640x360 
0x12CB3460, 36963306026046664, 231013585, 231013591, 6, 640x360 
0x12CB3460, 36963306026365632, 231013615, 231013618, 3, 640x360 
0x12CB3460, 36963306026684264, 231013645, 231013648, 3, 640x360 
0x12CB3460, 36963306027005728, 231013676, 231013678, 2, 640x360 
0x12CB3460, 36963306027326872, 231013715, 231013719, 4, 640x360 
0x12CB3460, 36963306027805016, 231013755, 231013759, 4, 640x360 
0x12CB3460, 36963306028125776, 231013795, 231013798, 3, 640x360 
0x12CB3460, 36963306028443888, 231013825, 231013828, 3, 640x360 
0x12CB3460, 36963306028908760, 231013867, 231013871, 4, 640x360 
0x12CB3460, 36963306029085328, 231013885, 231013888, 3, 640x360 
0x12CB3460, 36963306029407344, 231013915, 231013919, 4, 640x360 
0x12CB3460, 36963306029723984, 231013955, 231013958, 3, 640x360 
0x12CB3460, 36963306030043960, 231013985, 231013987, 2, 640x360 
0x12CB3460, 36963306030365824, 231014015, 231014018, 3, 640x360 
0x12CB3460, 36963306030687456, 231014045, 231014049, 4, 640x360 
0x12CB3460, 36963306031006008, 231014076, 231014080, 4, 640x360 
0x12CB3460, 36963306031325384, 231014106, 231014111, 5, 640x360 
0x12CB3460, 36963306031803680, 231014154, 231014158, 4, 640x360 
0x12CB3460, 36963306032125736, 231014195, 231014197, 2, 640x360 
0x12CB3460, 36963306032446408, 231014225, 231014228, 3, 640x360 
0x12CB3460, 36963306032763904, 231014255, 231014258, 3, 640x360 
0x12CB3460, 36963306033084496, 231014285, 231014288, 3, 640x360 
0x12CB3460, 36963306033406152, 231014315, 231014318, 3, 640x360 
0x12CB3460, 36963306033726512, 231014370, 231014373, 3, 640x360 
0x12CB3460, 36963306034045064, 231014384, 231014387, 3, 640x360 
0x12CB3460, 36963306034367216, 231014415, 231014418, 3, 640x360 
0x12CB3460, 36963306034685064, 231014447, 231014450, 3, 640x360 
0x12CB3460, 36963306035004640, 231014475, 231014477, 2, 640x360 
0x12CB3460, 36963306035485968, 231014526, 231014529, 3, 640x360 
0x12CB3460, 36963306035804120, 231014556, 231014559, 3, 640x360 
0x12CB3460, 36963306036126232, 231014595, 231014599, 4, 640x360 
0x12CB3460, 36963306036443488, 231014626, 231014628, 2, 640x360 
0x12CB3460, 36963306036764912, 231014655, 231014659, 4, 640x360 
0x12CB3460, 36963306037084936, 231014685, 231014689, 4, 640x360 
0x12CB3460, 36963306037406144, 231014716, 231014719, 3, 640x360 
0x12CB3460, 36963306037723992, 231014746, 231014749, 3, 640x360 
0x12CB3460, 36963306038045864, 231014785, 231014788, 3, 640x360 
0x12CB3460, 36963306038364568, 231014815, 231014818, 3, 640x360 
0x12CB3460, 36963306038684872, 231014845, 231014848, 3, 640x360 
0x12CB3460, 36963306039023720, 231014884, 231014887, 3, 640x360 
0x12CB3460, 36963306039483912, 231014925, 231014928, 3, 640x360 
0x12CB3460, 36963306039804544, 231014957, 231014962, 5, 640x360 
0x12CB3460, 36963306040123856, 231014995, 231014998, 3, 640x360 
0x12CB3460, 36963306040446120, 231015025, 231015028, 3, 640x360 
0x12CB3460, 36963306040765176, 231015055, 231015058, 3, 640x360 
0x12CB3460, 36963306041086728, 231015085, 231015088, 3, 640x360 
0x12CB3460, 36963306041405456, 231015114, 231015133, 19, 640x360 
0x12CB3460, 36963306041725168, 231015155, 231015158, 3, 640x360 
0x12CB3460, 36963306042044208, 231015185, 231015188, 3, 640x360 
0x12CB3460, 36963306042364600, 231015215, 231015219, 4, 640x360 
0x12CB3460, 36963306042685496, 231015245, 231015249, 4, 640x360 
0x12CB3460, 36963306043005480, 231015275, 231015278, 3, 640x360 
0x12CB3460, 36963306043486632, 231015324, 231015327, 3, 640x360 
0x12CB3460, 36963306044000600, 231015375, 231015378, 3, 640x360 
0x12CB3460, 36963306044125280, 231015395, 231015398, 3, 640x360 
0x12CB3460, 36963306044446696, 231015424, 231015427, 3, 640x360 
0x12CB3460, 36963306044765264, 231015456, 231015460, 4, 640x360 
0x12CB3460, 36963306045084728, 231015485, 231015487, 2, 640x360 
0x12CB3460, 36963306045405528, 231015516, 231015518, 2, 640x360 
0x12CB3460, 36963306045725112, 231015556, 231015560, 4, 640x360 
0x12CB3460, 36963306046044648, 231015585, 231015588, 3, 640x360 
0x12CB3460, 36963306046364656, 231015615, 231015618, 3, 640x360 
0x12CB3460, 36963306046685456, 231015645, 231015648, 3, 640x360 
0x12CB3460, 36963306047166208, 231015696, 231015699, 3, 640x360 
0x12CB3460, 36963306047488496, 231015725, 231015727, 2, 640x360 
0x12CB3460, 36963306047809448, 231015755, 231015760, 5, 640x360 
0x12CB3460, 36963306048124888, 231015795, 231015798, 3, 640x360 
0x12CB3460, 36963306048444576, 231015825, 231015827, 2, 640x360 
0x12CB3460, 36963306048764848, 231015875, 231015878, 3, 640x360 
0x12CB3460, 36963306049084144, 231015886, 231015889, 3, 640x360 
0x12CB3460, 36963306049405608, 231015916, 231015918, 2, 640x360 
0x12CB3460, 36963306049725400, 231015955, 231015958, 3, 640x360 
0x12CB3460, 36963306050045592, 231015985, 231015988, 3, 640x360 
0x12CB3460, 36963306050365616, 231016014, 231016017, 3, 640x360 
0x12CB3460, 36963306050686520, 231016045, 231016048, 3, 640x360 
0x12CB3460, 36963306051166256, 231016095, 231016098, 3, 640x360 
0x12CB3460, 36963306051485144, 231016125, 231016128, 3, 640x360 
0x12CB3460, 36963306051805896, 231016155, 231016158, 3, 640x360 
0x12CB3460, 36963306052127392, 231016195, 231016197, 2, 640x360 
0x12CB3460, 36963306052444216, 231016225, 231016228, 3, 640x360 
0x12CB3460, 36963306052768104, 231016254, 231016257, 3, 640x360 
0x12CB3460, 36963306053085496, 231016285, 231016288, 3, 640x360 
0x12CB3460, 36963306053405840, 231016315, 231016318, 3, 640x360 
0x12CB3460, 36963306053726440, 231016379, 231016383, 4, 640x360 
0x12CB3460, 36963306054109320, 231016387, 231016390, 3, 640x360 
0x12CB3460, 36963306054367568, 231016415, 231016417, 2, 640x360 
0x12CB3460, 36963306054686240, 231016445, 231016447, 2, 640x360 
0x12CB3460, 36963306055166768, 231016495, 231016499, 4, 640x360 
0x12CB3460, 36963306055485656, 231016524, 231016527, 3, 640x360 
0x12CB3460, 36963306055805888, 231016556, 231016560, 4, 640x360 
0x12CB3460, 36963306056126368, 231016596, 231016598, 2, 640x360 
0x12CB3460, 36963306056445368, 231016626, 231016628, 2, 640x360 
0x12CB3460, 36963306056765624, 231016655, 231016659, 4, 640x360 
0x12CB3460, 36963306057085496, 231016687, 231016690, 3, 640x360 
0x12CB3460, 36963306057408008, 231016716, 231016720, 4, 640x360 
0x12CB3460, 36963306057724248, 231016746, 231016749, 3, 640x360 
0x12CB3460, 36963306058044672, 231016785, 231016787, 2, 640x360 
0x12CB3460, 36963306058366640, 231016815, 231016818, 3, 640x360 
0x12CB3460, 36963306059029240, 231016886, 231016890, 4, 640x360 
0x12CB3460, 36963306059164008, 231016895, 231016898, 3, 640x360 
0x12CB3460, 36963306059484536, 231016925, 231016928, 3, 640x360 
0x12CB3460, 36963306059804352, 231016965, 231016968, 3, 640x360 
0x12CB3460, 36963306060127768, 231016995, 231016998, 3, 640x360 
0x12CB3460, 36963306060444896, 231017025, 231017028, 3, 640x360 
0x12CB3460, 36963306060764440, 231017055, 231017057, 2, 640x360 
0x12CB3460, 36963306061086248, 231017085, 231017089, 4, 640x360 
0x12CB3460, 36963306061403712, 231017116, 231017118, 2, 640x360 
0x12CB3460, 36963306061724104, 231017155, 231017157, 2, 640x360 
0x12CB3460, 36963306062045136, 231017186, 231017188, 2, 640x360 
0x12CB3460, 36963306062394624, 231017216, 231017219, 3, 640x360 
0x12CB3460, 36963306062845640, 231017265, 231017268, 3, 640x360 
0x12CB3460, 36963306063165104, 231017295, 231017298, 3, 640x360 
0x12CB3460, 36963306063485552, 231017325, 231017327, 2, 640x360 
0x12CB3460, 36963306064020576, 231017386, 231017389, 3, 640x360 
0x12CB3460, 36963306064444712, 231017425, 231017428, 3, 640x360 
0x12CB3460, 36963306064765184, 231017455, 231017457, 2, 640x360 
0x12CB3460, 36963306065085680, 231017486, 231017488, 2, 640x360 
0x12CB3460, 36963306065406312, 231017517, 231017520, 3, 640x360 
0x12CB3460, 36963306065727240, 231017556, 231017560, 4, 640x360 
0x12CB3460, 36963306066045784, 231017586, 231017592, 6, 640x360 
0x12CB3460, 36963306066366216, 231017614, 231017617, 3, 640x360 
0x12CB3460, 36963306066844184, 231017665, 231017668, 3, 640x360 
0x12CB3460, 36963306067167304, 231017695, 231017698, 3, 640x360 
0x12CB3460, 36963306067484648, 231017725, 231017727, 2, 640x360 
0x12CB3460, 36963306067806616, 231017756, 231017761, 5, 640x360 
0x12CB3460, 36963306068127816, 231017794, 231017797, 3, 640x360 
0x12CB3460, 36963306068444280, 231017824, 231017827, 3, 640x360 
0x12CB3460, 36963306068765312, 231017874, 231017877, 3, 640x360 
0x12CB3460, 36963306069084304, 231017885, 231017887, 2, 640x360 
0x12CB3460, 36963306069405768, 231017916, 231017919, 3, 640x360 
0x12CB3460, 36963306069726824, 231017954, 231017957, 3, 640x360 
0x12CB3460, 36963306070044536, 231017985, 231017988, 3, 640x360 
0x12CB3460, 36963306070526408, 231018036, 231018038, 2, 640x360 
0x12CB3460, 36963306070844456, 231018066, 231018069, 3, 640x360 
0x12CB3460, 36963306071163952, 231018095, 231018097, 2, 640x360 
0x12CB3460, 36963306071483936, 231018124, 231018127, 3, 640x360 
0x12CB3460, 36963306071805872, 231018155, 231018158, 3, 640x360 
0x12CB3460, 36963306072129800, 231018195, 231018198, 3, 640x360 
0x12CB3460, 36963306072446656, 231018225, 231018228, 3, 640x360 
0x12CB3460, 36963306072766592, 231018256, 231018264, 8, 640x360 
0x12CB3460, 36963306073084992, 231018286, 231018289, 3, 640x360 
0x12CB3460, 36963306073406464, 231018317, 231018320, 3, 640x360 
0x12CB3460, 36963306073728504, 231018395, 231018398, 3, 640x360 
0x12CB3460, 36963306074525264, 231018435, 231018437, 2, 640x360 
0x12CB3460, 36963306074844152, 231018465, 231018468, 3, 640x360 
0x12CB3460, 36963306075166744, 231018495, 231018497, 2, 640x360 
0x12CB3460, 36963306075485632, 231018525, 231018528, 3, 640x360 
0x12CB3460, 36963306075804512, 231018555, 231018558, 3, 640x360 
0x12CB3460, 36963306076125336, 231018586, 231018608, 22, 640x360 
0x12CB3460, 36963306076446200, 231018626, 231018635, 9, 640x360 
0x12CB3460, 36963306076764360, 231018654, 231018659, 5, 640x360 
0x12CB3460, 36963306077086072, 231018686, 231018689, 3, 640x360 
0x12CB3460, 36963306077407544, 231018716, 231018720, 4, 640x360 
0x12CB3460, 36963306077724696, 231018755, 231018759, 4, 640x360 
0x12CB3460, 36963306078205952, 231018796, 231018799, 3, 640x360 
0x12CB3460, 36963306078526768, 231018836, 231018839, 3, 640x360 
0x12CB3460, 36963306079116440, 231018886, 231018892, 6, 640x360 
0x12CB3460, 36963306079165864, 231018895, 231018898, 3, 640x360 
0x12CB3460, 36963306079485472, 231018925, 231018933, 8, 640x360 
0x12CB3460, 36963306079805512, 231018954, 231018957, 3, 640x360 
0x12CB3460, 36963306080124632, 231018995, 231018998, 3, 640x360 
0x12CB3460, 36963306080766128, 231019058, 231019061, 3, 640x360 
0x12CB3460, 36963306081086440, 231019085, 231019087, 2, 640x360 
0x12CB3460, 36963306081404336, 231019115, 231019118, 3, 640x360 
0x12CB3460, 36963306081724760, 231019155, 231019158, 3, 640x360 
0x12CB3460, 36963306082204584, 231019196, 231019199, 3, 640x360 
0x12CB3460, 36963306082524576, 231019235, 231019237, 2, 640x360 
0x12CB3460, 36963306082844688, 231019265, 231019267, 2, 640x360 
0x12CB3460, 36963306083164544, 231019295, 231019297, 2, 640x360 
0x12CB3460, 36963306083483880, 231019326, 231019329, 3, 640x360 
0x12CB3460, 36963306084126792, 231019395, 231019397, 2, 640x360 
0x12CB3460, 36963306084444120, 231019425, 231019434, 9, 640x360 
0x12CB3460, 36963306084763240, 231019454, 231019457, 3, 640x360 
0x12CB3460, 36963306085084848, 231019485, 231019488, 3, 640x360 
0x12CB3460, 36963306085405552, 231019515, 231019517, 2, 640x360 
0x12CB3460, 36963306085726608, 231019557, 231019561, 4, 640x360 
0x12CB3460, 36963306086206752, 231019596, 231019599, 3, 640x360 
0x12CB3460, 36963306086523672, 231019634, 231019637, 3, 640x360 
0x12CB3460, 36963306086845448, 231019665, 231019668, 3, 640x360 
0x12CB3460, 36963306087164240, 231019695, 231019698, 3, 640x360 
0x12CB3460, 36963306087484960, 231019726, 231019728, 2, 640x360 
0x12CB3460, 36963306087804320, 231019755, 231019758, 3, 640x360 
0x12CB3460, 36963306088127424, 231019795, 231019797, 2, 640x360 
0x12CB3460, 36963306088444072, 231019825, 231019828, 3, 640x360 
0x12CB3460, 36963306088987088, 231019876, 231019879, 3, 640x360 
0x12CB3460, 36963306089085160, 231019885, 231019889, 4, 640x360 
0x12CB3460, 36963306089404976, 231019915, 231019917, 2, 640x360 
0x12CB3460, 36963306089885296, 231019965, 231019967, 2, 640x360 
0x12CB3460, 36963306090206416, 231019995, 231019999, 4, 640x360 
0x12CB3460, 36963306090525384, 231020036, 231020040, 4, 640x360 
0x12CB3460, 36963306090850496, 231020065, 231020068, 3, 640x360 
0x12CB3460, 36963306091165552, 231020095, 231020098, 3, 640x360 
0x12CB3460, 36963306091485656, 231020124, 231020127, 3, 640x360 
0x12CB3460, 36963306091803840, 231020157, 231020160, 3, 640x360 
0x12CB3460, 36963306092125408, 231020196, 231020199, 3, 640x360 
0x12CB3460, 36963306092450496, 231020225, 231020228, 3, 640x360 
0x12CB3460, 36963306092763712, 231020255, 231020257, 2, 640x360 
0x12CB3460, 36963306093084600, 231020287, 231020289, 2, 640x360 
0x12CB3460, 36963306093405808, 231020315, 231020318, 3, 640x360 
0x12CB3460, 36963306094025880, 231020385, 231020388, 3, 640x360 
0x12CB3460, 36963306094204696, 231020395, 231020397, 2, 640x360 
0x12CB3460, 36963306094525472, 231020435, 231020437, 2, 640x360 
0x12CB3460, 36963306094844632, 231020466, 231020468, 2, 640x360 
0x12CB3460, 36963306095165312, 231020495, 231020497, 2, 640x360 
0x12CB3460, 36963306095486800, 231020525, 231020528, 3, 640x360 
0x12CB3460, 36963306095806760, 231020556, 231020559, 3, 640x360 
0x12CB3460, 36963306096126192, 231020596, 231020605, 9, 640x360 
0x12CB3460, 36963306096444424, 231020625, 231020627, 2, 640x360 
0x12CB3460, 36963306096764784, 231020656, 231020660, 4, 640x360 
0x12CB3460, 36963306097085776, 231020684, 231020687, 3, 640x360 
0x12CB3460, 36963306097405272, 231020716, 231020718, 2, 640x360 
0x12CB3460, 36963306097883120, 231020765, 231020767, 2, 640x360 
0x12CB3460, 36963306098202984, 231020795, 231020797, 2, 640x360 
0x12CB3460, 36963306098525240, 231020834, 231020837, 3, 640x360 
0x12CB3460, 36963306098967240, 231020875, 231020878, 3, 640x360 
0x12CB3460, 36963306099164344, 231020894, 231020897, 3, 640x360 
0x12CB3460, 36963306099483680, 231020924, 231020927, 3, 640x360 
0x12CB3460, 36963306099803496, 231020956, 231020958, 2, 640x360 
0x12CB3460, 36963306100125960, 231020995, 231020998, 3, 640x360 
0x12CB3460, 36963306100444368, 231021025, 231021027, 2, 640x360 
0x12CB3460, 36963306100764344, 231021056, 231021059, 3, 640x360 
0x12CB3460, 36963306101084288, 231021085, 231021087, 2, 640x360 
0x12CB3460, 36963306101564344, 231021135, 231021138, 3, 640x360 
0x12CB3460, 36963306101884248, 231021165, 231021168, 3, 640x360 
0x12CB3460, 36963306102204688, 231021196, 231021199, 3, 640x360 
0x12CB3460, 36963306102524440, 231021234, 231021237, 3, 640x360 
0x12CB3460, 36963306102844424, 231021265, 231021272, 7, 640x360 
0x12CB3460, 36963306103164632, 231021294, 231021296, 2, 640x360 
0x12CB3460, 36963306103484040, 231021325, 231021327, 2, 640x360 
0x12CB3460, 36963306103990216, 231021376, 231021379, 3, 640x360 
0x12CB3460, 36963306104123952, 231021387, 231021390, 3, 640x360 
0x12CB3460, 36963306104443608, 231021425, 231021428, 3, 640x360 
0x12CB3460, 36963306104764024, 231021455, 231021458, 3, 640x360 
0x12CB3460, 36963306105083992, 231021485, 231021503, 18, 640x360 
0x12CB3460, 36963306105566680, 231021535, 231021538, 3, 640x360 
0x12CB3460, 36963306105884432, 231021565, 231021573, 8, 640x360 
0x12CB3460, 36963306106203312, 231021594, 231021598, 4, 640x360 
0x12CB3460, 36963306106524464, 231021635, 231021638, 3, 640x360 
0x12CB3460, 36963306106844368, 231021666, 231021668, 2, 640x360 
0x12CB3460, 36963306107164848, 231021695, 231021697, 2, 640x360 
0x12CB3460, 36963306107484288, 231021725, 231021728, 3, 640x360 
0x12CB3460, 36963306107804512, 231021754, 231021759, 5, 640x360 
0x12CB3460, 36963306108128376, 231021794, 231021797, 3, 640x360 
0x12CB3460, 36963306108446104, 231021824, 231021827, 3, 640x360 
0x12CB3460, 36963306108764184, 231021879, 231021885, 6, 640x360 
0x12CB3460, 36963306109128480, 231021895, 231021898, 3, 640x360 
0x12CB3460, 36963306109564432, 231021935, 231021937, 2, 640x360 
0x12CB3460, 36963306109886592, 231021966, 231021968, 2, 640x360 
0x12CB3460, 36963306110204728, 231021995, 231021997, 2, 640x360 
0x12CB3460, 36963306110523472, 231022026, 231022029, 3, 640x360 
0x12CB3460, 36963306110843312, 231022065, 231022068, 3, 640x360 
0x12CB3460, 36963306111167904, 231022095, 231022098, 3, 640x360 
0x12CB3460, 36963306111482840, 231022125, 231022127, 2, 640x360 
0x12CB3460, 36963306111806352, 231022155, 231022158, 3, 640x360 
0x12CB3460, 36963306112123952, 231022186, 231022189, 3, 640x360 
0x12CB3460, 36963306112445224, 231022226, 231022229, 3, 640x360 
0x12CB3460, 36963306112768976, 231022255, 231022257, 2, 640x360 
0x12CB3460, 36963306113243680, 231022305, 231022307, 2, 640x360 
0x12CB3460, 36963306113565904, 231022335, 231022338, 3, 640x360 
0x12CB3460, 36963306114021336, 231022384, 231022387, 3, 640x360 
0x12CB3460, 36963306114203760, 231022396, 231022401, 5, 640x360 
0x12CB3460, 36963306114523600, 231022426, 231022429, 3, 640x360 
0x12CB3460, 36963306114843928, 231022465, 231022468, 3, 640x360 
0x12CB3460, 36963306115165160, 231022495, 231022497, 2, 640x360 
0x12CB3460, 36963306115485200, 231022525, 231022527, 2, 640x360 
0x12CB3460, 36963306115804704, 231022556, 231022559, 3, 640x360 
0x12CB3460, 36963306116126120, 231022596, 231022598, 2, 640x360 
0x12CB3460, 36963306116443960, 231022626, 231022629, 3, 640x360 
0x12CB3460, 36963306116764920, 231022656, 231022659, 3, 640x360 
0x12CB3460, 36963306117246448, 231022707, 231022710, 3, 640x360 
0x12CB3460, 36963306117563408, 231022735, 231022739, 4, 640x360 
0x12CB3460, 36963306117884408, 231022766, 231022768, 2, 640x360 
0x12CB3460, 36963306118204280, 231022796, 231022799, 3, 640x360 
0x12CB3460, 36963306118523464, 231022835, 231022837, 2, 640x360 
0x12CB3460, 36963306118992464, 231022876, 231022878, 2, 640x360 
0x12CB3460, 36963306119164128, 231022896, 231022898, 2, 640x360 
0x12CB3460, 36963306119483704, 231022924, 231022927, 3, 640x360 
0x12CB3460, 36963306119805136, 231022955, 231022958, 3, 640x360 
0x12CB3460, 36963306120129184, 231022995, 231022998, 3, 640x360 
0x12CB3460, 36963306120445800, 231023025, 231023028, 3, 640x360 
0x12CB3460, 36963306120926280, 231023066, 231023070, 4, 640x360 
0x12CB3460, 36963306121246040, 231023105, 231023108, 3, 640x360 
0x12CB3460, 36963306121564608, 231023135, 231023141, 6, 640x360 
0x12CB3460, 36963306121883272, 231023164, 231023167, 3, 640x360 
0x12CB3460, 36963306122203048, 231023196, 231023198, 2, 640x360 
0x12CB3460, 36963306122524584, 231023235, 231023238, 3, 640x360 
0x12CB3460, 36963306122848880, 231023266, 231023269, 3, 640x360 
0x12CB3460, 36963306123163616, 231023295, 231023298, 3, 640x360 
0x12CB3460, 36963306123484464, 231023325, 231023328, 3, 640x360 
0x12CB3460, 36963306123804304, 231023396, 231023399, 3, 640x360 
0x12CB3460, 36963306124445016, 231023425, 231023429, 4, 640x360 
0x12CB3460, 36963306124924480, 231023476, 231023479, 3, 640x360 
0x12CB3460, 36963306125243920, 231023505, 231023508, 3, 640x360 
0x12CB3460, 36963306125563640, 231023535, 231023538, 3, 640x360 
0x12CB3460, 36963306125884408, 231023565, 231023567, 2, 640x360 
0x12CB3460, 36963306126211544, 231023604, 231023607, 3, 640x360 
0x12CB3460, 36963306126523016, 231023635, 231023638, 3, 640x360 
0x12CB3460, 36963306126843848, 231023665, 231023682, 17, 640x360 
0x12CB3460, 36963306127164664, 231023695, 231023698, 3, 640x360 
0x12CB3460, 36963306127483888, 231023725, 231023728, 3, 640x360 
0x12CB3460, 36963306127805504, 231023755, 231023760, 5, 640x360 
0x12CB3460, 36963306128128336, 231023794, 231023797, 3, 640x360 
0x12CB3460, 36963306128444656, 231023825, 231023827, 2, 640x360 
0x12CB3460, 36963306129062400, 231023884, 231023887, 3, 640x360 
0x12CB3460, 36963306129244248, 231023907, 231023910, 3, 640x360 
0x12CB3460, 36963306129564424, 231023935, 231023938, 3, 640x360 
0x12CB3460, 36963306129884792, 231023965, 231023968, 3, 640x360 
0x12CB3460, 36963306130203968, 231023996, 231023998, 2, 640x360 
0x12CB3460, 36963306130524984, 231024035, 231024038, 3, 640x360 
0x12CB3460, 36963306130844464, 231024065, 231024068, 3, 640x360 
0x12CB3460, 36963306131164136, 231024095, 231024098, 3, 640x360 
0x12CB3460, 36963306131483728, 231024124, 231024127, 3, 640x360 
0x12CB3460, 36963306131804640, 231024155, 231024158, 3, 640x360 
0x12CB3460, 36963306132125600, 231024195, 231024198, 3, 640x360 
0x12CB3460, 36963306132603008, 231024236, 231024238, 2, 640x360 
0x12CB3460, 36963306132925320, 231024276, 231024281, 5, 640x360 
0x12CB3460, 36963306133243096, 231024305, 231024307, 2, 640x360 
0x12CB3460, 36963306133564640, 231024335, 231024338, 3, 640x360 
0x12CB3460, 36963306134017160, 231024386, 231024388, 2, 640x360 
0x12CB3460, 36963306134203952, 231024395, 231024397, 2, 640x360 
0x12CB3460, 36963306134525240, 231024434, 231024437, 3, 640x360 
0x12CB3460, 36963306134843920, 231024465, 231024468, 3, 640x360 
0x12CB3460, 36963306135165104, 231024495, 231024498, 3, 640x360 
0x12CB3460, 36963306135485624, 231024525, 231024527, 2, 640x360 
0x12CB3460, 36963306135806176, 231024558, 231024562, 4, 640x360 
0x12CB3460, 36963306136125104, 231024595, 231024601, 6, 640x360 
0x12CB3460, 36963306136605624, 231024635, 231024638, 3, 640x360 
0x12CB3460, 36963306136925720, 231024674, 231024677, 3, 640x360 
0x12CB3460, 36963306137244240, 231024706, 231024710, 4, 640x360 
0x12CB3460, 36963306137564408, 231024735, 231024737, 2, 640x360 
0x12CB3460, 36963306137884584, 231024765, 231024768, 3, 640x360 
0x12CB3460, 36963306138203696, 231024795, 231024798, 3, 640x360 
0x12CB3460, 36963306138523392, 231024826, 231024829, 3, 640x360 
0x12CB3460, 36963306138999912, 231024875, 231024878, 3, 640x360 
0x12CB3460, 36963306139164408, 231024895, 231024897, 2, 640x360 
0x12CB3460, 36963306139483696, 231024925, 231024927, 2, 640x360 
0x12CB3460, 36963306139804624, 231024954, 231024957, 3, 640x360 
0x12CB3460, 36963306140126328, 231024995, 231024998, 3, 640x360 
0x12CB3460, 36963306140605296, 231025037, 231025041, 4, 640x360 
0x12CB3460, 36963306140925696, 231025067, 231025071, 4, 640x360 
0x12CB3460, 36963306141244624, 231025104, 231025107, 3, 640x360 
0x12CB3460, 36963306141565024, 231025135, 231025138, 3, 640x360 
0x12CB3460, 36963306141886400, 231025165, 231025168, 3, 640x360 
0x12CB3460, 36963306142206360, 231025195, 231025199, 4, 640x360 
0x12CB3460, 36963306142524472, 231025226, 231025229, 3, 640x360 
0x12CB3460, 36963306142845096, 231025265, 231025268, 3, 640x360 
0x12CB3460, 36963306143165408, 231025295, 231025297, 2, 640x360 
0x12CB3460, 36963306143484648, 231025327, 231025330, 3, 640x360 
0x12CB3460, 36963306144121208, 231025396, 231025398, 2, 640x360 
0x12CB3460, 36963306144284440, 231025405, 231025411, 6, 640x360 
0x12CB3460, 36963306144603616, 231025436, 231025438, 2, 640x360 
0x12CB3460, 36963306144925208, 231025476, 231025479, 3, 640x360 
0x12CB3460, 36963306145244720, 231025505, 231025508, 3, 640x360 
0x12CB3460, 36963306145565056, 231025536, 231025538, 2, 640x360 
0x12CB3460, 36963306145886184, 231025566, 231025569, 3, 640x360 
0x12CB3460, 36963306146206040, 231025594, 231025598, 4, 640x360 
0x12CB3460, 36963306146525776, 231025635, 231025637, 2, 640x360 
0x12CB3460, 36963306146845032, 231025665, 231025668, 3, 640x360 
0x12CB3460, 36963306147168608, 231025696, 231025710, 14, 640x360 
0x12CB3460, 36963306147488256, 231025726, 231025730, 4, 640x360 
0x12CB3460, 36963306147803592, 231025755, 231025757, 2, 640x360 
0x12CB3460, 36963306148285072, 231025805, 231025808, 3, 640x360 
0x12CB3460, 36963306148605696, 231025836, 231025839, 3, 640x360 
0x12CB3460, 36963306148983648, 231025875, 231025880, 5, 640x360 
0x12CB3460, 36963306149243208, 231025906, 231025909, 3, 640x360 
0x12CB3460, 36963306149566248, 231025935, 231025937, 2, 640x360 
0x12CB3460, 36963306149883248, 231025966, 231025968, 2, 640x360 
0x12CB3460, 36963306150205016, 231025996, 231025998, 2, 640x360 
0x12CB3460, 36963306150523976, 231026026, 231026029, 3, 640x360 
0x12CB3460, 36963306150843440, 231026066, 231026068, 2, 640x360 
0x12CB3460, 36963306151169544, 231026096, 231026099, 3, 640x360 
0x12CB3460, 36963306151484904, 231026125, 231026128, 3, 640x360 
0x12CB3460, 36963306151964840, 231026175, 231026177, 2, 640x360 
0x12CB3460, 36963306152285328, 231026205, 231026209, 4, 640x360 
0x12CB3460, 36963306152603680, 231026235, 231026238, 3, 640x360 
0x12CB3460, 36963306152923448, 231026275, 231026278, 3, 640x360 
0x12CB3460, 36963306153244744, 231026305, 231026307, 2, 640x360 
0x12CB3460, 36963306153564632, 231026335, 231026337, 2, 640x360 
0x12CB3460, 36963306154047472, 231026385, 231026388, 3, 640x360 
0x12CB3460, 36963306154202576, 231026396, 231026398, 2, 640x360 
0x12CB3460, 36963306154524024, 231026435, 231026438, 3, 640x360 
0x12CB3460, 36963306154843760, 231026465, 231026468, 3, 640x360 
0x12CB3460, 36963306155165016, 231026494, 231026497, 3, 640x360 
0x12CB3460, 36963306155484712, 231026525, 231026527, 2, 640x360 
0x12CB3460, 36963306155966320, 231026576, 231026579, 3, 640x360 
0x12CB3460, 36963306156285952, 231026606, 231026610, 4, 640x360 
0x12CB3460, 36963306156605368, 231026636, 231026639, 3, 640x360 
0x12CB3460, 36963306156924408, 231026666, 231026669, 3, 640x360 
0x12CB3460, 36963306157245432, 231026705, 231026708, 3, 640x360 
0x12CB3460, 36963306157569328, 231026735, 231026737, 2, 640x360 
0x12CB3460, 36963306157884752, 231026765, 231026768, 3, 640x360 
0x12CB3460, 36963306158204144, 231026795, 231026797, 2, 640x360 
0x12CB3460, 36963306158524320, 231026825, 231026833, 8, 640x360 
0x12CB3460, 36963306159008368, 231026875, 231026879, 4, 640x360 
0x12CB3460, 36963306159163280, 231026894, 231026897, 3, 640x360 
0x12CB3460, 36963306159484760, 231026926, 231026928, 2, 640x360 
0x12CB3460, 36963306159963400, 231026975, 231026978, 3, 640x360 
0x12CB3460, 36963306160285064, 231027005, 231027008, 3, 640x360 
0x12CB3460, 36963306160607688, 231027046, 231027051, 5, 640x360 
0x12CB3460, 36963306160925024, 231027066, 231027069, 3, 640x360 
0x12CB3460, 36963306161243776, 231027105, 231027108, 3, 640x360 
0x12CB3460, 36963306161563976, 231027135, 231027137, 2, 640x360 
0x12CB3460, 36963306161885736, 231027165, 231027168, 3, 640x360 
0x12CB3460, 36963306162205376, 231027195, 231027197, 2, 640x360 
0x12CB3460, 36963306162524944, 231027235, 231027239, 4, 640x360 
0x12CB3460, 36963306162843928, 231027265, 231027268, 3, 640x360 
0x12CB3460, 36963306163163896, 231027295, 231027298, 3, 640x360 
0x12CB3460, 36963306163643168, 231027345, 231027372, 27, 640x360 
0x12CB3460, 36963306164018648, 231027376, 231027380, 4, 640x360 
0x12CB3460, 36963306164282968, 231027405, 231027408, 3, 640x360 
0x12CB3460, 36963306164604128, 231027436, 231027443, 7, 640x360 
0x12CB3460, 36963306164923776, 231027475, 231027478, 3, 640x360 
0x12CB3460, 36963306165249168, 231027505, 231027508, 3, 640x360 
0x12CB3460, 36963306165564656, 231027535, 231027538, 3, 640x360 
0x12CB3460, 36963306165884256, 231027565, 231027568, 3, 640x360 
0x12CB3460, 36963306166203280, 231027595, 231027598, 3, 640x360 
0x12CB3460, 36963306166523656, 231027625, 231027628, 3, 640x360 
0x12CB3460, 36963306166844704, 231027665, 231027668, 3, 640x360 
0x12CB3460, 36963306167164888, 231027695, 231027697, 2, 640x360 
0x12CB3460, 36963306167646160, 231027746, 231027748, 2, 640x360 
0x12CB3460, 36963306167965440, 231027775, 231027778, 3, 640x360 
0x12CB3460, 36963306168284864, 231027805, 231027808, 3, 640x360 
0x12CB3460, 36963306168605744, 231027835, 231027837, 2, 640x360 
0x12CB3460, 36963306169092880, 231027886, 231027889, 3, 640x360 
0x12CB3460, 36963306169243520, 231027905, 231027908, 3, 640x360 
0x12CB3460, 36963306169564536, 231027935, 231027937, 2, 640x360 
0x12CB3460, 36963306169887592, 231027965, 231027968, 3, 640x360 
0x12CB3460, 36963306170206328, 231027995, 231028008, 13, 640x360 
0x12CB3460, 36963306170524416, 231028025, 231028028, 3, 640x360 
0x12CB3460, 36963306170844368, 231028066, 231028068, 2, 640x360 
0x12CB3460, 36963306171171648, 231028095, 231028097, 2, 640x360 
0x12CB3460, 36963306171645240, 231028145, 231028148, 3, 640x360 
0x12CB3460, 36963306171965752, 231028175, 231028178, 3, 640x360 
0x12CB3460, 36963306172284160, 231028205, 231028208, 3, 640x360 
0x12CB3460, 36963306172605056, 231028235, 231028238, 3, 640x360 
0x12CB3460, 36963306172923760, 231028277, 231028280, 3, 640x360 
0x12CB3460, 36963306173243736, 231028305, 231028307, 2, 640x360 
0x12CB3460, 36963306173565048, 231028335, 231028338, 3, 640x360 
0x12CB3460, 36963306174080840, 231028385, 231028388, 3, 640x360 
0x12CB3460, 36963306174203920, 231028396, 231028398, 2, 640x360 
0x12CB3460, 36963306174523672, 231028435, 231028437, 2, 640x360 
0x12CB3460, 36963306174844360, 231028464, 231028467, 3, 640x360 
0x12CB3460, 36963306175326400, 231028515, 231028518, 3, 640x360 
0x12CB3460, 36963306175648048, 231028547, 231028551, 4, 640x360 
0x12CB3460, 36963306175965712, 231028575, 231028578, 3, 640x360 
0x12CB3460, 36963306176283352, 231028606, 231028614, 8, 640x360 
0x12CB3460, 36963306176604144, 231028635, 231028638, 3, 640x360 
0x12CB3460, 36963306176923544, 231028675, 231028677, 2, 640x360 
0x12CB3460, 36963306177246048, 231028705, 231028708, 3, 640x360 
0x12CB3460, 36963306177563712, 231028734, 231028737, 3, 640x360 
0x12CB3460, 36963306177886336, 231028765, 231028768, 3, 640x360 
0x12CB3460, 36963306178204304, 231028795, 231028797, 2, 640x360 
0x12CB3460, 36963306178524672, 231028826, 231028829, 3, 640x360 
0x12CB3460, 36963306178994880, 231028875, 231028878, 3, 640x360 
0x12CB3460, 36963306179322864, 231028906, 231028909, 3, 640x360 
0x12CB3460, 36963306179644640, 231028945, 231028947, 2, 640x360 
0x12CB3460, 36963306179964800, 231028975, 231028977, 2, 640x360 
0x12CB3460, 36963306180284752, 231029004, 231029007, 3, 640x360 
0x12CB3460, 36963306180605968, 231029034, 231029038, 4, 640x360 
0x12CB3460, 36963306180923728, 231029066, 231029069, 3, 640x360 
0x12CB3460, 36963306181245864, 231029105, 231029108, 3, 640x360 
0x12CB3460, 36963306181562760, 231029136, 231029138, 2, 640x360 
0x12CB3460, 36963306181885240, 231029165, 231029167, 2, 640x360 
0x12CB3460, 36963306182205848, 231029194, 231029197, 3, 640x360 
0x12CB3460, 36963306182524472, 231029226, 231029229, 3, 640x360 
0x12CB3460, 36963306182845016, 231029266, 231029268, 2, 640x360 
0x12CB3460, 36963306183323096, 231029306, 231029310, 4, 640x360 
0x12CB3460, 36963306183645088, 231029371, 231029376, 5, 640x360 
0x12CB3460, 36963306184283160, 231029404, 231029406, 2, 640x360 
0x12CB3460, 36963306184603168, 231029436, 231029440, 4, 640x360 
0x12CB3460, 36963306184924480, 231029466, 231029469, 3, 640x360 
0x12CB3460, 36963306185243688, 231029504, 231029507, 3, 640x360 
0x12CB3460, 36963306185564176, 231029535, 231029538, 3, 640x360 
0x12CB3460, 36963306185887096, 231029566, 231029570, 4, 640x360 
0x12CB3460, 36963306186206264, 231029594, 231029599, 5, 640x360 
0x12CB3460, 36963306186525576, 231029635, 231029640, 5, 640x360 
0x12CB3460, 36963306187005608, 231029675, 231029684, 9, 640x360 
0x12CB3460, 36963306187325704, 231029717, 231029720, 3, 640x360 
0x12CB3460, 36963306187647152, 231029745, 231029748, 3, 640x360 
0x12CB3460, 36963306187967056, 231029775, 231029781, 6, 640x360 
0x12CB3460, 36963306188284416, 231029805, 231029808, 3, 640x360 
0x12CB3460, 36963306188603080, 231029835, 231029838, 3, 640x360 
0x12CB3460, 36963306189022952, 231029885, 231029888, 3, 640x360 
0x12CB3460, 36963306189244240, 231029906, 231029909, 3, 640x360 
0x12CB3460, 36963306189562608, 231029936, 231029938, 2, 640x360 
0x12CB3460, 36963306189888896, 231029965, 231029968, 3, 640x360 
0x12CB3460, 36963306190204344, 231029995, 231029998, 3, 640x360 
0x12CB3460, 36963306190523744, 231030035, 231030038, 3, 640x360 
0x12CB3460, 36963306191003464, 231030089, 231030102, 13, 640x360 
0x12CB3460, 36963306191323296, 231030126, 231030133, 7, 640x360 
0x12CB3460, 36963306191647032, 231030145, 231030148, 3, 640x360 
0x12CB3460, 36963306191964520, 231030178, 231030182, 4, 640x360 
0x12CB3460, 36963306192284072, 231030205, 231030209, 4, 640x360 
0x12CB3460, 36963306192603520, 231030236, 231030239, 3, 640x360 
0x12CB3460, 36963306192926720, 231030275, 231030278, 3, 640x360 
0x12CB3460, 36963306193242960, 231030305, 231030308, 3, 640x360 
0x12CB3460, 36963306193562904, 231030335, 231030337, 2, 640x360 
0x12CB3460, 36963306194063320, 231030385, 231030388, 3, 640x360 
0x12CB3460, 36963306194203656, 231030395, 231030398, 3, 640x360 
0x12CB3460, 36963306194683288, 231030446, 231030449, 3, 640x360 
0x12CB3460, 36963306195002568, 231030475, 231030477, 2, 640x360 
0x12CB3460, 36963306195324512, 231030506, 231030509, 3, 640x360 
0x12CB3460, 36963306195643944, 231030545, 231030548, 3, 640x360 
0x12CB3460, 36963306195964224, 231030575, 231030577, 2, 640x360 
0x12CB3460, 36963306196284104, 231030605, 231030608, 3, 640x360 
0x12CB3460, 36963306196605560, 231030636, 231030639, 3, 640x360 
0x12CB3460, 36963306196926088, 231030675, 231030677, 2, 640x360 
0x12CB3460, 36963306197243584, 231030704, 231030708, 4, 640x360 
0x12CB3460, 36963306197662512, 231030745, 231030747, 2, 640x360 
0x12CB3460, 36963306197884640, 231030765, 231030768, 3, 640x360 
0x12CB3460, 36963306198202976, 231030796, 231030799, 3, 640x360 
0x12CB3460, 36963306198683832, 231030844, 231030847, 3, 640x360 
0x12CB3460, 36963306199077936, 231030885, 231030888, 3, 640x360 
0x12CB3460, 36963306199323888, 231030917, 231030919, 2, 640x360 
0x12CB3460, 36963306199643048, 231030946, 231030948, 2, 640x360 
0x12CB3460, 36963306199962992, 231030974, 231030977, 3, 640x360 
0x12CB3460, 36963306200286912, 231031006, 231031011, 5, 640x360 
0x12CB3460, 36963306200603600, 231031038, 231031042, 4, 640x360 
0x12CB3460, 36963306201048968, 231031086, 231031091, 5, 640x360 
0x12CB3460, 36963306201244408, 231031135, 231031162, 27, 640x360 
0x12CB3460, 36963306201887008, 231031176, 231031194, 18, 640x360 
0x12CB3460, 36963306202250856, 231031226, 231031230, 4, 640x360 
0x12CB3460, 36963306202683320, 231031245, 231031248, 3, 640x360 
0x12CB3460, 36963306203010480, 231031285, 231031288, 3, 640x360 
0x12CB3460, 36963306203322880, 231031316, 231031319, 3, 640x360 
0x12CB3460, 36963306203643144, 231031345, 231031348, 3, 640x360 
0x12CB3460, 36963306204019976, 231031385, 231031388, 3, 640x360 
0x12CB3460, 36963306204283600, 231031406, 231031414, 8, 640x360 
0x12CB3460, 36963306204603664, 231031444, 231031447, 3, 640x360 
0x12CB3460, 36963306204923928, 231031475, 231031478, 3, 640x360 
0x12CB3460, 36963306205245112, 231031504, 231031507, 3, 640x360 
0x12CB3460, 36963306205563088, 231031535, 231031538, 3, 640x360 
0x12CB3460, 36963306205883944, 231031564, 231031567, 3, 640x360 
0x12CB3460, 36963306206362472, 231031615, 231031617, 2, 640x360 
0x12CB3460, 36963306206684616, 231031644, 231031647, 3, 640x360 
0x12CB3460, 36963306207004640, 231031676, 231031679, 3, 640x360 
0x12CB3460, 36963306207325936, 231031716, 231031718, 2, 640x360 
0x12CB3460, 36963306207642760, 231031745, 231031749, 4, 640x360 
0x12CB3460, 36963306207962544, 231031775, 231031777, 2, 640x360 
0x12CB3460, 36963306208285208, 231031805, 231031808, 3, 640x360 
0x12CB3460, 36963306208602360, 231031834, 231031837, 3, 640x360 
0x12CB3460, 36963306208983008, 231031874, 231031877, 3, 640x360 
0x12CB3460, 36963306209243952, 231031905, 231031908, 3, 640x360 
0x12CB3460, 36963306209565336, 231031935, 231031938, 3, 640x360 
0x12CB3460, 36963306209883888, 231031966, 231031970, 4, 640x360 
0x12CB3460, 36963306210362568, 231032015, 231032017, 2, 640x360 
0x12CB3460, 36963306210685160, 231032045, 231032048, 3, 640x360 
0x12CB3460, 36963306211003784, 231032075, 231032078, 3, 640x360 
0x12CB3460, 36963306211323896, 231032105, 231032109, 4, 640x360 
0x12CB3460, 36963306211644752, 231032144, 231032147, 3, 640x360 
0x12CB3460, 36963306211965128, 231032176, 231032178, 2, 640x360 
0x12CB3460, 36963306212283920, 231032205, 231032208, 3, 640x360 
0x12CB3460, 36963306212602696, 231032235, 231032238, 3, 640x360 
0x12CB3460, 36963306212923840, 231032275, 231032282, 7, 640x360 
0x12CB3460, 36963306213244704, 231032304, 231032307, 3, 640x360 
0x12CB3460, 36963306213564600, 231032335, 231032338, 3, 640x360 
0x12CB3460, 36963306214072960, 231032385, 231032388, 3, 640x360 
0x12CB3460, 36963306214364312, 231032415, 231032418, 3, 640x360 
0x12CB3460, 36963306214687336, 231032445, 231032449, 4, 640x360 
0x12CB3460, 36963306215004776, 231032476, 231032478, 2, 640x360 
0x12CB3460, 36963306215323936, 231032515, 231032518, 3, 640x360 
0x12CB3460, 36963306215643352, 231032545, 231032547, 2, 640x360 
0x12CB3460, 36963306215964856, 231032575, 231032579, 4, 640x360 
0x12CB3460, 36963306216284344, 231032604, 231032607, 3, 640x360 
0x12CB3460, 36963306216606080, 231032634, 231032638, 4, 640x360 
0x12CB3460, 36963306216923968, 231032674, 231032677, 3, 640x360 
0x12CB3460, 36963306217245312, 231032705, 231032708, 3, 640x360 
0x12CB3460, 36963306217564608, 231032736, 231032739, 3, 640x360 
0x12CB3460, 36963306218043112, 231032786, 231032792, 6, 640x360 
0x12CB3460, 36963306218364496, 231032815, 231032817, 2, 640x360 
0x12CB3460, 36963306218684016, 231032845, 231032848, 3, 640x360 
0x12CB3460, 36963306219073824, 231032886, 231032889, 3, 640x360 
0x12CB3460, 36963306219322232, 231032906, 231032910, 4, 640x360 
0x12CB3460, 36963306219644176, 231032945, 231032950, 5, 640x360 
0x12CB3460, 36963306219962416, 231032975, 231032977, 2, 640x360 
0x12CB3460, 36963306220283432, 231033005, 231033008, 3, 640x360 
0x12CB3460, 36963306220604208, 231033035, 231033039, 4, 640x360 
0x12CB3460, 36963306220923304, 231033066, 231033070, 4, 640x360 
0x12CB3460, 36963306221243432, 231033106, 231033109, 3, 640x360 
0x12CB3460, 36963306221563952, 231033134, 231033152, 18, 640x360 
0x12CB3460, 36963306222044160, 231033186, 231033188, 2, 640x360 
0x12CB3460, 36963306222363808, 231033216, 231033218, 2, 640x360 
0x12CB3460, 36963306222683496, 231033246, 231033250, 4, 640x360 
0x12CB3460, 36963306223002400, 231033275, 231033278, 3, 640x360 
0x12CB3460, 36963306223322992, 231033315, 231033318, 3, 640x360 
0x12CB3460, 36963306223644368, 231033344, 231033383, 39, 640x360 
0x12CB3460, 36963306224081728, 231033384, 231033389, 5, 640x360 
0x12CB3460, 36963306224282384, 231033405, 231033408, 3, 640x360 
0x12CB3460, 36963306224603736, 231033435, 231033438, 3, 640x360 
0x12CB3460, 36963306224924264, 231033475, 231033480, 5, 640x360 
0x12CB3460, 36963306225243224, 231033505, 231033508, 3, 640x360 
0x12CB3460, 36963306225564968, 231033535, 231033538, 3, 640x360 
0x12CB3460, 36963306226044920, 231033586, 231033588, 2, 640x360 
0x12CB3460, 36963306226363984, 231033615, 231033619, 4, 640x360 
0x12CB3460, 36963306226683320, 231033645, 231033648, 3, 640x360 
0x12CB3460, 36963306227003808, 231033675, 231033678, 3, 640x360 
0x12CB3460, 36963306227324376, 231033715, 231033718, 3, 640x360 
0x12CB3460, 36963306227644120, 231033746, 231033748, 2, 640x360 
0x12CB3460, 36963306227964168, 231033775, 231033778, 3, 640x360 
0x12CB3460, 36963306228283512, 231033805, 231033807, 2, 640x360 
0x12CB3460, 36963306228603632, 231033836, 231033838, 2, 640x360 
0x12CB3460, 36963306229090920, 231033896, 231033899, 3, 640x360 
0x12CB3460, 36963306229243264, 231033905, 231033908, 3, 640x360 
0x12CB3460, 36963306229724328, 231033955, 231033957, 2, 640x360 
0x12CB3460, 36963306230043104, 231033985, 231033988, 3, 640x360 
0x12CB3460, 36963306230362544, 231034014, 231034018, 4, 640x360 
0x12CB3460, 36963306230685736, 231034045, 231034054, 9, 640x360 
0x12CB3460, 36963306231003608, 231034075, 231034077, 2, 640x360 
0x12CB3460, 36963306231323360, 231034114, 231034117, 3, 640x360 
0x12CB3460, 36963306231642656, 231034146, 231034148, 2, 640x360 
0x12CB3460, 36963306231962760, 231034174, 231034177, 3, 640x360 
0x12CB3460, 36963306232283144, 231034205, 231034208, 3, 640x360 
0x12CB3460, 36963306232602720, 231034235, 231034238, 3, 640x360 
0x12CB3460, 36963306232923016, 231034265, 231034269, 4, 640x360 
0x12CB3460, 36963306233243720, 231034305, 231034308, 3, 640x360 
0x12CB3460, 36963306233725160, 231034377, 231034380, 3, 640x360 
0x12CB3460, 36963306234062328, 231034386, 231034388, 2, 640x360 
0x12CB3460, 36963306234362400, 231034415, 231034417, 2, 640x360 
0x12CB3460, 36963306234683944, 231034445, 231034449, 4, 640x360 
0x12CB3460, 36963306235003592, 231034474, 231034478, 4, 640x360 
0x12CB3460, 36963306235323592, 231034515, 231034518, 3, 640x360 
0x12CB3460, 36963306235644024, 231034546, 231034549, 3, 640x360 
0x12CB3460, 36963306235962736, 231034575, 231034578, 3, 640x360 
0x12CB3460, 36963306236284592, 231034605, 231034609, 4, 640x360 
0x12CB3460, 36963306236603880, 231034635, 231034639, 4, 640x360 
0x12CB3460, 36963306236923496, 231034665, 231034669, 4, 640x360 
0x12CB3460, 36963306237406248, 231034715, 231034719, 4, 640x360 
0x12CB3460, 36963306237722752, 231034745, 231034748, 3, 640x360 
0x12CB3460, 36963306238045504, 231034785, 231034788, 3, 640x360 
0x12CB3460, 36963306238362896, 231034815, 231034817, 2, 640x360 
0x12CB3460, 36963306238685016, 231034845, 231034873, 28, 640x360 
0x12CB3460, 36963306239023512, 231034885, 231034888, 3, 640x360 
0x12CB3460, 36963306239324016, 231034905, 231034910, 5, 640x360 
0x12CB3460, 36963306239643984, 231034945, 231034947, 2, 640x360 
0x12CB3460, 36963306239964592, 231034975, 231034977, 2, 640x360 
0x12CB3460, 36963306240282776, 231035005, 231035008, 3, 640x360 
0x12CB3460, 36963306240603392, 231035034, 231035038, 4, 640x360 
0x12CB3460, 36963306240924080, 231035066, 231035070, 4, 640x360 
0x12CB3460, 36963306241403936, 231035115, 231035118, 3, 640x360 
0x12CB3460, 36963306241722448, 231035145, 231035149, 4, 640x360 
0x12CB3460, 36963306242044184, 231035185, 231035188, 3, 640x360 
0x12CB3460, 36963306242366784, 231035215, 231035218, 3, 640x360 
0x12CB3460, 36963306242684264, 231035246, 231035249, 3, 640x360 
0x12CB3460, 36963306243003808, 231035275, 231035278, 3, 640x360 
0x12CB3460, 36963306243324368, 231035306, 231035310, 4, 640x360 
0x12CB3460, 36963306243643336, 231035344, 231035347, 3, 640x360 
0x12CB3460, 36963306244076744, 231035385, 231035389, 4, 640x360 
0x12CB3460, 36963306244283456, 231035405, 231035408, 3, 640x360 
0x12CB3460, 36963306244604416, 231035436, 231035439, 3, 640x360 
0x12CB3460, 36963306244925088, 231035476, 231035480, 4, 640x360 
0x12CB3460, 36963306245405400, 231035515, 231035519, 4, 640x360 
0x12CB3460, 36963306245723008, 231035556, 231035560, 4, 640x360 
0x12CB3460, 36963306246043552, 231035585, 231035588, 3, 640x360 
0x12CB3460, 36963306246364608, 231035616, 231035620, 4, 640x360 
0x12CB3460, 36963306246683736, 231035645, 231035647, 2, 640x360 
0x12CB3460, 36963306247003424, 231035674, 231035678, 4, 640x360 
0x12CB3460, 36963306247322672, 231035715, 231035718, 3, 640x360 
0x12CB3460, 36963306247643512, 231035745, 231035748, 3, 640x360 
0x12CB3460, 36963306247963816, 231035775, 231035778, 3, 640x360 
0x12CB3460, 36963306248287488, 231035805, 231035809, 4, 640x360 
0x12CB3460, 36963306248602736, 231035835, 231035838, 3, 640x360 
0x12CB3460, 36963306249082104, 231035884, 231035887, 3, 640x360 
0x12CB3460, 36963306249402024, 231035916, 231035919, 3, 640x360 
0x12CB3460, 36963306249722304, 231035946, 231035950, 4, 640x360 
0x12CB3460, 36963306250043160, 231035986, 231035989, 3, 640x360 
0x12CB3460, 36963306250362528, 231036015, 231036018, 3, 640x360 
0x12CB3460, 36963306250684688, 231036045, 231036048, 3, 640x360 
0x12CB3460, 36963306251003232, 231036076, 231036078, 2, 640x360 
0x12CB3460, 36963306251323248, 231036115, 231036118, 3, 640x360 
0x12CB3460, 36963306251643040, 231036145, 231036148, 3, 640x360 
0x12CB3460, 36963306251962872, 231036175, 231036178, 3, 640x360 
0x12CB3460, 36963306252283688, 231036204, 231036207, 3, 640x360 
0x12CB3460, 36963306252603896, 231036235, 231036238, 3, 640x360 
0x12CB3460, 36963306253083960, 231036285, 231036288, 3, 640x360 
0x12CB3460, 36963306253403880, 231036315, 231036318, 3, 640x360 
0x12CB3460, 36963306253722016, 231036369, 231036373, 4, 640x360 
0x12CB3460, 36963306254043768, 231036385, 231036388, 3, 640x360 
0x12CB3460, 36963306254362872, 231036415, 231036418, 3, 640x360 
0x12CB3460, 36963306254683584, 231036445, 231036448, 3, 640x360 
0x12CB3460, 36963306255004296, 231036475, 231036478, 3, 640x360 
0x12CB3460, 36963306255323936, 231036515, 231036518, 3, 640x360 
0x12CB3460, 36963306255645328, 231036546, 231036549, 3, 640x360 
0x12CB3460, 36963306255964424, 231036575, 231036578, 3, 640x360 
0x12CB3460, 36963306256285792, 231036605, 231036608, 3, 640x360 
0x12CB3460, 36963306256603736, 231036635, 231036639, 4, 640x360 
0x12CB3460, 36963306257084672, 231036685, 231036688, 3, 640x360 
0x12CB3460, 36963306257405008, 231036716, 231036720, 4, 640x360 
0x12CB3460, 36963306257723656, 231036746, 231036749, 3, 640x360 
0x12CB3460, 36963306258043216, 231036786, 231036789, 3, 640x360 
0x12CB3460, 36963306258363552, 231036815, 231036818, 3, 640x360 
0x12CB3460, 36963306258683560, 231036844, 231036847, 3, 640x360 
0x12CB3460, 36963306259127400, 231036888, 231036892, 4, 640x360 
0x12CB3460, 36963306259322968, 231036905, 231036910, 5, 640x360 
0x12CB3460, 36963306259642776, 231036945, 231036947, 2, 640x360 
0x12CB3460, 36963306259967984, 231036975, 231036978, 3, 640x360 
0x12CB3460, 36963306260282872, 231037004, 231037007, 3, 640x360 
0x12CB3460, 36963306260763904, 231037055, 231037059, 4, 640x360 
0x12CB3460, 36963306261085680, 231037085, 231037088, 3, 640x360 
0x12CB3460, 36963306261408072, 231037116, 231037119, 3, 640x360 
0x12CB3460, 36963306261724288, 231037155, 231037158, 3, 640x360 
0x12CB3460, 36963306262044648, 231037185, 231037188, 3, 640x360 
0x12CB3460, 36963306262369056, 231037216, 231037219, 3, 640x360 
0x12CB3460, 36963306262682600, 231037246, 231037248, 2, 640x360 
0x12CB3460, 36963306263003088, 231037275, 231037278, 3, 640x360 
0x12CB3460, 36963306263322448, 231037305, 231037310, 5, 640x360 
0x12CB3460, 36963306263643952, 231037375, 231037381, 6, 640x360 
0x12CB3460, 36963306264060408, 231037381, 231037387, 6, 640x360 
0x12CB3460, 36963306264289200, 231037406, 231037409, 3, 640x360 
0x12CB3460, 36963306264764088, 231037456, 231037461, 5, 640x360 
0x12CB3460, 36963306265083936, 231037485, 231037488, 3, 640x360 
0x12CB3460, 36963306265402872, 231037515, 231037518, 3, 640x360 
0x12CB3460, 36963306265726216, 231037555, 231037558, 3, 640x360 
0x12CB3460, 36963306266043416, 231037585, 231037603, 18, 640x360 
0x12CB3460, 36963306266367096, 231037614, 231037617, 3, 640x360 
0x12CB3460, 36963306266683344, 231037644, 231037647, 3, 640x360 
0x12CB3460, 36963306267004536, 231037675, 231037679, 4, 640x360 
0x12CB3460, 36963306267322624, 231037715, 231037721, 6, 640x360 
0x12CB3460, 36963306267664256, 231037746, 231037750, 4, 640x360 
0x12CB3460, 36963306267987416, 231037788, 231037797, 9, 640x360 
0x12CB3460, 36963306268444024, 231037824, 231037827, 3, 640x360 
0x12CB3460, 36963306268995352, 231037876, 231037882, 6, 640x360 
0x12CB3460, 36963306269423592, 231037926, 231037930, 4, 640x360 
0x12CB3460, 36963306269722376, 231037945, 231037949, 4, 640x360 
0x12CB3460, 36963306270044224, 231037986, 231037989, 3, 640x360 
0x12CB3460, 36963306270365568, 231038015, 231038017, 2, 640x360 
0x12CB3460, 36963306270683864, 231038046, 231038049, 3, 640x360 
0x12CB3460, 36963306271002800, 231038075, 231038078, 3, 640x360 
0x12CB3460, 36963306271642768, 231038145, 231038148, 3, 640x360 
0x12CB3460, 36963306271962752, 231038174, 231038177, 3, 640x360 
0x12CB3460, 36963306272442400, 231038225, 231038228, 3, 640x360 
0x12CB3460, 36963306272763304, 231038255, 231038258, 3, 640x360 
0x12CB3460, 36963306273082920, 231038285, 231038287, 2, 640x360 
0x12CB3460, 36963306273403936, 231038315, 231038318, 3, 640x360 
0x12CB3460, 36963306273722888, 231038379, 231038382, 3, 640x360 
0x12CB3460, 36963306274078848, 231038386, 231038388, 2, 640x360 
0x12CB3460, 36963306274362776, 231038414, 231038417, 3, 640x360 
0x12CB3460, 36963306274683544, 231038445, 231038448, 3, 640x360 
0x12CB3460, 36963306275067600, 231038486, 231038490, 4, 640x360 
0x12CB3460, 36963306275322168, 231038515, 231038517, 2, 640x360 
0x12CB3460, 36963306275646016, 231038546, 231038548, 2, 640x360 
0x12CB3460, 36963306275964336, 231038576, 231038579, 3, 640x360 
0x12CB3460, 36963306276443536, 231038624, 231038627, 3, 640x360 
0x12CB3460, 36963306276764128, 231038656, 231038661, 5, 640x360 
0x12CB3460, 36963306277081824, 231038685, 231038688, 3, 640x360 
0x12CB3460, 36963306277402408, 231038716, 231038718, 2, 640x360 
0x12CB3460, 36963306277723712, 231038756, 231038758, 2, 640x360 
0x12CB3460, 36963306278044288, 231038785, 231038788, 3, 640x360 
0x12CB3460, 36963306278363064, 231038815, 231038818, 3, 640x360 
0x12CB3460, 36963306278682816, 231038845, 231038875, 30, 640x360 
0x12CB3460, 36963306279043560, 231038885, 231038888, 3, 640x360 
0x12CB3460, 36963306279323280, 231038906, 231038910, 4, 640x360 
0x12CB3460, 36963306279643120, 231038945, 231038947, 2, 640x360 
0x12CB3460, 36963306280125520, 231038986, 231038991, 5, 640x360 
0x12CB3460, 36963306280444064, 231039025, 231039035, 10, 640x360 
0x12CB3460, 36963306280762992, 231039054, 231039058, 4, 640x360 
0x12CB3460, 36963306281083424, 231039086, 231039089, 3, 640x360 
0x12CB3460, 36963306281403520, 231039115, 231039118, 3, 640x360 
0x12CB3460, 36963306281723408, 231039154, 231039157, 3, 640x360 
0x12CB3460, 36963306282044136, 231039185, 231039188, 3, 640x360 
0x12CB3460, 36963306282363376, 231039215, 231039220, 5, 640x360 
0x12CB3460, 36963306282682688, 231039245, 231039248, 3, 640x360 
0x12CB3460, 36963306283003176, 231039275, 231039278, 3, 640x360 
0x12CB3460, 36963306283326384, 231039315, 231039318, 3, 640x360 
0x12CB3460, 36963306283644816, 231039377, 231039380, 3, 640x360 
0x12CB3460, 36963306284121528, 231039386, 231039389, 3, 640x360 
0x12CB3460, 36963306284442504, 231039424, 231039427, 3, 640x360 
0x12CB3460, 36963306284763216, 231039455, 231039458, 3, 640x360 
0x12CB3460, 36963306285082392, 231039485, 231039488, 3, 640x360 
0x12CB3460, 36963306285404072, 231039515, 231039518, 3, 640x360 
0x12CB3460, 36963306285724776, 231039555, 231039557, 2, 640x360 
0x12CB3460, 36963306286044296, 231039585, 231039588, 3, 640x360 
0x12CB3460, 36963306286361784, 231039615, 231039618, 3, 640x360 
0x12CB3460, 36963306286683488, 231039646, 231039650, 4, 640x360 
0x12CB3460, 36963306287003360, 231039675, 231039678, 3, 640x360 
0x12CB3460, 36963306287322528, 231039715, 231039718, 3, 640x360 
0x12CB3460, 36963306287643200, 231039745, 231039748, 3, 640x360 
0x12CB3460, 36963306288123104, 231039795, 231039798, 3, 640x360 
0x12CB3460, 36963306288449616, 231039825, 231039827, 2, 640x360 
0x12CB3460, 36963306288768376, 231039875, 231039878, 3, 640x360 
0x12CB3460, 36963306289083840, 231039886, 231039889, 3, 640x360 
0x12CB3460, 36963306289402696, 231039916, 231039919, 3, 640x360 
0x12CB3460, 36963306289723160, 231039946, 231039949, 3, 640x360 
0x12CB3460, 36963306290042592, 231039985, 231039988, 3, 640x360 
0x12CB3460, 36963306290361968, 231040015, 231040018, 3, 640x360 
0x12CB3460, 36963306290683752, 231040045, 231040049, 4, 640x360 
0x12CB3460, 36963306291021248, 231040085, 231040088, 3, 640x360 
0x12CB3460, 36963306291322736, 231040116, 231040119, 3, 640x360 
0x12CB3460, 36963306291801680, 231040155, 231040158, 3, 640x360 
0x12CB3460, 36963306292123472, 231040195, 231040198, 3, 640x360 
0x12CB3460, 36963306292445864, 231040225, 231040228, 3, 640x360 
0x12CB3460, 36963306292763448, 231040254, 231040258, 4, 640x360 
0x12CB3460, 36963306293082352, 231040285, 231040288, 3, 640x360 
0x12CB3460, 36963306293403240, 231040315, 231040318, 3, 640x360 
0x12CB3460, 36963306293724272, 231040374, 231040378, 4, 640x360 
0x12CB3460, 36963306294044352, 231040378, 231040383, 5, 640x360 
0x12CB3460, 36963306294362952, 231040415, 231040418, 3, 640x360 
0x12CB3460, 36963306294684056, 231040445, 231040449, 4, 640x360 
0x12CB3460, 36963306295003224, 231040475, 231040477, 2, 640x360 
0x12CB3460, 36963306295322920, 231040505, 231040509, 4, 640x360 
0x12CB3460, 36963306295803608, 231040555, 231040558, 3, 640x360 
0x12CB3460, 36963306296124304, 231040595, 231040598, 3, 640x360 
0x12CB3460, 36963306296442744, 231040625, 231040627, 2, 640x360 
0x12CB3460, 36963306296762152, 231040654, 231040657, 3, 640x360 
0x12CB3460, 36963306297083184, 231040685, 231040688, 3, 640x360 
0x12CB3460, 36963306297403240, 231040714, 231040718, 4, 640x360 
0x12CB3460, 36963306297723808, 231040746, 231040749, 3, 640x360 
0x12CB3460, 36963306298043984, 231040786, 231040788, 2, 640x360 
0x12CB3460, 36963306298363792, 231040815, 231040832, 17, 640x360 
0x12CB3460, 36963306298683912, 231040861, 231040873, 12, 640x360 
0x12CB3460, 36963306299023368, 231040885, 231040888, 3, 640x360 
0x12CB3460, 36963306299323896, 231040906, 231040909, 3, 640x360 
0x12CB3460, 36963306299801928, 231040955, 231040958, 3, 640x360 
0x12CB3460, 36963306300123384, 231040995, 231040998, 3, 640x360 
0x12CB3460, 36963306300442448, 231041025, 231041027, 2, 640x360 
0x12CB3460, 36963306300763000, 231041055, 231041058, 3, 640x360 
0x12CB3460, 36963306301083088, 231041085, 231041087, 2, 640x360 
0x12CB3460, 36963306301402984, 231041116, 231041119, 3, 640x360 
0x12CB3460, 36963306301722328, 231041155, 231041158, 3, 640x360 
0x12CB3460, 36963306302043712, 231041186, 231041188, 2, 640x360 
0x12CB3460, 36963306302362752, 231041215, 231041218, 3, 640x360 
0x12CB3460, 36963306302683024, 231041245, 231041248, 3, 640x360 
0x12CB3460, 36963306303003160, 231041275, 231041278, 3, 640x360 
0x12CB3460, 36963306303482344, 231041325, 231041328, 3, 640x360 
0x12CB3460, 36963306304082880, 231041385, 231041388, 3, 640x360 
0x12CB3460, 36963306304124488, 231041395, 231041399, 4, 640x360 
0x12CB3460, 36963306304445000, 231041425, 231041427, 2, 640x360 
0x12CB3460, 36963306304763568, 231041455, 231041459, 4, 640x360 
0x12CB3460, 36963306305084192, 231041484, 231041487, 3, 640x360 
0x12CB3460, 36963306305723232, 231041555, 231041558, 3, 640x360 
0x12CB3460, 36963306306044456, 231041585, 231041588, 3, 640x360 
0x12CB3460, 36963306306362752, 231041615, 231041618, 3, 640x360 
0x12CB3460, 36963306306684464, 231041645, 231041649, 4, 640x360 
0x12CB3460, 36963306307002920, 231041674, 231041678, 4, 640x360 
0x12CB3460, 36963306307483760, 231041725, 231041728, 3, 640x360 
0x12CB3460, 36963306307802040, 231041755, 231041758, 3, 640x360 
0x12CB3460, 36963306308121880, 231041798, 231041807, 9, 640x360 
0x12CB3460, 36963306308442312, 231041825, 231041828, 3, 640x360 
0x12CB3460, 36963306308763568, 231041890, 231041895, 5, 640x360 
0x12CB3460, 36963306309406400, 231041915, 231041920, 5, 640x360 
0x12CB3460, 36963306309724288, 231041955, 231041958, 3, 640x360 
0x12CB3460, 36963306310046584, 231041986, 231041989, 3, 640x360 
0x12CB3460, 36963306310364040, 231042015, 231042018, 3, 640x360 
0x12CB3460, 36963306310682488, 231042045, 231042048, 3, 640x360 
0x12CB3460, 36963306311161600, 231042095, 231042098, 3, 640x360 
0x12CB3460, 36963306311482600, 231042125, 231042129, 4, 640x360 
0x12CB3460, 36963306311803368, 231042165, 231042168, 3, 640x360 
0x12CB3460, 36963306312443816, 231042225, 231042230, 5, 640x360 
0x12CB3460, 36963306312764200, 231042255, 231042258, 3, 640x360 
0x12CB3460, 36963306313082616, 231042286, 231042289, 3, 640x360 
0x12CB3460, 36963306313402944, 231042316, 231042319, 3, 640x360 
0x12CB3460, 36963306313723104, 231042385, 231042389, 4, 640x360 
0x12CB3460, 36963306314365696, 231042415, 231042419, 4, 640x360 
0x12CB3460, 36963306314684048, 231042445, 231042448, 3, 640x360 
0x12CB3460, 36963306315163224, 231042494, 231042498, 4, 640x360 
0x12CB3460, 36963306315481600, 231042525, 231042528, 3, 640x360 
0x12CB3460, 36963306315802928, 231042560, 231042567, 7, 640x360 
0x12CB3460, 36963306316123224, 231042595, 231042598, 3, 640x360 
0x12CB3460, 36963306316448904, 231042624, 231042628, 4, 640x360 
0x12CB3460, 36963306316762256, 231042655, 231042659, 4, 640x360 
0x12CB3460, 36963306317082912, 231042696, 231042699, 3, 640x360 
0x12CB3460, 36963306317402472, 231042715, 231042720, 5, 640x360 
0x12CB3460, 36963306317723016, 231042755, 231042758, 3, 640x360 
0x12CB3460, 36963306318045984, 231042788, 231042791, 3, 640x360 
0x12CB3460, 36963306318364304, 231042815, 231042818, 3, 640x360 
0x12CB3460, 36963306318699576, 231042845, 231042878, 33, 640x360 
0x12CB3460, 36963306319163384, 231042895, 231042898, 3, 640x360 
0x12CB3460, 36963306319482800, 231042924, 231042928, 4, 640x360 
0x12CB3460, 36963306319801960, 231042955, 231042958, 3, 640x360 
0x12CB3460, 36963306320122456, 231042995, 231042997, 2, 640x360 
0x12CB3460, 36963306320443664, 231043025, 231043028, 3, 640x360 
0x12CB3460, 36963306320763864, 231043054, 231043057, 3, 640x360 
0x12CB3460, 36963306321082200, 231043085, 231043088, 3, 640x360 
0x12CB3460, 36963306321403600, 231043116, 231043119, 3, 640x360 
0x12CB3460, 36963306321724264, 231043155, 231043158, 3, 640x360 
0x12CB3460, 36963306322044624, 231043185, 231043188, 3, 640x360 
0x12CB3460, 36963306322369864, 231043214, 231043221, 7, 640x360 
0x12CB3460, 36963306322842024, 231043265, 231043268, 3, 640x360 
0x12CB3460, 36963306323184880, 231043295, 231043298, 3, 640x360 
0x12CB3460, 36963306323483224, 231043325, 231043328, 3, 640x360 
0x12CB3460, 36963306324243600, 231043406, 231043409, 3, 640x360 
0x12CB3460, 36963306324442080, 231043426, 231043435, 9, 640x360 
0x12CB3460, 36963306324765984, 231043454, 231043457, 3, 640x360 
0x12CB3460, 36963306325082520, 231043486, 231043489, 3, 640x360 
0x12CB3460, 36963306325404144, 231043516, 231043519, 3, 640x360 
0x12CB3460, 36963306325723000, 231043555, 231043558, 3, 640x360 
0x12CB3460, 36963306326044760, 231043585, 231043588, 3, 640x360 
0x12CB3460, 36963306326365584, 231043615, 231043618, 3, 640x360 
0x12CB3460, 36963306326843768, 231043665, 231043668, 3, 640x360 
0x12CB3460, 36963306327165488, 231043695, 231043698, 3, 640x360 
0x12CB3460, 36963306327482272, 231043725, 231043728, 3, 640x360 
0x12CB3460, 36963306327802360, 231043756, 231043759, 3, 640x360 
0x12CB3460, 36963306328122712, 231043795, 231043798, 3, 640x360 
0x12CB3460, 36963306328442680, 231043824, 231043827, 3, 640x360 
0x12CB3460, 36963306328964856, 231043875, 231043878, 3, 640x360 
0x12CB3460, 36963306329083096, 231043885, 231043888, 3, 640x360 
0x12CB3460, 36963306329403920, 231043916, 231043919, 3, 640x360 
0x12CB3460, 36963306329722192, 231043945, 231043948, 3, 640x360 
0x12CB3460, 36963306330044344, 231043985, 231043989, 4, 640x360 
0x12CB3460, 36963306330364000, 231044015, 231044017, 2, 640x360 
0x12CB3460, 36963306330842336, 231044065, 231044068, 3, 640x360 
0x12CB3460, 36963306331163032, 231044095, 231044098, 3, 640x360 
0x12CB3460, 36963306331484096, 231044125, 231044127, 2, 640x360 
0x12CB3460, 36963306331803712, 231044154, 231044158, 4, 640x360 
0x12CB3460, 36963306332123176, 231044185, 231044189, 4, 640x360 
0x12CB3460, 36963306332441968, 231044225, 231044228, 3, 640x360 
0x12CB3460, 36963306332762024, 231044255, 231044258, 3, 640x360 
0x12CB3460, 36963306333083216, 231044286, 231044288, 2, 640x360 
0x12CB3460, 36963306333407696, 231044316, 231044320, 4, 640x360 
0x12CB3460, 36963306333724264, 231044370, 231044373, 3, 640x360 
0x12CB3460, 36963306334043752, 231044384, 231044387, 3, 640x360 
0x12CB3460, 36963306334522840, 231044426, 231044430, 4, 640x360 
0x12CB3460, 36963306334843056, 231044464, 231044466, 2, 640x360 
0x12CB3460, 36963306335163504, 231044495, 231044497, 2, 640x360 
0x12CB3460, 36963306335483992, 231044524, 231044527, 3, 640x360 
0x12CB3460, 36963306335805192, 231044555, 231044559, 4, 640x360 
0x12CB3460, 36963306336123696, 231044596, 231044598, 2, 640x360 
0x12CB3460, 36963306336446376, 231044626, 231044629, 3, 640x360 
0x12CB3460, 36963306336763504, 231044655, 231044658, 3, 640x360 
0x12CB3460, 36963306337086848, 231044687, 231044690, 3, 640x360 
0x12CB3460, 36963306337404608, 231044716, 231044719, 3, 640x360 
0x12CB3460, 36963306337722360, 231044746, 231044749, 3, 640x360 
0x12CB3460, 36963306338044160, 231044784, 231044787, 3, 640x360 
0x12CB3460, 36963306338522992, 231044835, 231044838, 3, 640x360 
0x12CB3460, 36963306339015464, 231044876, 231044879, 3, 640x360 
0x12CB3460, 36963306339481776, 231044925, 231044927, 2, 640x360 
0x12CB3460, 36963306339803104, 231044955, 231044958, 3, 640x360 
0x12CB3460, 36963306340122304, 231044995, 231044998, 3, 640x360 
0x12CB3460, 36963306340443832, 231045025, 231045027, 2, 640x360 
0x12CB3460, 36963306340763736, 231045054, 231045057, 3, 640x360 
0x12CB3460, 36963306341082712, 231045085, 231045102, 17, 640x360 
0x12CB3460, 36963306341403896, 231045114, 231045117, 3, 640x360 
0x12CB3460, 36963306341723584, 231045145, 231045149, 4, 640x360 
0x12CB3460, 36963306342204776, 231045195, 231045198, 3, 640x360 
0x12CB3460, 36963306342525616, 231045235, 231045238, 3, 640x360 
0x12CB3460, 36963306342842152, 231045264, 231045267, 3, 640x360 
0x12CB3460, 36963306343163848, 231045295, 231045301, 6, 640x360 
0x12CB3460, 36963306343482240, 231045324, 231045327, 3, 640x360 
0x12CB3460, 36963306344006744, 231045375, 231045378, 3, 640x360 
0x12CB3460, 36963306344122224, 231045395, 231045397, 2, 640x360 
0x12CB3460, 36963306344441928, 231045424, 231045427, 3, 640x360 
0x12CB3460, 36963306344763392, 231045455, 231045458, 3, 640x360 
0x12CB3460, 36963306345083352, 231045485, 231045488, 3, 640x360 
0x12CB3460, 36963306345404424, 231045516, 231045519, 3, 640x360 
0x12CB3460, 36963306345725528, 231045554, 231045558, 4, 640x360 
0x12CB3460, 36963306346207608, 231045606, 231045610, 4, 640x360 
0x12CB3460, 36963306346523728, 231045635, 231045638, 3, 640x360 
0x12CB3460, 36963306346842712, 231045665, 231045668, 3, 640x360 
0x12CB3460, 36963306347165488, 231045695, 231045698, 3, 640x360 
0x12CB3460, 36963306347482936, 231045725, 231045727, 2, 640x360 
0x12CB3460, 36963306347803496, 231045755, 231045758, 3, 640x360 
0x12CB3460, 36963306348122872, 231045794, 231045798, 4, 640x360 
0x12CB3460, 36963306348444264, 231045825, 231045828, 3, 640x360 
0x12CB3460, 36963306349000704, 231045884, 231045887, 3, 640x360 
0x12CB3460, 36963306349402384, 231045915, 231045918, 3, 640x360 
0x12CB3460, 36963306349725944, 231045955, 231045957, 2, 640x360 
0x12CB3460, 36963306350202816, 231045995, 231046010, 15, 640x360 
0x12CB3460, 36963306350524040, 231046035, 231046038, 3, 640x360 
0x12CB3460, 36963306350842320, 231046065, 231046068, 3, 640x360 
0x12CB3460, 36963306351163136, 231046095, 231046098, 3, 640x360 
0x12CB3460, 36963306351483704, 231046125, 231046128, 3, 640x360 
0x12CB3460, 36963306351802568, 231046154, 231046158, 4, 640x360 
0x12CB3460, 36963306352123448, 231046195, 231046200, 5, 640x360 
0x12CB3460, 36963306352443464, 231046225, 231046228, 3, 640x360 
0x12CB3460, 36963306352763184, 231046255, 231046257, 2, 640x360 
0x12CB3460, 36963306353084104, 231046286, 231046289, 3, 640x360 
0x12CB3460, 36963306353402504, 231046315, 231046318, 3, 640x360 
0x12CB3460, 36963306354072616, 231046384, 231046387, 3, 640x360 
0x12CB3460, 36963306354202960, 231046394, 231046397, 3, 640x360 
0x12CB3460, 36963306354522040, 231046435, 231046438, 3, 640x360 
0x12CB3460, 36963306354844056, 231046465, 231046467, 2, 640x360 
0x12CB3460, 36963306355162344, 231046495, 231046498, 3, 640x360 
0x12CB3460, 36963306355484280, 231046524, 231046527, 3, 640x360 
0x12CB3460, 36963306355805424, 231046555, 231046558, 3, 640x360 
0x12CB3460, 36963306356122120, 231046596, 231046599, 3, 640x360 
0x12CB3460, 36963306356441776, 231046625, 231046628, 3, 640x360 
0x12CB3460, 36963306356762416, 231046655, 231046658, 3, 640x360 
0x12CB3460, 36963306357082936, 231046685, 231046688, 3, 640x360 
0x12CB3460, 36963306357405952, 231046717, 231046720, 3, 640x360 
0x12CB3460, 36963306357881688, 231046765, 231046768, 3, 640x360 
0x12CB3460, 36963306358204328, 231046796, 231046800, 4, 640x360 
0x12CB3460, 36963306358523384, 231046826, 231046829, 3, 640x360 
0x12CB3460, 36963306358990440, 231046875, 231046878, 3, 640x360 
0x12CB3460, 36963306359162664, 231046894, 231046897, 3, 640x360 
0x12CB3460, 36963306359483560, 231046925, 231046928, 3, 640x360 
0x12CB3460, 36963306359804096, 231046955, 231046959, 4, 640x360 
0x12CB3460, 36963306360122232, 231046995, 231046997, 2, 640x360 
0x12CB3460, 36963306360443640, 231047025, 231047028, 3, 640x360 
0x12CB3460, 36963306360765896, 231047055, 231047057, 2, 640x360 
0x12CB3460, 36963306361084240, 231047085, 231047088, 3, 640x360 
0x12CB3460, 36963306361406048, 231047115, 231047119, 4, 640x360 
0x12CB3460, 36963306361882000, 231047165, 231047168, 3, 640x360 
0x12CB3460, 36963306362204880, 231047195, 231047198, 3, 640x360 
0x12CB3460, 36963306362521936, 231047225, 231047229, 4, 640x360 
0x12CB3460, 36963306362842048, 231047265, 231047268, 3, 640x360 
0x12CB3460, 36963306363164032, 231047295, 231047298, 3, 640x360 
0x12CB3460, 36963306363484888, 231047326, 231047329, 3, 640x360 
0x12CB3460, 36963306364140672, 231047395, 231047397, 2, 640x360 
0x12CB3460, 36963306364443576, 231047425, 231047435, 10, 640x360 
0x12CB3460, 36963306364762576, 231047455, 231047458, 3, 640x360 
0x12CB3460, 36963306365082976, 231047485, 231047487, 2, 640x360 
0x12CB3460, 36963306365563792, 231047536, 231047539, 3, 640x360 
0x12CB3460, 36963306365884600, 231047565, 231047568, 3, 640x360 
0x12CB3460, 36963306366205904, 231047595, 231047599, 4, 640x360 
0x12CB3460, 36963306366522688, 231047635, 231047642, 7, 640x360 
0x12CB3460, 36963306366843536, 231047664, 231047667, 3, 640x360 
0x12CB3460, 36963306367163808, 231047695, 231047698, 3, 640x360 
0x12CB3460, 36963306367484472, 231047725, 231047728, 3, 640x360 
0x12CB3460, 36963306367802848, 231047756, 231047759, 3, 640x360 
0x12CB3460, 36963306368122440, 231047794, 231047797, 3, 640x360 
0x12CB3460, 36963306368443088, 231047825, 231047827, 2, 640x360 
0x12CB3460, 36963306368762208, 231047873, 231047877, 4, 640x360 
0x12CB3460, 36963306369082776, 231047885, 231047888, 3, 640x360 
0x12CB3460, 36963306369562968, 231047935, 231047938, 3, 640x360 
0x12CB3460, 36963306369886464, 231047965, 231047968, 3, 640x360 
0x12CB3460, 36963306370203952, 231047996, 231048000, 4, 640x360 
0x12CB3460, 36963306370523216, 231048026, 231048029, 3, 640x360 
0x12CB3460, 36963306370842232, 231048064, 231048067, 3, 640x360 
0x12CB3460, 36963306371161848, 231048095, 231048098, 3, 640x360 
0x12CB3460, 36963306371483400, 231048124, 231048128, 4, 640x360 
0x12CB3460, 36963306371802456, 231048155, 231048158, 3, 640x360 
0x12CB3460, 36963306372121720, 231048195, 231048197, 2, 640x360 
0x12CB3460, 36963306372442904, 231048224, 231048227, 3, 640x360 
0x12CB3460, 36963306372763176, 231048255, 231048258, 3, 640x360 
0x12CB3460, 36963306373083440, 231048285, 231048288, 3, 640x360 
0x12CB3460, 36963306373561744, 231048335, 231048338, 3, 640x360 
0x12CB3460, 36963306373985152, 231048376, 231048378, 2, 640x360 
0x12CB3460, 36963306374202584, 231048395, 231048397, 2, 640x360 
0x12CB3460, 36963306374523840, 231048436, 231048438, 2, 640x360 
0x12CB3460, 36963306374842584, 231048466, 231048474, 8, 640x360 
0x12CB3460, 36963306375176600, 231048497, 231048502, 5, 640x360 
0x12CB3460, 36963306375482016, 231048525, 231048529, 4, 640x360 
0x12CB3460, 36963306375806592, 231048556, 231048560, 4, 640x360 
0x12CB3460, 36963306376122616, 231048595, 231048598, 3, 640x360 
0x12CB3460, 36963306376464256, 231048628, 231048631, 3, 640x360 
0x12CB3460, 36963306376763176, 231048656, 231048660, 4, 640x360 
0x12CB3460, 36963306377241984, 231048705, 231048710, 5, 640x360 
0x12CB3460, 36963306377561224, 231048736, 231048738, 2, 640x360 
0x12CB3460, 36963306377883448, 231048765, 231048768, 3, 640x360 
0x12CB3460, 36963306378203048, 231048794, 231048797, 3, 640x360 
0x12CB3460, 36963306378521936, 231048826, 231048830, 4, 640x360 
0x12CB3460, 36963306378979368, 231048876, 231048878, 2, 640x360 
0x12CB3460, 36963306379162992, 231048895, 231048897, 2, 640x360 
0x12CB3460, 36963306379482632, 231048924, 231048927, 3, 640x360 
0x12CB3460, 36963306379802376, 231048955, 231048958, 3, 640x360 
0x12CB3460, 36963306380122104, 231048995, 231048998, 3, 640x360 
0x12CB3460, 36963306380443792, 231049025, 231049028, 3, 640x360 
0x12CB3460, 36963306380763552, 231049056, 231049061, 5, 640x360 
0x12CB3460, 36963306381242352, 231049105, 231049115, 10, 640x360 
0x12CB3460, 36963306381563048, 231049134, 231049137, 3, 640x360 
0x12CB3460, 36963306381883384, 231049165, 231049168, 3, 640x360 
0x12CB3460, 36963306382202504, 231049195, 231049198, 3, 640x360 
0x12CB3460, 36963306382522232, 231049235, 231049238, 3, 640x360 
0x12CB3460, 36963306382842592, 231049265, 231049268, 3, 640x360 
0x12CB3460, 36963306383162440, 231049295, 231049310, 15, 640x360 
0x12CB3460, 36963306383483400, 231049324, 231049327, 3, 640x360 
0x12CB3460, 36963306384062992, 231049386, 231049389, 3, 640x360 
0x12CB3460, 36963306384443432, 231049425, 231049428, 3, 640x360 
0x12CB3460, 36963306384921600, 231049475, 231049479, 4, 640x360 
0x12CB3460, 36963306385243064, 231049504, 231049510, 6, 640x360 
0x12CB3460, 36963306385561192, 231049535, 231049538, 3, 640x360 
0x12CB3460, 36963306385883744, 231049565, 231049568, 3, 640x360 
0x12CB3460, 36963306386201472, 231049594, 231049598, 4, 640x360 
0x12CB3460, 36963306386523232, 231049637, 231049641, 4, 640x360 
0x12CB3460, 36963306386842504, 231049665, 231049668, 3, 640x360 
0x12CB3460, 36963306387161496, 231049695, 231049698, 3, 640x360 
0x12CB3460, 36963306387483600, 231049725, 231049728, 3, 640x360 
0x12CB3460, 36963306387802928, 231049756, 231049759, 3, 640x360 
0x12CB3460, 36963306388122360, 231049795, 231049798, 3, 640x360 
0x12CB3460, 36963306388442712, 231049825, 231049827, 2, 640x360 
0x12CB3460, 36963306388988368, 231049875, 231049878, 3, 640x360 
0x12CB3460, 36963306389243280, 231049905, 231049907, 2, 640x360 
0x12CB3460, 36963306389562368, 231049935, 231049938, 3, 640x360 
0x12CB3460, 36963306389886968, 231049965, 231049968, 3, 640x360 
0x12CB3460, 36963306390201320, 231049994, 231049997, 3, 640x360 
0x12CB3460, 36963306390521448, 231050034, 231050037, 3, 640x360 
0x12CB3460, 36963306390842520, 231050065, 231050067, 2, 640x360 
0x12CB3460, 36963306391161640, 231050094, 231050097, 3, 640x360 
0x12CB3460, 36963306391484264, 231050125, 231050128, 3, 640x360 
0x12CB3460, 36963306391806144, 231050156, 231050159, 3, 640x360 
0x12CB3460, 36963306392121968, 231050196, 231050198, 2, 640x360 
0x12CB3460, 36963306392441800, 231050224, 231050227, 3, 640x360 
0x12CB3460, 36963306392923368, 231050275, 231050279, 4, 640x360 
0x12CB3460, 36963306393241736, 231050304, 231050308, 4, 640x360 
0x12CB3460, 36963306393563168, 231050335, 231050338, 3, 640x360 
0x12CB3460, 36963306394102288, 231050395, 231050398, 3, 640x360 
0x12CB3460, 36963306394523040, 231050435, 231050438, 3, 640x360 
0x12CB3460, 36963306394842304, 231050465, 231050468, 3, 640x360 
0x12CB3460, 36963306395163136, 231050495, 231050497, 2, 640x360 
0x12CB3460, 36963306395482280, 231050524, 231050528, 4, 640x360 
0x12CB3460, 36963306395804976, 231050555, 231050559, 4, 640x360 
0x12CB3460, 36963306396124848, 231050595, 231050598, 3, 640x360 
0x12CB3460, 36963306396605624, 231050646, 231050650, 4, 640x360 
0x12CB3460, 36963306396925168, 231050675, 231050678, 3, 640x360 
0x12CB3460, 36963306397244584, 231050705, 231050708, 3, 640x360 
0x12CB3460, 36963306397565336, 231050734, 231050737, 3, 640x360 
0x12CB3460, 36963306397883520, 231050765, 231050768, 3, 640x360 
0x12CB3460, 36963306398203952, 231050795, 231050799, 4, 640x360 
0x12CB3460, 36963306398523552, 231050825, 231050835, 10, 640x360 
0x12CB3460, 36963306398980968, 231050875, 231050878, 3, 640x360 
0x12CB3460, 36963306399162064, 231050894, 231050898, 4, 640x360 
0x12CB3460, 36963306399482200, 231050925, 231050929, 4, 640x360 
0x12CB3460, 36963306399802456, 231050956, 231050959, 3, 640x360 
0x12CB3460, 36963306400123160, 231050995, 231050997, 2, 640x360 
0x12CB3460, 36963306400603080, 231051034, 231051037, 3, 640x360 
0x12CB3460, 36963306400922816, 231051065, 231051069, 4, 640x360 
0x12CB3460, 36963306401243464, 231051106, 231051109, 3, 640x360 
0x12CB3460, 36963306401563472, 231051135, 231051138, 3, 640x360 
0x12CB3460, 36963306401882112, 231051165, 231051168, 3, 640x360 
0x12CB3460, 36963306402204368, 231051196, 231051212, 16, 640x360 
0x12CB3460, 36963306402524968, 231051234, 231051237, 3, 640x360 
0x12CB3460, 36963306402842608, 231051265, 231051268, 3, 640x360 
0x12CB3460, 36963306403162448, 231051294, 231051297, 3, 640x360 
0x12CB3460, 36963306403483520, 231051325, 231051330, 5, 640x360 
0x12CB3460, 36963306403993176, 231051375, 231051378, 3, 640x360 
0x12CB3460, 36963306404121864, 231051387, 231051390, 3, 640x360 
0x12CB3460, 36963306404603576, 231051435, 231051438, 3, 640x360 
0x12CB3460, 36963306404922232, 231051474, 231051482, 8, 640x360 
0x12CB3460, 36963306405242128, 231051504, 231051507, 3, 640x360 
0x12CB3460, 36963306405562568, 231051535, 231051538, 3, 640x360 
0x12CB3460, 36963306405881272, 231051565, 231051567, 2, 640x360 
0x12CB3460, 36963306406201968, 231051595, 231051598, 3, 640x360 
0x12CB3460, 36963306406521568, 231051635, 231051638, 3, 640x360 
0x12CB3460, 36963306406841704, 231051664, 231051667, 3, 640x360 
0x12CB3460, 36963306407163640, 231051694, 231051697, 3, 640x360 
0x12CB3460, 36963306407483192, 231051725, 231051728, 3, 640x360 
0x12CB3460, 36963306407802552, 231051754, 231051757, 3, 640x360 
0x12CB3460, 36963306408282352, 231051805, 231051808, 3, 640x360 
0x12CB3460, 36963306408601984, 231051835, 231051838, 3, 640x360 
0x12CB3460, 36963306408985248, 231051875, 231051878, 3, 640x360 
0x12CB3460, 36963306409241696, 231051904, 231051907, 3, 640x360 
0x12CB3460, 36963306409562160, 231051935, 231051938, 3, 640x360 
0x12CB3460, 36963306409882112, 231051966, 231051970, 4, 640x360 
0x12CB3460, 36963306410202576, 231051995, 231051997, 2, 640x360 
0x12CB3460, 36963306410522224, 231052035, 231052038, 3, 640x360 
0x12CB3460, 36963306410841856, 231052065, 231052068, 3, 640x360 
0x12CB3460, 36963306411162312, 231052094, 231052097, 3, 640x360 
0x12CB3460, 36963306411481712, 231052125, 231052131, 6, 640x360 
0x12CB3460, 36963306411803400, 231052155, 231052159, 4, 640x360 
0x12CB3460, 36963306412283240, 231052205, 231052210, 5, 640x360 
0x12CB3460, 36963306412602824, 231052234, 231052237, 3, 640x360 
0x12CB3460, 36963306412923320, 231052266, 231052269, 3, 640x360 
0x12CB3460, 36963306413242168, 231052305, 231052308, 3, 640x360 
0x12CB3460, 36963306413561976, 231052334, 231052337, 3, 640x360 
0x12CB3460, 36963306414005808, 231052385, 231052388, 3, 640x360 
0x12CB3460, 36963306414202280, 231052394, 231052397, 3, 640x360 
0x12CB3460, 36963306414521152, 231052426, 231052429, 3, 640x360 
0x12CB3460, 36963306414844368, 231052466, 231052469, 3, 640x360 
0x12CB3460, 36963306415165552, 231052494, 231052497, 3, 640x360 
0x12CB3460, 36963306415484368, 231052525, 231052528, 3, 640x360 
0x12CB3460, 36963306415803856, 231052556, 231052558, 2, 640x360 
0x12CB3460, 36963306416284968, 231052605, 231052609, 4, 640x360 
0x12CB3460, 36963306416605816, 231052645, 231052648, 3, 640x360 
0x12CB3460, 36963306416921960, 231052666, 231052670, 4, 640x360 
0x12CB3460, 36963306417242384, 231052704, 231052707, 3, 640x360 
0x12CB3460, 36963306417562560, 231052735, 231052737, 2, 640x360 
0x12CB3460, 36963306417883400, 231052765, 231052768, 3, 640x360 
0x12CB3460, 36963306418201448, 231052796, 231052800, 4, 640x360 
0x12CB3460, 36963306418521512, 231052825, 231052828, 3, 640x360 
0x12CB3460, 36963306418987976, 231052875, 231052878, 3, 640x360 
0x12CB3460, 36963306419162488, 231052894, 231052897, 3, 640x360 
0x12CB3460, 36963306419482424, 231052925, 231052927, 2, 640x360 
0x12CB3460, 36963306419963712, 231052976, 231052978, 2, 640x360 
0x12CB3460, 36963306420281624, 231053004, 231053007, 3, 640x360 
0x12CB3460, 36963306420603416, 231053036, 231053039, 3, 640x360 
0x12CB3460, 36963306420920808, 231053065, 231053069, 4, 640x360 
0x12CB3460, 36963306421241464, 231053105, 231053108, 3, 640x360 
0x12CB3460, 36963306421562800, 231053135, 231053138, 3, 640x360 
0x12CB3460, 36963306421884288, 231053165, 231053168, 3, 640x360 
0x12CB3460, 36963306422203744, 231053195, 231053198, 3, 640x360 
0x12CB3460, 36963306422522536, 231053235, 231053237, 2, 640x360 
0x12CB3460, 36963306422843416, 231053264, 231053267, 3, 640x360 
0x12CB3460, 36963306423165152, 231053296, 231053298, 2, 640x360 
0x12CB3460, 36963306423482848, 231053325, 231053329, 4, 640x360 
0x12CB3460, 36963306424086520, 231053384, 231053387, 3, 640x360 
0x12CB3460, 36963306424281032, 231053404, 231053406, 2, 640x360 
0x12CB3460, 36963306424603440, 231053435, 231053452, 17, 640x360 
0x12CB3460, 36963306424925208, 231053475, 231053478, 3, 640x360 
0x12CB3460, 36963306425242144, 231053504, 231053507, 3, 640x360 
0x12CB3460, 36963306425563904, 231053535, 231053538, 3, 640x360 
0x12CB3460, 36963306425883064, 231053565, 231053568, 3, 640x360 
0x12CB3460, 36963306426206352, 231053606, 231053611, 5, 640x360 
0x12CB3460, 36963306426528064, 231053637, 231053641, 4, 640x360 
0x12CB3460, 36963306426848568, 231053666, 231053669, 3, 640x360 
0x12CB3460, 36963306427166816, 231053695, 231053698, 3, 640x360 
0x12CB3460, 36963306427642912, 231053745, 231053748, 3, 640x360 
0x12CB3460, 36963306427963512, 231053775, 231053777, 2, 640x360 
0x12CB3460, 36963306428281752, 231053806, 231053809, 3, 640x360 
0x12CB3460, 36963306428602496, 231053836, 231053839, 3, 640x360 
0x12CB3460, 36963306428994312, 231053875, 231053878, 3, 640x360 
0x12CB3460, 36963306429242816, 231053905, 231053907, 2, 640x360 
0x12CB3460, 36963306429563056, 231053935, 231053937, 2, 640x360 
0x12CB3460, 36963306429883160, 231053965, 231053967, 2, 640x360 
0x12CB3460, 36963306430202880, 231053999, 231054002, 3, 640x360 
0x12CB3460, 36963306430522344, 231054036, 231054039, 3, 640x360 
0x12CB3460, 36963306430842856, 231054065, 231054067, 2, 640x360 
0x12CB3460, 36963306431163176, 231054095, 231054097, 2, 640x360 
0x12CB3460, 36963306431643568, 231054145, 231054147, 2, 640x360 
0x12CB3460, 36963306431962384, 231054175, 231054178, 3, 640x360 
0x12CB3460, 36963306432282240, 231054204, 231054207, 3, 640x360 
0x12CB3460, 36963306432602920, 231054234, 231054237, 3, 640x360 
0x12CB3460, 36963306432923104, 231054265, 231054268, 3, 640x360 
0x12CB3460, 36963306433242080, 231054304, 231054307, 3, 640x360 
0x12CB3460, 36963306433562776, 231054336, 231054343, 7, 640x360 
0x12CB3460, 36963306433966664, 231054375, 231054378, 3, 640x360 
0x12CB3460, 36963306434201936, 231054395, 231054397, 2, 640x360 
0x12CB3460, 36963306434522976, 231054425, 231054429, 4, 640x360 
0x12CB3460, 36963306434842952, 231054465, 231054468, 3, 640x360 
0x12CB3460, 36963306435162992, 231054494, 231054497, 3, 640x360 
0x12CB3460, 36963306435643488, 231054544, 231054561, 17, 640x360 
0x12CB3460, 36963306435963944, 231054576, 231054579, 3, 640x360 
0x12CB3460, 36963306436286520, 231054605, 231054609, 4, 640x360 
0x12CB3460, 36963306436605344, 231054646, 231054650, 4, 640x360 
0x12CB3460, 36963306436924664, 231054676, 231054679, 3, 640x360 
0x12CB3460, 36963306437243984, 231054705, 231054708, 3, 640x360 
0x12CB3460, 36963306437562160, 231054735, 231054738, 3, 640x360 
0x12CB3460, 36963306437882936, 231054765, 231054767, 2, 640x360 
0x12CB3460, 36963306438204304, 231054797, 231054799, 2, 640x360 
0x12CB3460, 36963306438521888, 231054825, 231054829, 4, 640x360 
0x12CB3460, 36963306438976584, 231054874, 231054877, 3, 640x360 
0x12CB3460, 36963306439322432, 231054916, 231054919, 3, 640x360 
0x12CB3460, 36963306439641200, 231054945, 231054948, 3, 640x360 
0x12CB3460, 36963306439961104, 231054976, 231054979, 3, 640x360 
0x12CB3460, 36963306440281536, 231055004, 231055007, 3, 640x360 
0x12CB3460, 36963306440603488, 231055034, 231055038, 4, 640x360 
0x12CB3460, 36963306440921728, 231055065, 231055069, 4, 640x360 
0x12CB3460, 36963306441241624, 231055105, 231055107, 2, 640x360 
0x12CB3460, 36963306441562952, 231055135, 231055138, 3, 640x360 
0x12CB3460, 36963306441881552, 231055165, 231055167, 2, 640x360 
0x12CB3460, 36963306442203032, 231055195, 231055198, 3, 640x360 
0x12CB3460, 36963306442522352, 231055235, 231055237, 2, 640x360 
0x12CB3460, 36963306442843352, 231055265, 231055268, 3, 640x360 
0x12CB3460, 36963306443322592, 231055315, 231055317, 2, 640x360 
0x12CB3460, 36963306443640984, 231055344, 231055346, 2, 640x360 
0x12CB3460, 36963306444077056, 231055385, 231055388, 3, 640x360 
0x12CB3460, 36963306444281256, 231055404, 231055407, 3, 640x360 
0x12CB3460, 36963306444603776, 231055435, 231055438, 3, 640x360 
0x12CB3460, 36963306444926128, 231055475, 231055477, 2, 640x360 
0x12CB3460, 36963306445245616, 231055505, 231055508, 3, 640x360 
0x12CB3460, 36963306445561832, 231055535, 231055538, 3, 640x360 
0x12CB3460, 36963306445881400, 231055565, 231055568, 3, 640x360 
0x12CB3460, 36963306446202400, 231055595, 231055598, 3, 640x360 
0x12CB3460, 36963306446522080, 231055635, 231055638, 3, 640x360 
0x12CB3460, 36963306446844616, 231055665, 231055668, 3, 640x360 
0x12CB3460, 36963306447322240, 231055715, 231055718, 3, 640x360 
0x12CB3460, 36963306447641416, 231055745, 231055748, 3, 640x360 
0x12CB3460, 36963306447962832, 231055777, 231055780, 3, 640x360 
0x12CB3460, 36963306448283480, 231055805, 231055808, 3, 640x360 
0x12CB3460, 36963306448601296, 231055835, 231055838, 3, 640x360 
0x12CB3460, 36963306449021512, 231055886, 231055889, 3, 640x360 
0x12CB3460, 36963306449241472, 231055904, 231055907, 3, 640x360 
0x12CB3460, 36963306449562384, 231055935, 231055939, 4, 640x360 
0x12CB3460, 36963306449882592, 231055965, 231055968, 3, 640x360 
0x12CB3460, 36963306450201592, 231055996, 231055999, 3, 640x360 
0x12CB3460, 36963306450522432, 231056036, 231056038, 2, 640x360 
0x12CB3460, 36963306451002672, 231056075, 231056078, 3, 640x360 
0x12CB3460, 36963306451322920, 231056106, 231056110, 4, 640x360 
0x12CB3460, 36963306451643832, 231056146, 231056148, 2, 640x360 
0x12CB3460, 36963306451962232, 231056174, 231056177, 3, 640x360 
0x12CB3460, 36963306452281176, 231056205, 231056208, 3, 640x360 
0x12CB3460, 36963306452602000, 231056234, 231056237, 3, 640x360 
0x12CB3460, 36963306452921936, 231056266, 231056269, 3, 640x360 
0x12CB3460, 36963306453241448, 231056305, 231056308, 3, 640x360 
0x12CB3460, 36963306453562496, 231056335, 231056338, 3, 640x360 
0x12CB3460, 36963306454068224, 231056385, 231056387, 2, 640x360 
0x12CB3460, 36963306454202064, 231056395, 231056397, 2, 640x360 
0x12CB3460, 36963306454522984, 231056436, 231056439, 3, 640x360 
0x12CB3460, 36963306455001624, 231056475, 231056478, 3, 640x360 
0x12CB3460, 36963306455321504, 231056515, 231056518, 3, 640x360 
0x12CB3460, 36963306455644544, 231056545, 231056548, 3, 640x360 
0x12CB3460, 36963306455964688, 231056575, 231056579, 4, 640x360 
0x12CB3460, 36963306456283944, 231056606, 231056609, 3, 640x360 
0x12CB3460, 36963306456603400, 231056636, 231056639, 3, 640x360 
0x12CB3460, 36963306456923152, 231056675, 231056677, 2, 640x360 
0x12CB3460, 36963306457242832, 231056705, 231056707, 2, 640x360 
0x12CB3460, 36963306457563472, 231056734, 231056737, 3, 640x360 
0x12CB3460, 36963306457881584, 231056766, 231056768, 2, 640x360 
0x12CB3460, 36963306458204360, 231056795, 231056798, 3, 640x360 
0x12CB3460, 36963306458680888, 231056845, 231056847, 2, 640x360 
0x12CB3460, 36963306459058112, 231056885, 231056889, 4, 640x360 
0x12CB3460, 36963306459320632, 231056905, 231056909, 4, 640x360 
0x12CB3460, 36963306459642112, 231056945, 231056948, 3, 640x360 
0x12CB3460, 36963306459962856, 231056975, 231056977, 2, 640x360 
0x12CB3460, 36963306460282328, 231057005, 231057007, 2, 640x360 
0x12CB3460, 36963306460603392, 231057034, 231057038, 4, 640x360 
0x12CB3460, 36963306460921720, 231057065, 231057083, 18, 640x360 
0x12CB3460, 36963306461242752, 231057106, 231057109, 3, 640x360 
0x12CB3460, 36963306461562264, 231057135, 231057138, 3, 640x360 
0x12CB3460, 36963306461882568, 231057165, 231057168, 3, 640x360 
0x12CB3460, 36963306462203328, 231057196, 231057199, 3, 640x360 
0x12CB3460, 36963306462682736, 231057244, 231057247, 3, 640x360 
0x12CB3460, 36963306463003088, 231057274, 231057278, 4, 640x360 
0x12CB3460, 36963306463321296, 231057315, 231057320, 5, 640x360 
0x12CB3460, 36963306463644728, 231057383, 231057387, 4, 640x360 
0x12CB3460, 36963306464154472, 231057394, 231057397, 3, 640x360 
0x12CB3460, 36963306464282704, 231057405, 231057408, 3, 640x360 
0x12CB3460, 36963306464602120, 231057435, 231057440, 5, 640x360 
0x12CB3460, 36963306464923952, 231057466, 231057470, 4, 640x360 
0x12CB3460, 36963306465241536, 231057505, 231057509, 4, 640x360 
0x12CB3460, 36963306465561936, 231057535, 231057538, 3, 640x360 
0x12CB3460, 36963306465882848, 231057565, 231057567, 2, 640x360 
0x12CB3460, 36963306466202848, 231057595, 231057597, 2, 640x360 
0x12CB3460, 36963306466681632, 231057645, 231057648, 3, 640x360 
0x12CB3460, 36963306467002688, 231057674, 231057677, 3, 640x360 
0x12CB3460, 36963306467321624, 231057715, 231057717, 2, 640x360 
0x12CB3460, 36963306467644288, 231057744, 231057747, 3, 640x360 
0x12CB3460, 36963306467963384, 231057776, 231057779, 3, 640x360 
0x12CB3460, 36963306468283584, 231057805, 231057808, 3, 640x360 
0x12CB3460, 36963306468602192, 231057835, 231057838, 3, 640x360 
0x12CB3460, 36963306469109296, 231057887, 231057902, 15, 640x360 
0x12CB3460, 36963306469251608, 231057904, 231057909, 5, 640x360 
0x12CB3460, 36963306469561112, 231057938, 231057942, 4, 640x360 
0x12CB3460, 36963306469893008, 231057977, 231057982, 5, 640x360 
0x12CB3460, 36963306470363184, 231058016, 231058019, 3, 640x360 
0x12CB3460, 36963306470682736, 231058045, 231058048, 3, 640x360 
0x12CB3460, 36963306471001992, 231058075, 231058078, 3, 640x360 
0x12CB3460, 36963306471322064, 231058105, 231058109, 4, 640x360 
0x12CB3460, 36963306471646608, 231058144, 231058148, 4, 640x360 
0x12CB3460, 36963306471961064, 231058175, 231058177, 2, 640x360 
0x12CB3460, 36963306472282712, 231058204, 231058207, 3, 640x360 
0x12CB3460, 36963306472602240, 231058234, 231058238, 4, 640x360 
0x12CB3460, 36963306472921440, 231058266, 231058270, 4, 640x360 
0x12CB3460, 36963306473247808, 231058305, 231058307, 2, 640x360 
0x12CB3460, 36963306473562616, 231058334, 231058337, 3, 640x360 
0x12CB3460, 36963306474108208, 231058386, 231058389, 3, 640x360 
0x12CB3460, 36963306474360936, 231058415, 231058419, 4, 640x360 
0x12CB3460, 36963306474681576, 231058446, 231058448, 2, 640x360 
0x12CB3460, 36963306475001784, 231058475, 231058478, 3, 640x360 
0x12CB3460, 36963306475322816, 231058506, 231058509, 3, 640x360 
0x12CB3460, 36963306475645392, 231058545, 231058548, 3, 640x360 
0x12CB3460, 36963306475961536, 231058575, 231058578, 3, 640x360 
0x12CB3460, 36963306476282256, 231058606, 231058609, 3, 640x360 
0x12CB3460, 36963306476602248, 231058635, 231058638, 3, 640x360 
0x12CB3460, 36963306476922760, 231058665, 231058669, 4, 640x360 
0x12CB3460, 36963306477241072, 231058705, 231058708, 3, 640x360 
0x12CB3460, 36963306477561784, 231058735, 231058738, 3, 640x360 
0x12CB3460, 36963306477882120, 231058765, 231058768, 3, 640x360 
0x12CB3460, 36963306478362080, 231058815, 231058818, 3, 640x360 
0x12CB3460, 36963306478681912, 231058869, 231058874, 5, 640x360 
0x12CB3460, 36963306479001888, 231058874, 231058878, 4, 640x360 
0x12CB3460, 36963306479321024, 231058905, 231058924, 19, 640x360 
0x12CB3460, 36963306479641880, 231058944, 231058947, 3, 640x360 
0x12CB3460, 36963306479962464, 231058975, 231058978, 3, 640x360 
0x12CB3460, 36963306480281992, 231059004, 231059007, 3, 640x360 
0x12CB3460, 36963306480602040, 231059034, 231059037, 3, 640x360 
0x12CB3460, 36963306480921832, 231059075, 231059077, 2, 640x360 
0x12CB3460, 36963306481244248, 231059104, 231059107, 3, 640x360 
0x12CB3460, 36963306481562240, 231059135, 231059138, 3, 640x360 
0x12CB3460, 36963306482041432, 231059184, 231059188, 4, 640x360 
0x12CB3460, 36963306482363424, 231059215, 231059218, 3, 640x360 
0x12CB3460, 36963306482682464, 231059244, 231059247, 3, 640x360 
0x12CB3460, 36963306483000920, 231059275, 231059278, 3, 640x360 
0x12CB3460, 36963306483323728, 231059315, 231059318, 3, 640x360 
0x12CB3460, 36963306483646240, 231059344, 231059347, 3, 640x360 
0x12CB3460, 36963306484169952, 231059395, 231059398, 3, 640x360 
0x12CB3460, 36963306484281248, 231059405, 231059409, 4, 640x360 
0x12CB3460, 36963306484603072, 231059435, 231059438, 3, 640x360 
0x12CB3460, 36963306484921608, 231059465, 231059470, 5, 640x360 
0x12CB3460, 36963306485242464, 231059504, 231059509, 5, 640x360 
0x12CB3460, 36963306485561560, 231059536, 231059539, 3, 640x360 
0x12CB3460, 36963306486042440, 231059585, 231059588, 3, 640x360 
0x12CB3460, 36963306486360696, 231059615, 231059618, 3, 640x360 
0x12CB3460, 36963306486711496, 231059654, 231059657, 3, 640x360 
0x12CB3460, 36963306487002336, 231059674, 231059677, 3, 640x360 
0x12CB3460, 36963306487321912, 231059714, 231059717, 3, 640x360 
0x12CB3460, 36963306487641976, 231059745, 231059748, 3, 640x360 
0x12CB3460, 36963306487962368, 231059775, 231059778, 3, 640x360 
0x12CB3460, 36963306488281496, 231059805, 231059814, 9, 640x360 
0x12CB3460, 36963306488601072, 231059834, 231059840, 6, 640x360 
0x12CB3460, 36963306489127680, 231059894, 231059898, 4, 640x360 
0x12CB3460, 36963306489242984, 231059905, 231059908, 3, 640x360 
0x12CB3460, 36963306489562120, 231059934, 231059937, 3, 640x360 
0x12CB3460, 36963306490040536, 231059985, 231059989, 4, 640x360 
0x12CB3460, 36963306490362840, 231060015, 231060018, 3, 640x360 
0x12CB3460, 36963306490681888, 231060044, 231060047, 3, 640x360 
0x12CB3460, 36963306491002288, 231060076, 231060081, 5, 640x360 
0x12CB3460, 36963306491321280, 231060105, 231060112, 7, 640x360 
0x12CB3460, 36963306491645904, 231060144, 231060147, 3, 640x360 
0x12CB3460, 36963306491961520, 231060175, 231060178, 3, 640x360 
0x12CB3460, 36963306492282504, 231060205, 231060210, 5, 640x360 
0x12CB3460, 36963306492601696, 231060235, 231060237, 2, 640x360 
0x12CB3460, 36963306492921216, 231060265, 231060269, 4, 640x360 
0x12CB3460, 36963306493242616, 231060304, 231060312, 8, 640x360 
0x12CB3460, 36963306493723528, 231060366, 231060370, 4, 640x360 
0x12CB3460, 36963306494040752, 231060385, 231060388, 3, 640x360 
0x12CB3460, 36963306494361064, 231060414, 231060417, 3, 640x360 
0x12CB3460, 36963306494681232, 231060445, 231060448, 3, 640x360 
0x12CB3460, 36963306495002928, 231060474, 231060478, 4, 640x360 
0x12CB3460, 36963306495320752, 231060505, 231060509, 4, 640x360 
0x12CB3460, 36963306495642072, 231060545, 231060548, 3, 640x360 
0x12CB3460, 36963306495960760, 231060574, 231060577, 3, 640x360 
0x12CB3460, 36963306496281536, 231060605, 231060607, 2, 640x360 
0x12CB3460, 36963306496601376, 231060634, 231060642, 8, 640x360 
0x12CB3460, 36963306496921032, 231060674, 231060677, 3, 640x360 
0x12CB3460, 36963306497241336, 231060705, 231060708, 3, 640x360 
0x12CB3460, 36963306497722080, 231060754, 231060757, 3, 640x360 
0x12CB3460, 36963306498041920, 231060785, 231060788, 3, 640x360 
0x12CB3460, 36963306498360696, 231060816, 231060819, 3, 640x360 
0x12CB3460, 36963306498681056, 231060844, 231060847, 3, 640x360 
0x12CB3460, 36963306499083760, 231060885, 231060889, 4, 640x360 
0x12CB3460, 36963306499321848, 231060915, 231060919, 4, 640x360 
0x12CB3460, 36963306499641736, 231060944, 231060948, 4, 640x360 
0x12CB3460, 36963306499962000, 231060974, 231060977, 3, 640x360 
0x12CB3460, 36963306500281416, 231061005, 231061007, 2, 640x360 
0x12CB3460, 36963306500601720, 231061035, 231061038, 3, 640x360 
0x12CB3460, 36963306500921584, 231061074, 231061077, 3, 640x360 
0x12CB3460, 36963306501402176, 231061115, 231061135, 20, 640x360 
0x12CB3460, 36963306501725032, 231061155, 231061162, 7, 640x360 
0x12CB3460, 36963306502041744, 231061184, 231061188, 4, 640x360 
0x12CB3460, 36963306502362464, 231061215, 231061235, 20, 640x360 
0x12CB3460, 36963306502681704, 231061245, 231061248, 3, 640x360 
0x12CB3460, 36963306503002240, 231061275, 231061277, 2, 640x360 
0x12CB3460, 36963306503321448, 231061305, 231061309, 4, 640x360 
0x12CB3460, 36963306503644152, 231061345, 231061378, 33, 640x360 
0x12CB3460, 36963306504050888, 231061387, 231061391, 4, 640x360 
0x12CB3460, 36963306504282136, 231061405, 231061410, 5, 640x360 
0x12CB3460, 36963306504601160, 231061437, 231061443, 6, 640x360 
0x12CB3460, 36963306504922688, 231061475, 231061480, 5, 640x360 
0x12CB3460, 36963306505402968, 231061516, 231061526, 10, 640x360 
0x12CB3460, 36963306505721152, 231061555, 231061560, 5, 640x360 
0x12CB3460, 36963306506041120, 231061585, 231061588, 3, 640x360 
0x12CB3460, 36963306506360696, 231061615, 231061619, 4, 640x360 
0x12CB3460, 36963306506682568, 231061645, 231061648, 3, 640x360 
0x12CB3460, 36963306507002400, 231061675, 231061678, 3, 640x360 
0x12CB3460, 36963306507322816, 231061715, 231061718, 3, 640x360 
0x12CB3460, 36963306507641328, 231061744, 231061747, 3, 640x360 
0x12CB3460, 36963306507962632, 231061775, 231061778, 3, 640x360 
0x12CB3460, 36963306508282312, 231061804, 231061807, 3, 640x360 
0x12CB3460, 36963306508601776, 231061835, 231061839, 4, 640x360 
0x12CB3460, 36963306508979512, 231061874, 231061877, 3, 640x360 
0x12CB3460, 36963306509402192, 231061915, 231061918, 3, 640x360 
0x12CB3460, 36963306509720936, 231061945, 231061948, 3, 640x360 
0x12CB3460, 36963306510042520, 231061985, 231062000, 15, 640x360 
0x12CB3460, 36963306510362520, 231062015, 231062018, 3, 640x360 
0x12CB3460, 36963306510683136, 231062044, 231062047, 3, 640x360 
0x12CB3460, 36963306511003056, 231062075, 231062078, 3, 640x360 
0x12CB3460, 36963306511321688, 231062105, 231062108, 3, 640x360 
0x12CB3460, 36963306511645168, 231062145, 231062148, 3, 640x360 
0x12CB3460, 36963306511963272, 231062174, 231062177, 3, 640x360 
0x12CB3460, 36963306512282264, 231062205, 231062208, 3, 640x360 
0x12CB3460, 36963306512601192, 231062234, 231062237, 3, 640x360 
0x12CB3460, 36963306513083048, 231062285, 231062288, 3, 640x360 
0x12CB3460, 36963306513403736, 231062315, 231062318, 3, 640x360 
0x12CB3460, 36963306513721016, 231062376, 231062380, 4, 640x360 
0x12CB3460, 36963306514066848, 231062384, 231062388, 4, 640x360 
0x12CB3460, 36963306514362344, 231062415, 231062418, 3, 640x360 
0x12CB3460, 36963306514681688, 231062444, 231062460, 16, 640x360 
0x12CB3460, 36963306515003024, 231062475, 231062478, 3, 640x360 
0x12CB3460, 36963306515320984, 231062515, 231062518, 3, 640x360 
0x12CB3460, 36963306515642104, 231062544, 231062561, 17, 640x360 
0x12CB3460, 36963306515963536, 231062574, 231062577, 3, 640x360 
0x12CB3460, 36963306516281032, 231062604, 231062607, 3, 640x360 
0x12CB3460, 36963306516602056, 231062634, 231062639, 5, 640x360 
0x12CB3460, 36963306517082512, 231062685, 231062688, 3, 640x360 
0x12CB3460, 36963306517405336, 231062715, 231062718, 3, 640x360 
0x12CB3460, 36963306517721688, 231062745, 231062749, 4, 640x360 
0x12CB3460, 36963306518042328, 231062785, 231062788, 3, 640x360 
0x12CB3460, 36963306518363224, 231062814, 231062817, 3, 640x360 
0x12CB3460, 36963306518684144, 231062845, 231062878, 33, 640x360 
0x12CB3460, 36963306519083296, 231062885, 231062888, 3, 640x360 
0x12CB3460, 36963306519320560, 231062905, 231062909, 4, 640x360 
0x12CB3460, 36963306519643352, 231062945, 231062948, 3, 640x360 
0x12CB3460, 36963306519962536, 231062975, 231062977, 2, 640x360 
0x12CB3460, 36963306520285408, 231063004, 231063007, 3, 640x360 
0x12CB3460, 36963306520603216, 231063035, 231063038, 3, 640x360 
0x12CB3460, 36963306521082160, 231063084, 231063087, 3, 640x360 
0x12CB3460, 36963306521405528, 231063115, 231063117, 2, 640x360 
0x12CB3460, 36963306521721352, 231063155, 231063158, 3, 640x360 
0x12CB3460, 36963306522043504, 231063184, 231063189, 5, 640x360 
0x12CB3460, 36963306522360856, 231063215, 231063218, 3, 640x360 
0x12CB3460, 36963306522681592, 231063244, 231063247, 3, 640x360 
0x12CB3460, 36963306523002496, 231063276, 231063279, 3, 640x360 
0x12CB3460, 36963306523322552, 231063315, 231063317, 2, 640x360 
0x12CB3460, 36963306523641776, 231063367, 231063372, 5, 640x360 
0x12CB3460, 36963306524011256, 231063386, 231063388, 2, 640x360 
0x12CB3460, 36963306524280984, 231063405, 231063407, 2, 640x360 
0x12CB3460, 36963306524762952, 231063455, 231063457, 2, 640x360 
0x12CB3460, 36963306525081464, 231063485, 231063488, 3, 640x360 
0x12CB3460, 36963306525401432, 231063515, 231063518, 3, 640x360 
0x12CB3460, 36963306525722528, 231063555, 231063558, 3, 640x360 
0x12CB3460, 36963306526041464, 231063586, 231063603, 17, 640x360 
0x12CB3460, 36963306526361944, 231063615, 231063617, 2, 640x360 
0x12CB3460, 36963306526681720, 231063645, 231063648, 3, 640x360 
0x12CB3460, 36963306527001328, 231063674, 231063677, 3, 640x360 
0x12CB3460, 36963306527321240, 231063714, 231063717, 3, 640x360 
0x12CB3460, 36963306527641136, 231063745, 231063748, 3, 640x360 
0x12CB3460, 36963306527962728, 231063776, 231063779, 3, 640x360 
0x12CB3460, 36963306528282584, 231063804, 231063808, 4, 640x360 
0x12CB3460, 36963306528760592, 231063877, 231063880, 3, 640x360 
0x12CB3460, 36963306529083144, 231063885, 231063888, 3, 640x360 
0x12CB3460, 36963306529401960, 231063916, 231063918, 2, 640x360 
0x12CB3460, 36963306529720472, 231063945, 231063948, 3, 640x360 
0x12CB3460, 36963306530047264, 231063985, 231063988, 3, 640x360 
0x12CB3460, 36963306530362304, 231064014, 231064017, 3, 640x360 
0x12CB3460, 36963306530682696, 231064045, 231064048, 3, 640x360 
0x12CB3460, 36963306531002336, 231064074, 231064077, 3, 640x360 
0x12CB3460, 36963306531321800, 231064105, 231064108, 3, 640x360 
0x12CB3460, 36963306531642968, 231064145, 231064148, 3, 640x360 
0x12CB3460, 36963306531962432, 231064174, 231064177, 3, 640x360 
0x12CB3460, 36963306532282688, 231064205, 231064207, 2, 640x360 
0x12CB3460, 36963306532762256, 231064254, 231064256, 2, 640x360 
0x12CB3460, 36963306533083080, 231064285, 231064288, 3, 640x360 
0x12CB3460, 36963306533402480, 231064316, 231064319, 3, 640x360 
0x12CB3460, 36963306533722152, 231064370, 231064375, 5, 640x360 
0x12CB3460, 36963306534044736, 231064384, 231064388, 4, 640x360 
0x12CB3460, 36963306534361080, 231064415, 231064417, 2, 640x360 
0x12CB3460, 36963306534682280, 231064444, 231064447, 3, 640x360 
0x12CB3460, 36963306535003064, 231064475, 231064478, 3, 640x360 
0x12CB3460, 36963306535321120, 231064515, 231064517, 2, 640x360 
0x12CB3460, 36963306535641096, 231064544, 231064547, 3, 640x360 
0x12CB3460, 36963306535962848, 231064575, 231064578, 3, 640x360 
0x12CB3460, 36963306536441568, 231064625, 231064628, 3, 640x360 
0x12CB3460, 36963306536765072, 231064655, 231064658, 3, 640x360 
0x12CB3460, 36963306537080752, 231064684, 231064689, 5, 640x360 
0x12CB3460, 36963306537402376, 231064715, 231064718, 3, 640x360 
0x12CB3460, 36963306537722104, 231064755, 231064757, 2, 640x360 
0x12CB3460, 36963306538043240, 231064785, 231064788, 3, 640x360 
0x12CB3460, 36963306538362472, 231064815, 231064817, 2, 640x360 
0x12CB3460, 36963306538684672, 231064867, 231064871, 4, 640x360 
0x12CB3460, 36963306539003240, 231064875, 231064878, 3, 640x360 
0x12CB3460, 36963306539320624, 231064905, 231064909, 4, 640x360 
0x12CB3460, 36963306539642576, 231064946, 231064948, 2, 640x360 
0x12CB3460, 36963306539963840, 231064975, 231064977, 2, 640x360 
0x12CB3460, 36963306540441192, 231065025, 231065028, 3, 640x360 
0x12CB3460, 36963306540761504, 231065055, 231065058, 3, 640x360 
0x12CB3460, 36963306541080376, 231065086, 231065088, 2, 640x360 
0x12CB3460, 36963306541402096, 231065115, 231065118, 3, 640x360 
0x12CB3460, 36963306541721000, 231065154, 231065157, 3, 640x360 
0x12CB3460, 36963306542042568, 231065187, 231065191, 4, 640x360 
0x12CB3460, 36963306542361584, 231065214, 231065217, 3, 640x360 
0x12CB3460, 36963306542681952, 231065244, 231065246, 2, 640x360 
0x12CB3460, 36963306543001272, 231065275, 231065278, 3, 640x360 
0x12CB3460, 36963306543323904, 231065315, 231065321, 6, 640x360 
0x12CB3460, 36963306543644328, 231065344, 231065347, 3, 640x360 
0x12CB3460, 36963306544119880, 231065385, 231065389, 4, 640x360 
0x12CB3460, 36963306544442928, 231065424, 231065427, 3, 640x360 
0x12CB3460, 36963306544761472, 231065455, 231065458, 3, 640x360 
0x12CB3460, 36963306545082640, 231065485, 231065487, 2, 640x360 
0x12CB3460, 36963306545401856, 231065516, 231065520, 4, 640x360 
0x12CB3460, 36963306545721288, 231065555, 231065558, 3, 640x360 
0x12CB3460, 36963306546040616, 231065584, 231065588, 4, 640x360 
0x12CB3460, 36963306546360248, 231065615, 231065617, 2, 640x360 
0x12CB3460, 36963306546683624, 231065645, 231065648, 3, 640x360 
0x12CB3460, 36963306547001240, 231065675, 231065686, 11, 640x360 
0x12CB3460, 36963306547322456, 231065715, 231065718, 3, 640x360 
0x12CB3460, 36963306547641560, 231065744, 231065746, 2, 640x360 
0x12CB3460, 36963306548124456, 231065795, 231065797, 2, 640x360 
0x12CB3460, 36963306548441408, 231065825, 231065829, 4, 640x360 
0x12CB3460, 36963306548760744, 231065874, 231065877, 3, 640x360 
0x12CB3460, 36963306549080512, 231065884, 231065889, 5, 640x360 
0x12CB3460, 36963306549400880, 231065915, 231065918, 3, 640x360 
0x12CB3460, 36963306549720728, 231065955, 231065957, 2, 640x360 
0x12CB3460, 36963306550041424, 231065984, 231065988, 4, 640x360 
0x12CB3460, 36963306550360544, 231066015, 231066018, 3, 640x360 
0x12CB3460, 36963306550682776, 231066045, 231066060, 15, 640x360 
0x12CB3460, 36963306551001008, 231066075, 231066078, 3, 640x360 
0x12CB3460, 36963306551320792, 231066116, 231066118, 2, 640x360 
0x12CB3460, 36963306551641512, 231066144, 231066160, 16, 640x360 
0x12CB3460, 36963306552120728, 231066195, 231066197, 2, 640x360 
0x12CB3460, 36963306552440744, 231066224, 231066227, 3, 640x360 
0x12CB3460, 36963306552762328, 231066254, 231066257, 3, 640x360 
0x12CB3460, 36963306553082912, 231066285, 231066288, 3, 640x360 
0x12CB3460, 36963306553401400, 231066314, 231066318, 4, 640x360 
0x12CB3460, 36963306553721512, 231066370, 231066376, 6, 640x360 
0x12CB3460, 36963306554042568, 231066385, 231066388, 3, 640x360 
0x12CB3460, 36963306554361984, 231066414, 231066417, 3, 640x360 
0x12CB3460, 36963306554682344, 231066445, 231066448, 3, 640x360 
0x12CB3460, 36963306555002744, 231066475, 231066479, 4, 640x360 
0x12CB3460, 36963306555322008, 231066505, 231066509, 4, 640x360 
0x12CB3460, 36963306555802728, 231066554, 231066558, 4, 640x360 
0x12CB3460, 36963306556123240, 231066594, 231066597, 3, 640x360 
0x12CB3460, 36963306556442128, 231066626, 231066628, 2, 640x360 
0x12CB3460, 36963306556761024, 231066655, 231066658, 3, 640x360 
0x12CB3460, 36963306557081472, 231066685, 231066689, 4, 640x360 
0x12CB3460, 36963306557403088, 231066714, 231066718, 4, 640x360 
0x12CB3460, 36963306557722168, 231066745, 231066749, 4, 640x360 
0x12CB3460, 36963306558042072, 231066785, 231066788, 3, 640x360 
0x12CB3460, 36963306558361848, 231066815, 231066818, 3, 640x360 
0x12CB3460, 36963306558686448, 231066844, 231066847, 3, 640x360 
0x12CB3460, 36963306559074104, 231066885, 231066904, 19, 640x360 
0x12CB3460, 36963306559321960, 231066916, 231066918, 2, 640x360 
0x12CB3460, 36963306559802816, 231066955, 231066958, 3, 640x360 
0x12CB3460, 36963306560123208, 231066995, 231066998, 3, 640x360 
0x12CB3460, 36963306560441328, 231067024, 231067027, 3, 640x360 
0x12CB3460, 36963306560763640, 231067055, 231067058, 3, 640x360 
0x12CB3460, 36963306561081488, 231067084, 231067087, 3, 640x360 
0x12CB3460, 36963306561400912, 231067115, 231067118, 3, 640x360 
0x12CB3460, 36963306561721960, 231067156, 231067160, 4, 640x360 
0x12CB3460, 36963306562041328, 231067185, 231067188, 3, 640x360 
0x12CB3460, 36963306562361136, 231067215, 231067218, 3, 640x360 
0x12CB3460, 36963306562681360, 231067244, 231067247, 3, 640x360 
0x12CB3460, 36963306563002112, 231067274, 231067277, 3, 640x360 
0x12CB3460, 36963306563321616, 231067314, 231067317, 3, 640x360 
0x12CB3460, 36963306563966944, 231067375, 231067377, 2, 640x360 
0x12CB3460, 36963306564120840, 231067387, 231067390, 3, 640x360 
0x12CB3460, 36963306564440576, 231067424, 231067427, 3, 640x360 
0x12CB3460, 36963306564760984, 231067455, 231067458, 3, 640x360 
0x12CB3460, 36963306565082880, 231067485, 231067489, 4, 640x360 
0x12CB3460, 36963306565401952, 231067516, 231067520, 4, 640x360 
0x12CB3460, 36963306565720576, 231067555, 231067557, 2, 640x360 
0x12CB3460, 36963306566042384, 231067584, 231067588, 4, 640x360 
0x12CB3460, 36963306566361760, 231067615, 231067618, 3, 640x360 
0x12CB3460, 36963306566684656, 231067645, 231067648, 3, 640x360 
0x12CB3460, 36963306567001384, 231067674, 231067677, 3, 640x360 
0x12CB3460, 36963306567481568, 231067725, 231067727, 2, 640x360 
0x12CB3460, 36963306567802248, 231067755, 231067758, 3, 640x360 
0x12CB3460, 36963306568121432, 231067794, 231067797, 3, 640x360 
0x12CB3460, 36963306568441056, 231067825, 231067829, 4, 640x360 
0x12CB3460, 36963306568761944, 231067874, 231067877, 3, 640x360 
0x12CB3460, 36963306569080296, 231067884, 231067888, 4, 640x360 
0x12CB3460, 36963306569401240, 231067914, 231067917, 3, 640x360 
0x12CB3460, 36963306569721000, 231067955, 231067958, 3, 640x360 
0x12CB3460, 36963306570040904, 231067985, 231068002, 17, 640x360 
0x12CB3460, 36963306570362240, 231068015, 231068019, 4, 640x360 
0x12CB3460, 36963306570681024, 231068045, 231068048, 3, 640x360 
0x12CB3460, 36963306571000560, 231068075, 231068077, 2, 640x360 
0x12CB3460, 36963306571482336, 231068125, 231068128, 3, 640x360 
0x12CB3460, 36963306571802720, 231068155, 231068158, 3, 640x360 
0x12CB3460, 36963306572121368, 231068194, 231068197, 3, 640x360 
0x12CB3460, 36963306572442000, 231068225, 231068228, 3, 640x360 
0x12CB3460, 36963306572761880, 231068254, 231068257, 3, 640x360 
0x12CB3460, 36963306573081200, 231068286, 231068288, 2, 640x360 
0x12CB3460, 36963306573404472, 231068315, 231068319, 4, 640x360 
0x12CB3460, 36963306573722216, 231068379, 231068383, 4, 640x360 
0x12CB3460, 36963306574094880, 231068386, 231068390, 4, 640x360 
0x12CB3460, 36963306574361896, 231068414, 231068417, 3, 640x360 
0x12CB3460, 36963306574681472, 231068444, 231068447, 3, 640x360 
0x12CB3460, 36963306575163064, 231068496, 231068500, 4, 640x360 
0x12CB3460, 36963306575489544, 231068525, 231068529, 4, 640x360 
0x12CB3460, 36963306575803104, 231068555, 231068558, 3, 640x360 
0x12CB3460, 36963306576119976, 231068585, 231068589, 4, 640x360 
0x12CB3460, 36963306576441328, 231068625, 231068627, 2, 640x360 
0x12CB3460, 36963306576763144, 231068655, 231068658, 3, 640x360 
0x12CB3460, 36963306577080856, 231068685, 231068688, 3, 640x360 
0x12CB3460, 36963306577402016, 231068714, 231068718, 4, 640x360 
0x12CB3460, 36963306577720952, 231068745, 231068761, 16, 640x360 
0x12CB3460, 36963306578041040, 231068786, 231068789, 3, 640x360 
0x12CB3460, 36963306578361256, 231068814, 231068817, 3, 640x360 
0x12CB3460, 36963306578682312, 231068845, 231068847, 2, 640x360 
0x12CB3460, 36963306579173784, 231068894, 231068897, 3, 640x360 
0x12CB3460, 36963306579481696, 231068926, 231068929, 3, 640x360 
0x12CB3460, 36963306579800368, 231068955, 231068958, 3, 640x360 
0x12CB3460, 36963306580120880, 231068994, 231069005, 11, 640x360 
0x12CB3460, 36963306580440272, 231069025, 231069027, 2, 640x360 
0x12CB3460, 36963306580761232, 231069054, 231069057, 3, 640x360 
0x12CB3460, 36963306581081800, 231069085, 231069088, 3, 640x360 
0x12CB3460, 36963306581400760, 231069115, 231069119, 4, 640x360 
0x12CB3460, 36963306581721672, 231069155, 231069159, 4, 640x360 
0x12CB3460, 36963306582040728, 231069185, 231069188, 3, 640x360 
0x12CB3460, 36963306582364000, 231069216, 231069218, 2, 640x360 
0x12CB3460, 36963306582681464, 231069244, 231069247, 3, 640x360 
0x12CB3460, 36963306583162776, 231069296, 231069298, 2, 640x360 
0x12CB3460, 36963306583484536, 231069325, 231069329, 4, 640x360 
0x12CB3460, 36963306583981496, 231069375, 231069378, 3, 640x360 
0x12CB3460, 36963306584121240, 231069386, 231069390, 4, 640x360 
0x12CB3460, 36963306584440592, 231069425, 231069427, 2, 640x360 
0x12CB3460, 36963306584762336, 231069455, 231069458, 3, 640x360 
0x12CB3460, 36963306585081664, 231069485, 231069488, 3, 640x360 
0x12CB3460, 36963306585403048, 231069515, 231069517, 2, 640x360 
0x12CB3460, 36963306585722272, 231069555, 231069558, 3, 640x360 
0x12CB3460, 36963306586041896, 231069584, 231069587, 3, 640x360 
0x12CB3460, 36963306586363288, 231069616, 231069619, 3, 640x360 
0x12CB3460, 36963306586847264, 231069665, 231069668, 3, 640x360 
0x12CB3460, 36963306587163568, 231069695, 231069698, 3, 640x360 
0x12CB3460, 36963306587480328, 231069724, 231069727, 3, 640x360 
0x12CB3460, 36963306587801344, 231069754, 231069757, 3, 640x360 
0x12CB3460, 36963306588122224, 231069795, 231069798, 3, 640x360 
0x12CB3460, 36963306588442968, 231069825, 231069831, 6, 640x360 
0x12CB3460, 36963306588760688, 231069876, 231069880, 4, 640x360 
0x12CB3460, 36963306589082168, 231069885, 231069888, 3, 640x360 
0x12CB3460, 36963306589401680, 231069914, 231069918, 4, 640x360 
0x12CB3460, 36963306589722168, 231069954, 231069957, 3, 640x360 
0x12CB3460, 36963306590041008, 231069985, 231069988, 3, 640x360 
0x12CB3460, 36963306590361848, 231070014, 231070017, 3, 640x360 
0x12CB3460, 36963306590840096, 231070065, 231070067, 2, 640x360 
0x12CB3460, 36963306591160160, 231070095, 231070097, 2, 640x360 
0x12CB3460, 36963306591481368, 231070125, 231070128, 3, 640x360 
0x12CB3460, 36963306591801952, 231070155, 231070158, 3, 640x360 
0x12CB3460, 36963306592121104, 231070185, 231070191, 6, 640x360 
0x12CB3460, 36963306592442376, 231070224, 231070227, 3, 640x360 
0x12CB3460, 36963306592761296, 231070255, 231070260, 5, 640x360 
0x12CB3460, 36963306593082008, 231070284, 231070287, 3, 640x360 
0x12CB3460, 36963306593401360, 231070315, 231070318, 3, 640x360 
0x12CB3460, 36963306593721592, 231070387, 231070396, 9, 640x360 
0x12CB3460, 36963306594361280, 231070415, 231070418, 3, 640x360 
0x12CB3460, 36963306594842360, 231070465, 231070468, 3, 640x360 
0x12CB3460, 36963306595163664, 231070495, 231070501, 6, 640x360 
0x12CB3460, 36963306595480224, 231070525, 231070527, 2, 640x360 
0x12CB3460, 36963306595802200, 231070554, 231070557, 3, 640x360 
0x12CB3460, 36963306596122936, 231070594, 231070598, 4, 640x360 
0x12CB3460, 36963306596444608, 231070624, 231070627, 3, 640x360 
0x12CB3460, 36963306596765536, 231070656, 231070660, 4, 640x360 
0x12CB3460, 36963306597085464, 231070685, 231070688, 3, 640x360 
0x12CB3460, 36963306597404600, 231070714, 231070719, 5, 640x360 
0x12CB3460, 36963306597721616, 231070745, 231070749, 4, 640x360 
0x12CB3460, 36963306598042448, 231070786, 231070788, 2, 640x360 
0x12CB3460, 36963306598519680, 231070825, 231070828, 3, 640x360 
0x12CB3460, 36963306599001488, 231070874, 231070878, 4, 640x360 
0x12CB3460, 36963306599160840, 231070894, 231070897, 3, 640x360 
0x12CB3460, 36963306599481032, 231070925, 231070927, 2, 640x360 
0x12CB3460, 36963306599800384, 231070955, 231070958, 3, 640x360 
0x12CB3460, 36963306600120424, 231070994, 231070996, 2, 640x360 
0x12CB3460, 36963306600441528, 231071025, 231071028, 3, 640x360 
0x12CB3460, 36963306600760960, 231071054, 231071057, 3, 640x360 
0x12CB3460, 36963306601080512, 231071085, 231071088, 3, 640x360 
0x12CB3460, 36963306601400216, 231071115, 231071117, 2, 640x360 
0x12CB3460, 36963306601721560, 231071145, 231071149, 4, 640x360 
0x12CB3460, 36963306602040864, 231071185, 231071189, 4, 640x360 
0x12CB3460, 36963306602520896, 231071235, 231071238, 3, 640x360 
0x12CB3460, 36963306602842280, 231071264, 231071267, 3, 640x360 
0x12CB3460, 36963306603163056, 231071295, 231071298, 3, 640x360 
0x12CB3460, 36963306603480776, 231071325, 231071328, 3, 640x360 
0x12CB3460, 36963306603981528, 231071375, 231071377, 2, 640x360 
0x12CB3460, 36963306604121056, 231071394, 231071397, 3, 640x360 
0x12CB3460, 36963306604441944, 231071425, 231071427, 2, 640x360 
0x12CB3460, 36963306604760800, 231071454, 231071457, 3, 640x360 
0x12CB3460, 36963306605082232, 231071486, 231071489, 3, 640x360 
0x12CB3460, 36963306605404048, 231071514, 231071518, 4, 640x360 
0x12CB3460, 36963306605722352, 231071554, 231071557, 3, 640x360 
0x12CB3460, 36963306606041928, 231071585, 231071588, 3, 640x360 
0x12CB3460, 36963306606521416, 231071626, 231071629, 3, 640x360 
0x12CB3460, 36963306606843584, 231071664, 231071667, 3, 640x360 
0x12CB3460, 36963306607163400, 231071695, 231071698, 3, 640x360 
0x12CB3460, 36963306607482696, 231071725, 231071728, 3, 640x360 
0x12CB3460, 36963306607801216, 231071755, 231071758, 3, 640x360 
0x12CB3460, 36963306608121408, 231071794, 231071797, 3, 640x360 
0x12CB3460, 36963306608441224, 231071825, 231071828, 3, 640x360 
0x12CB3460, 36963306608918648, 231071875, 231071877, 2, 640x360 
0x12CB3460, 36963306609080032, 231071885, 231071889, 4, 640x360 
0x12CB3460, 36963306609400448, 231071915, 231071917, 2, 640x360 
0x12CB3460, 36963306609721728, 231071954, 231071957, 3, 640x360 
0x12CB3460, 36963306610201784, 231071995, 231071998, 3, 640x360 
0x12CB3460, 36963306610521152, 231072034, 231072037, 3, 640x360 
0x12CB3460, 36963306610839928, 231072065, 231072067, 2, 640x360 
0x12CB3460, 36963306611161264, 231072094, 231072110, 16, 640x360 
0x12CB3460, 36963306611480608, 231072125, 231072127, 2, 640x360 
0x12CB3460, 36963306611801320, 231072154, 231072157, 3, 640x360 
0x12CB3460, 36963306612122064, 231072195, 231072199, 4, 640x360 
0x12CB3460, 36963306612440024, 231072225, 231072227, 2, 640x360 
0x12CB3460, 36963306612761392, 231072254, 231072261, 7, 640x360 
0x12CB3460, 36963306613080208, 231072285, 231072289, 4, 640x360 
0x12CB3460, 36963306613401520, 231072314, 231072318, 4, 640x360 
0x12CB3460, 36963306613722112, 231072375, 231072378, 3, 640x360 
0x12CB3460, 36963306614199736, 231072395, 231072398, 3, 640x360 
0x12CB3460, 36963306614521064, 231072425, 231072429, 4, 640x360 
0x12CB3460, 36963306614841448, 231072465, 231072467, 2, 640x360 
0x12CB3460, 36963306615162712, 231072494, 231072497, 3, 640x360 
0x12CB3460, 36963306615480584, 231072525, 231072529, 4, 640x360 
0x12CB3460, 36963306615800320, 231072555, 231072557, 2, 640x360 
0x12CB3460, 36963306616120704, 231072594, 231072597, 3, 640x360 
0x12CB3460, 36963306616441744, 231072624, 231072627, 3, 640x360 
0x12CB3460, 36963306616760664, 231072656, 231072662, 6, 640x360 
0x12CB3460, 36963306617081448, 231072685, 231072688, 3, 640x360 
0x12CB3460, 36963306617402936, 231072716, 231072719, 3, 640x360 
0x12CB3460, 36963306617880040, 231072764, 231072767, 3, 640x360 
0x12CB3460, 36963306618200992, 231072795, 231072799, 4, 640x360 
0x12CB3460, 36963306618519912, 231072835, 231072838, 3, 640x360 
0x12CB3460, 36963306618842208, 231072890, 231072896, 6, 640x360 
0x12CB3460, 36963306619162384, 231072896, 231072899, 3, 640x360 
0x12CB3460, 36963306619481104, 231072924, 231072937, 13, 640x360 
0x12CB3460, 36963306619801352, 231072955, 231072958, 3, 640x360 
0x12CB3460, 36963306620121328, 231072994, 231072997, 3, 640x360 
0x12CB3460, 36963306620443728, 231073025, 231073027, 2, 640x360 
0x12CB3460, 36963306620761432, 231073055, 231073058, 3, 640x360 
0x12CB3460, 36963306621080224, 231073085, 231073088, 3, 640x360 
0x12CB3460, 36963306621400272, 231073115, 231073118, 3, 640x360 
0x12CB3460, 36963306621880888, 231073166, 231073169, 3, 640x360 
0x12CB3460, 36963306622201984, 231073195, 231073198, 3, 640x360 
0x12CB3460, 36963306622519976, 231073234, 231073238, 4, 640x360 
0x12CB3460, 36963306622841432, 231073264, 231073267, 3, 640x360 
0x12CB3460, 36963306623162800, 231073295, 231073298, 3, 640x360 
0x12CB3460, 36963306623481792, 231073325, 231073329, 4, 640x360 
0x12CB3460, 36963306624026968, 231073386, 231073390, 4, 640x360 
0x12CB3460, 36963306624120280, 231073395, 231073398, 3, 640x360 
0x12CB3460, 36963306624441008, 231073424, 231073427, 3, 640x360 
0x12CB3460, 36963306624762000, 231073455, 231073458, 3, 640x360 
0x12CB3460, 36963306625081248, 231073484, 231073488, 4, 640x360 
0x12CB3460, 36963306625403312, 231073516, 231073520, 4, 640x360 
0x12CB3460, 36963306625879864, 231073565, 231073569, 4, 640x360 
0x12CB3460, 36963306626201576, 231073594, 231073597, 3, 640x360 
0x12CB3460, 36963306626522048, 231073634, 231073637, 3, 640x360 
0x12CB3460, 36963306626840440, 231073666, 231073672, 6, 640x360 
0x12CB3460, 36963306627161552, 231073694, 231073697, 3, 640x360 
0x12CB3460, 36963306627481704, 231073725, 231073728, 3, 640x360 
0x12CB3460, 36963306627801648, 231073756, 231073758, 2, 640x360 
0x12CB3460, 36963306628120584, 231073796, 231073798, 2, 640x360 
0x12CB3460, 36963306628459560, 231073824, 231073828, 4, 640x360 
0x12CB3460, 36963306628917872, 231073875, 231073877, 2, 640x360 
0x12CB3460, 36963306629081472, 231073885, 231073888, 3, 640x360 
0x12CB3460, 36963306629559984, 231073934, 231073939, 5, 640x360 
0x12CB3460, 36963306629879992, 231073966, 231073968, 2, 640x360 
0x12CB3460, 36963306630201544, 231073995, 231073998, 3, 640x360 
0x12CB3460, 36963306630520616, 231074034, 231074038, 4, 640x360 
0x12CB3460, 36963306630840016, 231074065, 231074067, 2, 640x360 
0x12CB3460, 36963306631160960, 231074094, 231074096, 2, 640x360 
0x12CB3460, 36963306631481520, 231074125, 231074127, 2, 640x360 
0x12CB3460, 36963306631801984, 231074154, 231074157, 3, 640x360 
0x12CB3460, 36963306632122216, 231074195, 231074197, 2, 640x360 
0x12CB3460, 36963306632440512, 231074224, 231074227, 3, 640x360 
0x12CB3460, 36963306632761432, 231074255, 231074258, 3, 640x360 
0x12CB3460, 36963306633081488, 231074284, 231074288, 4, 640x360 
0x12CB3460, 36963306633561048, 231074335, 231074339, 4, 640x360 
0x12CB3460, 36963306634060584, 231074385, 231074388, 3, 640x360 
0x12CB3460, 36963306634199616, 231074395, 231074398, 3, 640x360 
0x12CB3460, 36963306634521440, 231074425, 231074429, 4, 640x360 
0x12CB3460, 36963306634840912, 231074466, 231074469, 3, 640x360 
0x12CB3460, 36963306635161664, 231074495, 231074498, 3, 640x360 
0x12CB3460, 36963306635481768, 231074524, 231074527, 3, 640x360 
0x12CB3460, 36963306635802368, 231074555, 231074559, 4, 640x360 
0x12CB3460, 36963306636120176, 231074595, 231074598, 3, 640x360 
0x12CB3460, 36963306636441168, 231074625, 231074628, 3, 640x360 
0x12CB3460, 36963306636760208, 231074655, 231074660, 5, 640x360 
0x12CB3460, 36963306637081600, 231074686, 231074690, 4, 640x360 
0x12CB3460, 36963306637561800, 231074735, 231074738, 3, 640x360 
0x12CB3460, 36963306637882688, 231074765, 231074767, 2, 640x360 
0x12CB3460, 36963306638202664, 231074795, 231074798, 3, 640x360 
0x12CB3460, 36963306638520728, 231074836, 231074841, 5, 640x360 
0x12CB3460, 36963306639028176, 231074884, 231074889, 5, 640x360 
0x12CB3460, 36963306639162152, 231074895, 231074898, 3, 640x360 
0x12CB3460, 36963306639481384, 231074924, 231074927, 3, 640x360 
0x12CB3460, 36963306639802072, 231074956, 231074959, 3, 640x360 
0x12CB3460, 36963306640122376, 231074995, 231075001, 6, 640x360 
0x12CB3460, 36963306640441432, 231075025, 231075027, 2, 640x360 
0x12CB3460, 36963306640761784, 231075055, 231075057, 2, 640x360 
0x12CB3460, 36963306641241776, 231075106, 231075108, 2, 640x360 
0x12CB3460, 36963306641562560, 231075134, 231075138, 4, 640x360 
0x12CB3460, 36963306641881096, 231075166, 231075169, 3, 640x360 
0x12CB3460, 36963306642203592, 231075195, 231075199, 4, 640x360 
0x12CB3460, 36963306642524848, 231075235, 231075240, 5, 640x360 
0x12CB3460, 36963306642842776, 231075264, 231075268, 4, 640x360 
0x12CB3460, 36963306643163944, 231075295, 231075298, 3, 640x360 
0x12CB3460, 36963306643481832, 231075325, 231075330, 5, 640x360 
0x12CB3460, 36963306643997864, 231075375, 231075379, 4, 640x360 
0x12CB3460, 36963306644120808, 231075386, 231075390, 4, 640x360 
0x12CB3460, 36963306644440520, 231075425, 231075428, 3, 640x360 
0x12CB3460, 36963306644760952, 231075455, 231075458, 3, 640x360 
0x12CB3460, 36963306645243200, 231075504, 231075507, 3, 640x360 
0x12CB3460, 36963306645564216, 231075536, 231075540, 4, 640x360 
0x12CB3460, 36963306645880272, 231075565, 231075568, 3, 640x360 
0x12CB3460, 36963306646202720, 231075596, 231075599, 3, 640x360 
0x12CB3460, 36963306646524832, 231075635, 231075653, 18, 640x360 
0x12CB3460, 36963306646845968, 231075667, 231075672, 5, 640x360 
0x12CB3460, 36963306647164464, 231075696, 231075701, 5, 640x360 
0x12CB3460, 36963306647480320, 231075725, 231075728, 3, 640x360 
0x12CB3460, 36963306647801320, 231075756, 231075758, 2, 640x360 
0x12CB3460, 36963306648121168, 231075785, 231075788, 3, 640x360 
0x12CB3460, 36963306648440944, 231075824, 231075827, 3, 640x360 
0x12CB3460, 36963306648762384, 231075875, 231075879, 4, 640x360 
0x12CB3460, 36963306649240128, 231075904, 231075907, 3, 640x360 
0x12CB3460, 36963306649561336, 231075935, 231075938, 3, 640x360 
0x12CB3460, 36963306649881992, 231075964, 231075967, 3, 640x360 
0x12CB3460, 36963306650202480, 231075995, 231075999, 4, 640x360 
0x12CB3460, 36963306650522792, 231076035, 231076039, 4, 640x360 
0x12CB3460, 36963306650841304, 231076064, 231076067, 3, 640x360 
0x12CB3460, 36963306651160712, 231076095, 231076097, 2, 640x360 
0x12CB3460, 36963306651480760, 231076124, 231076127, 3, 640x360 
0x12CB3460, 36963306651801344, 231076155, 231076158, 3, 640x360 
0x12CB3460, 36963306652121728, 231076194, 231076197, 3, 640x360 
0x12CB3460, 36963306652440984, 231076224, 231076236, 12, 640x360 
0x12CB3460, 36963306652921616, 231076276, 231076278, 2, 640x360 
0x12CB3460, 36963306653240160, 231076304, 231076307, 3, 640x360 
0x12CB3460, 36963306653563440, 231076336, 231076339, 3, 640x360 
0x12CB3460, 36963306654060616, 231076385, 231076395, 10, 640x360 
0x12CB3460, 36963306654200016, 231076395, 231076398, 3, 640x360 
0x12CB3460, 36963306654520216, 231076434, 231076437, 3, 640x360 
0x12CB3460, 36963306654842368, 231076465, 231076468, 3, 640x360 
0x12CB3460, 36963306655163280, 231076495, 231076498, 3, 640x360 
0x12CB3460, 36963306655481072, 231076526, 231076532, 6, 640x360 
0x12CB3460, 36963306655801120, 231076555, 231076558, 3, 640x360 
0x12CB3460, 36963306656122464, 231076595, 231076597, 2, 640x360 
0x12CB3460, 36963306656441720, 231076624, 231076627, 3, 640x360 
0x12CB3460, 36963306656922008, 231076666, 231076670, 4, 640x360 
0x12CB3460, 36963306657240256, 231076705, 231076707, 2, 640x360 
0x12CB3460, 36963306657559792, 231076734, 231076739, 5, 640x360 
0x12CB3460, 36963306657882936, 231076765, 231076767, 2, 640x360 
0x12CB3460, 36963306658200248, 231076795, 231076798, 3, 640x360 
0x12CB3460, 36963306658522056, 231076835, 231076840, 5, 640x360 
0x12CB3460, 36963306658990248, 231076874, 231076877, 3, 640x360 
0x12CB3460, 36963306659162360, 231076894, 231076897, 3, 640x360 
0x12CB3460, 36963306659480720, 231076925, 231076928, 3, 640x360 
0x12CB3460, 36963306659801360, 231076955, 231076957, 2, 640x360 
0x12CB3460, 36963306660121976, 231076995, 231076998, 3, 640x360 
0x12CB3460, 36963306660599584, 231077034, 231077039, 5, 640x360 
0x12CB3460, 36963306660920944, 231077065, 231077069, 4, 640x360 
0x12CB3460, 36963306661240728, 231077105, 231077107, 2, 640x360 
0x12CB3460, 36963306661561640, 231077135, 231077138, 3, 640x360 
0x12CB3460, 36963306661883376, 231077166, 231077168, 2, 640x360 
0x12CB3460, 36963306662201600, 231077195, 231077198, 3, 640x360 
0x12CB3460, 36963306662521824, 231077235, 231077238, 3, 640x360 
0x12CB3460, 36963306662841216, 231077265, 231077268, 3, 640x360 
0x12CB3460, 36963306663162008, 231077295, 231077299, 4, 640x360 
0x12CB3460, 36963306663483152, 231077324, 231077328, 4, 640x360 
0x12CB3460, 36963306663802584, 231077385, 231077389, 4, 640x360 
0x12CB3460, 36963306664124680, 231077395, 231077397, 2, 640x360 
0x12CB3460, 36963306664601104, 231077435, 231077438, 3, 640x360 
0x12CB3460, 36963306664922192, 231077475, 231077478, 3, 640x360 
0x12CB3460, 36963306665241768, 231077506, 231077508, 2, 640x360 
0x12CB3460, 36963306665561968, 231077534, 231077538, 4, 640x360 
0x12CB3460, 36963306665880280, 231077564, 231077568, 4, 640x360 
0x12CB3460, 36963306666202168, 231077595, 231077598, 3, 640x360 
0x12CB3460, 36963306666523096, 231077636, 231077640, 4, 640x360 
0x12CB3460, 36963306666842472, 231077664, 231077668, 4, 640x360 
0x12CB3460, 36963306667161000, 231077695, 231077698, 3, 640x360 
0x12CB3460, 36963306667484856, 231077725, 231077729, 4, 640x360 
0x12CB3460, 36963306667801280, 231077754, 231077757, 3, 640x360 
0x12CB3460, 36963306668120984, 231077794, 231077797, 3, 640x360 
0x12CB3460, 36963306668600776, 231077835, 231077838, 3, 640x360 
0x12CB3460, 36963306669066584, 231077885, 231077888, 3, 640x360 
0x12CB3460, 36963306669239920, 231077905, 231077907, 2, 640x360 
0x12CB3460, 36963306669560312, 231077934, 231077937, 3, 640x360 
0x12CB3460, 36963306669882040, 231077964, 231077967, 3, 640x360 
0x12CB3460, 36963306670201592, 231077995, 231078011, 16, 640x360 
0x12CB3460, 36963306670525904, 231078034, 231078037, 3, 640x360 
0x12CB3460, 36963306670841848, 231078065, 231078068, 3, 640x360 
0x12CB3460, 36963306671160168, 231078094, 231078097, 3, 640x360 
0x12CB3460, 36963306671480768, 231078125, 231078127, 2, 640x360 
0x12CB3460, 36963306671801656, 231078154, 231078158, 4, 640x360 
0x12CB3460, 36963306672281416, 231078205, 231078208, 3, 640x360 
0x12CB3460, 36963306672603688, 231078235, 231078240, 5, 640x360 
0x12CB3460, 36963306672921240, 231078265, 231078269, 4, 640x360 
0x12CB3460, 36963306673241552, 231078305, 231078308, 3, 640x360 
0x12CB3460, 36963306673562432, 231078335, 231078338, 3, 640x360 
0x12CB3460, 36963306674009712, 231078376, 231078380, 4, 640x360 
0x12CB3460, 36963306674199872, 231078395, 231078398, 3, 640x360 
0x12CB3460, 36963306674521456, 231078435, 231078437, 2, 640x360 
0x12CB3460, 36963306674841168, 231078466, 231078469, 3, 640x360 
0x12CB3460, 36963306675161456, 231078495, 231078498, 3, 640x360 
0x12CB3460, 36963306675482376, 231078526, 231078529, 3, 640x360 
0x12CB3460, 36963306675801928, 231078555, 231078559, 4, 640x360 
0x12CB3460, 36963306676281272, 231078604, 231078607, 3, 640x360 
0x12CB3460, 36963306676601056, 231078635, 231078638, 3, 640x360 
0x12CB3460, 36963306676923048, 231078675, 231078678, 3, 640x360 
0x12CB3460, 36963306677239912, 231078706, 231078708, 2, 640x360 
0x12CB3460, 36963306677560328, 231078734, 231078738, 4, 640x360 
0x12CB3460, 36963306677880656, 231078764, 231078777, 13, 640x360 
0x12CB3460, 36963306678200992, 231078795, 231078798, 3, 640x360 
0x12CB3460, 36963306678521192, 231078825, 231078834, 9, 640x360 
0x12CB3460, 36963306678992496, 231078885, 231078890, 5, 640x360 
0x12CB3460, 36963306679164840, 231078894, 231078898, 4, 640x360 
0x12CB3460, 36963306679481080, 231078925, 231078928, 3, 640x360 
0x12CB3460, 36963306679801952, 231078955, 231078958, 3, 640x360 
0x12CB3460, 36963306680282336, 231079005, 231079008, 3, 640x360 
0x12CB3460, 36963306680603856, 231079044, 231079048, 4, 640x360 
0x12CB3460, 36963306680920576, 231079075, 231079077, 2, 640x360 
0x12CB3460, 36963306681241056, 231079105, 231079108, 3, 640x360 
0x12CB3460, 36963306681561272, 231079136, 231079139, 3, 640x360 
0x12CB3460, 36963306681881448, 231079165, 231079167, 2, 640x360 
0x12CB3460, 36963306682199768, 231079195, 231079198, 3, 640x360 
0x12CB3460, 36963306682522176, 231079235, 231079238, 3, 640x360 
0x12CB3460, 36963306682840488, 231079264, 231079267, 3, 640x360 
0x12CB3460, 36963306683162808, 231079294, 231079296, 2, 640x360 
0x12CB3460, 36963306683481048, 231079325, 231079328, 3, 640x360 
0x12CB3460, 36963306684038816, 231079385, 231079391, 6, 640x360 
0x12CB3460, 36963306684279432, 231079404, 231079406, 2, 640x360 
0x12CB3460, 36963306684601064, 231079435, 231079437, 2, 640x360 
0x12CB3460, 36963306684921480, 231079476, 231079478, 2, 640x360 
0x12CB3460, 36963306685240768, 231079505, 231079508, 3, 640x360 
0x12CB3460, 36963306685560488, 231079535, 231079539, 4, 640x360 
0x12CB3460, 36963306685880336, 231079564, 231079567, 3, 640x360 
0x12CB3460, 36963306686201712, 231079594, 231079598, 4, 640x360 
0x12CB3460, 36963306686522728, 231079635, 231079638, 3, 640x360 
0x12CB3460, 36963306686841928, 231079665, 231079668, 3, 640x360 
0x12CB3460, 36963306687162608, 231079695, 231079698, 3, 640x360 
0x12CB3460, 36963306687483160, 231079725, 231079728, 3, 640x360 
0x12CB3460, 36963306687961576, 231079775, 231079778, 3, 640x360 
0x12CB3460, 36963306688281008, 231079805, 231079807, 2, 640x360 
0x12CB3460, 36963306688601392, 231079835, 231079838, 3, 640x360 
0x12CB3460, 36963306688973584, 231079874, 231079877, 3, 640x360 
0x12CB3460, 36963306689240904, 231079904, 231079907, 3, 640x360 
0x12CB3460, 36963306689561648, 231079935, 231079938, 3, 640x360 
0x12CB3460, 36963306689881192, 231079966, 231079970, 4, 640x360 
0x12CB3460, 36963306690201336, 231079995, 231079998, 3, 640x360 
0x12CB3460, 36963306690520760, 231080025, 231080029, 4, 640x360 
0x12CB3460, 36963306690841952, 231080065, 231080068, 3, 640x360 
0x12CB3460, 36963306691163840, 231080095, 231080098, 3, 640x360 
0x12CB3460, 36963306691639632, 231080144, 231080147, 3, 640x360 
0x12CB3460, 36963306691961776, 231080174, 231080178, 4, 640x360 
0x12CB3460, 36963306692279288, 231080204, 231080207, 3, 640x360 
0x12CB3460, 36963306692600552, 231080235, 231080238, 3, 640x360 
0x12CB3460, 36963306692920192, 231080265, 231080269, 4, 640x360 
0x12CB3460, 36963306693241712, 231080304, 231080307, 3, 640x360 
0x12CB3460, 36963306693562032, 231080335, 231080338, 3, 640x360 
0x12CB3460, 36963306694075880, 231080386, 231080391, 5, 640x360 
0x12CB3460, 36963306694200008, 231080395, 231080401, 6, 640x360 
0x12CB3460, 36963306694520528, 231080425, 231080428, 3, 640x360 
0x12CB3460, 36963306694840120, 231080465, 231080469, 4, 640x360 
0x12CB3460, 36963306695161664, 231080494, 231080497, 3, 640x360 
0x12CB3460, 36963306695639816, 231080544, 231080547, 3, 640x360 
0x12CB3460, 36963306695961472, 231080574, 231080576, 2, 640x360 
0x12CB3460, 36963306696280016, 231080605, 231080607, 2, 640x360 
0x12CB3460, 36963306696603264, 231080635, 231080639, 4, 640x360 
0x12CB3460, 36963306696922048, 231080675, 231080678, 3, 640x360 
0x12CB3460, 36963306697240072, 231080705, 231080708, 3, 640x360 
0x12CB3460, 36963306697560312, 231080735, 231080739, 4, 640x360 
0x12CB3460, 36963306697880200, 231080765, 231080767, 2, 640x360 
0x12CB3460, 36963306698201072, 231080795, 231080798, 3, 640x360 
0x12CB3460, 36963306698520320, 231080825, 231080829, 4, 640x360 
0x12CB3460, 36963306699008552, 231080884, 231080889, 5, 640x360 
0x12CB3460, 36963306699167168, 231080894, 231080896, 2, 640x360 
0x12CB3460, 36963306699639632, 231080944, 231080947, 3, 640x360 
0x12CB3460, 36963306699961824, 231080974, 231080977, 3, 640x360 
0x12CB3460, 36963306700282400, 231081005, 231081008, 3, 640x360 
0x12CB3460, 36963306700599872, 231081034, 231081038, 4, 640x360 
0x12CB3460, 36963306700920984, 231081065, 231081069, 4, 640x360 
0x12CB3460, 36963306701240184, 231081104, 231081107, 3, 640x360 
0x12CB3460, 36963306701561536, 231081135, 231081138, 3, 640x360 
0x12CB3460, 36963306701882096, 231081165, 231081168, 3, 640x360 
0x12CB3460, 36963306702201720, 231081196, 231081202, 6, 640x360 
0x12CB3460, 36963306702520792, 231081234, 231081238, 4, 640x360 
0x12CB3460, 36963306702840488, 231081264, 231081267, 3, 640x360 
0x12CB3460, 36963306703322176, 231081315, 231081318, 3, 640x360 
0x12CB3460, 36963306703640232, 231081347, 231081378, 31, 640x360 
0x12CB3460, 36963306704066264, 231081385, 231081389, 4, 640x360 
0x12CB3460, 36963306704279288, 231081405, 231081407, 2, 640x360 
0x12CB3460, 36963306704600784, 231081435, 231081438, 3, 640x360 
0x12CB3460, 36963306704920040, 231081466, 231081470, 4, 640x360 
0x12CB3460, 36963306705240136, 231081504, 231081508, 4, 640x360 
0x12CB3460, 36963306705560120, 231081535, 231081539, 4, 640x360 
0x12CB3460, 36963306705881376, 231081564, 231081567, 3, 640x360 
0x12CB3460, 36963306706202160, 231081595, 231081598, 3, 640x360 
0x12CB3460, 36963306706523864, 231081634, 231081638, 4, 640x360 
0x12CB3460, 36963306706841904, 231081665, 231081669, 4, 640x360 
0x12CB3460, 36963306707322272, 231081715, 231081718, 3, 640x360 
0x12CB3460, 36963306707640056, 231081744, 231081746, 2, 640x360 
0x12CB3460, 36963306707960536, 231081775, 231081787, 12, 640x360 
0x12CB3460, 36963306708279208, 231081804, 231081811, 7, 640x360 
0x12CB3460, 36963306708599560, 231081835, 231081838, 3, 640x360 
0x12CB3460, 36963306709082256, 231081886, 231081889, 3, 640x360 
0x12CB3460, 36963306709243136, 231081905, 231081908, 3, 640x360 
0x12CB3460, 36963306709560304, 231081934, 231081938, 4, 640x360 
0x12CB3460, 36963306709879280, 231081965, 231081968, 3, 640x360 
0x12CB3460, 36963306710199936, 231081994, 231081997, 3, 640x360 
0x12CB3460, 36963306710521040, 231082036, 231082039, 3, 640x360 
0x12CB3460, 36963306710841216, 231082064, 231082067, 3, 640x360 
0x12CB3460, 36963306711320656, 231082105, 231082109, 4, 640x360 
0x12CB3460, 36963306711640288, 231082145, 231082149, 4, 640x360 
0x12CB3460, 36963306711960528, 231082175, 231082178, 3, 640x360 
0x12CB3460, 36963306712281088, 231082205, 231082208, 3, 640x360 
0x12CB3460, 36963306712599960, 231082245, 231082249, 4, 640x360 
0x12CB3460, 36963306712919424, 231082274, 231082277, 3, 640x360 
0x12CB3460, 36963306713239160, 231082305, 231082307, 2, 640x360 
0x12CB3460, 36963306713559752, 231082335, 231082339, 4, 640x360 
0x12CB3460, 36963306714088640, 231082386, 231082389, 3, 640x360 
0x12CB3460, 36963306714199208, 231082395, 231082400, 5, 640x360 
0x12CB3460, 36963306714521912, 231082435, 231082439, 4, 640x360 
0x12CB3460, 36963306715000592, 231082475, 231082478, 3, 640x360 
0x12CB3460, 36963306715321400, 231082514, 231082517, 3, 640x360 
0x12CB3460, 36963306715638800, 231082545, 231082547, 2, 640x360 
0x12CB3460, 36963306715961256, 231082575, 231082578, 3, 640x360 
0x12CB3460, 36963306716279744, 231082604, 231082607, 3, 640x360 
0x12CB3460, 36963306716601760, 231082636, 231082639, 3, 640x360 
0x12CB3460, 36963306716920776, 231082675, 231082678, 3, 640x360 
0x12CB3460, 36963306717240336, 231082705, 231082711, 6, 640x360 
0x12CB3460, 36963306717560776, 231082737, 231082740, 3, 640x360 
0x12CB3460, 36963306717882336, 231082764, 231082767, 3, 640x360 
0x12CB3460, 36963306718201208, 231082796, 231082799, 3, 640x360 
0x12CB3460, 36963306718520968, 231082825, 231082829, 4, 640x360 
0x12CB3460, 36963306719023128, 231082884, 231082890, 6, 640x360 
0x12CB3460, 36963306719320344, 231082906, 231082909, 3, 640x360 
0x12CB3460, 36963306719639896, 231082945, 231082947, 2, 640x360 
0x12CB3460, 36963306719960384, 231082974, 231082977, 3, 640x360 
0x12CB3460, 36963306720282808, 231083005, 231083008, 3, 640x360 
0x12CB3460, 36963306720600880, 231083035, 231083042, 7, 640x360 
0x12CB3460, 36963306720919552, 231083074, 231083077, 3, 640x360 
0x12CB3460, 36963306721240488, 231083105, 231083108, 3, 640x360 
0x12CB3460, 36963306721561088, 231083135, 231083138, 3, 640x360 
0x12CB3460, 36963306721881784, 231083166, 231083169, 3, 640x360 
0x12CB3460, 36963306722201336, 231083195, 231083202, 7, 640x360 
0x12CB3460, 36963306722520584, 231083235, 231083239, 4, 640x360 
0x12CB3460, 36963306722999904, 231083275, 231083278, 3, 640x360 
0x12CB3460, 36963306723322472, 231083315, 231083318, 3, 640x360 
0x12CB3460, 36963306723641320, 231083345, 231083376, 31, 640x360 
0x12CB3460, 36963306724047160, 231083386, 231083389, 3, 640x360 
0x12CB3460, 36963306724280272, 231083405, 231083412, 7, 640x360 
0x12CB3460, 36963306724601152, 231083435, 231083438, 3, 640x360 
0x12CB3460, 36963306724919672, 231083466, 231083469, 3, 640x360 
0x12CB3460, 36963306725240960, 231083505, 231083508, 3, 640x360 
0x12CB3460, 36963306725562056, 231083535, 231083539, 4, 640x360 
0x12CB3460, 36963306725879888, 231083564, 231083567, 3, 640x360 
0x12CB3460, 36963306726200080, 231083595, 231083598, 3, 640x360 
0x12CB3460, 36963306726680104, 231083644, 231083647, 3, 640x360 
0x12CB3460, 36963306727002696, 231083674, 231083678, 4, 640x360 
0x12CB3460, 36963306727320336, 231083715, 231083719, 4, 640x360 
0x12CB3460, 36963306727639160, 231083744, 231083747, 3, 640x360 
0x12CB3460, 36963306727960440, 231083775, 231083778, 3, 640x360 
0x12CB3460, 36963306728280408, 231083805, 231083808, 3, 640x360 
0x12CB3460, 36963306728599656, 231083836, 231083840, 4, 640x360 
0x12CB3460, 36963306728997984, 231083875, 231083878, 3, 640x360 
0x12CB3460, 36963306729239760, 231083905, 231083908, 3, 640x360 
0x12CB3460, 36963306729559384, 231083934, 231083938, 4, 640x360 
0x12CB3460, 36963306729880448, 231083965, 231083968, 3, 640x360 
0x12CB3460, 36963306730200504, 231083995, 231083997, 2, 640x360 
0x12CB3460, 36963306730679488, 231084044, 231084047, 3, 640x360 
0x12CB3460, 36963306731011032, 231084085, 231084092, 7, 640x360 
0x12CB3460, 36963306731319952, 231084114, 231084116, 2, 640x360 
0x12CB3460, 36963306731639792, 231084144, 231084147, 3, 640x360 
0x12CB3460, 36963306731959552, 231084174, 231084178, 4, 640x360 
0x12CB3460, 36963306732280408, 231084204, 231084207, 3, 640x360 
0x12CB3460, 36963306732599336, 231084236, 231084238, 2, 640x360 
0x12CB3460, 36963306732923392, 231084274, 231084277, 3, 640x360 
0x12CB3460, 36963306733239688, 231084305, 231084308, 3, 640x360 
0x12CB3460, 36963306733562864, 231084335, 231084339, 4, 640x360 
0x12CB3460, 36963306734011664, 231084376, 231084383, 7, 640x360 
0x12CB3460, 36963306734360272, 231084414, 231084417, 3, 640x360 
0x12CB3460, 36963306734681008, 231084445, 231084448, 3, 640x360 
0x12CB3460, 36963306735000192, 231084475, 231084478, 3, 640x360 
0x12CB3460, 36963306735319688, 231084515, 231084519, 4, 640x360 
0x12CB3460, 36963306735641512, 231084544, 231084547, 3, 640x360 
0x12CB3460, 36963306735960760, 231084574, 231084577, 3, 640x360 
0x12CB3460, 36963306736279360, 231084605, 231084608, 3, 640x360 
0x12CB3460, 36963306736599856, 231084635, 231084638, 3, 640x360 
0x12CB3460, 36963306736919632, 231084675, 231084678, 3, 640x360 
0x12CB3460, 36963306737247712, 231084705, 231084710, 5, 640x360 
0x12CB3460, 36963306737559608, 231084734, 231084738, 4, 640x360 
0x12CB3460, 36963306737881040, 231084764, 231084767, 3, 640x360 
0x12CB3460, 36963306738361616, 231084815, 231084818, 3, 640x360 
0x12CB3460, 36963306738681968, 231084845, 231084848, 3, 640x360 
0x12CB3460, 36963306739120192, 231084887, 231084891, 4, 640x360 
0x12CB3460, 36963306739320760, 231084905, 231084909, 4, 640x360 
0x12CB3460, 36963306739640384, 231084944, 231084947, 3, 640x360 
0x12CB3460, 36963306739960016, 231084976, 231084978, 2, 640x360 
0x12CB3460, 36963306740281680, 231085005, 231085008, 3, 640x360 
0x12CB3460, 36963306740601072, 231085036, 231085040, 4, 640x360 
0x12CB3460, 36963306740919920, 231085065, 231085068, 3, 640x360 
0x12CB3460, 36963306741240592, 231085104, 231085107, 3, 640x360 
0x12CB3460, 36963306741561472, 231085135, 231085138, 3, 640x360 
0x12CB3460, 36963306741880848, 231085165, 231085168, 3, 640x360 
0x12CB3460, 36963306742361432, 231085215, 231085218, 3, 640x360 
0x12CB3460, 36963306742679664, 231085244, 231085246, 2, 640x360 
0x12CB3460, 36963306743001032, 231085275, 231085278, 3, 640x360 
0x12CB3460, 36963306743320992, 231085316, 231085319, 3, 640x360 
0x12CB3460, 36963306743640160, 231085373, 231085377, 4, 640x360 
0x12CB3460, 36963306744060144, 231085387, 231085391, 4, 640x360 
0x12CB3460, 36963306744280008, 231085405, 231085408, 3, 640x360 
0x12CB3460, 36963306744600104, 231085434, 231085438, 4, 640x360 
0x12CB3460, 36963306744918888, 231085465, 231085470, 5, 640x360 
0x12CB3460, 36963306745240656, 231085504, 231085507, 3, 640x360 
0x12CB3460, 36963306745559160, 231085534, 231085537, 3, 640x360 
0x12CB3460, 36963306746039944, 231085585, 231085590, 5, 640x360 
0x12CB3460, 36963306746363120, 231085614, 231085617, 3, 640x360 
0x12CB3460, 36963306746679032, 231085645, 231085648, 3, 640x360 
0x12CB3460, 36963306747000016, 231085674, 231085677, 3, 640x360 
0x12CB3460, 36963306747321048, 231085714, 231085717, 3, 640x360 
0x12CB3460, 36963306747640880, 231085745, 231085747, 2, 640x360 
0x12CB3460, 36963306747959544, 231085775, 231085778, 3, 640x360 
0x12CB3460, 36963306748279008, 231085806, 231085808, 2, 640x360 
0x12CB3460, 36963306748600280, 231085837, 231085839, 2, 640x360 
0x12CB3460, 36963306749025560, 231085885, 231085897, 12, 640x360 
0x12CB3460, 36963306749245608, 231085904, 231085907, 3, 640x360 
0x12CB3460, 36963306749560464, 231085935, 231085939, 4, 640x360 
0x12CB3460, 36963306750039080, 231085985, 231085989, 4, 640x360 
0x12CB3460, 36963306750360152, 231086015, 231086018, 3, 640x360 
0x12CB3460, 36963306750680104, 231086044, 231086047, 3, 640x360 
0x12CB3460, 36963306750999496, 231086075, 231086078, 3, 640x360 
0x12CB3460, 36963306751319136, 231086105, 231086109, 4, 640x360 
0x12CB3460, 36963306751640792, 231086144, 231086146, 2, 640x360 
0x12CB3460, 36963306751960712, 231086175, 231086177, 2, 640x360 
0x12CB3460, 36963306752280568, 231086205, 231086209, 4, 640x360 
0x12CB3460, 36963306752599048, 231086235, 231086239, 4, 640x360 
0x12CB3460, 36963306752921456, 231086274, 231086277, 3, 640x360 
0x12CB3460, 36963306753242232, 231086304, 231086307, 3, 640x360 
0x12CB3460, 36963306753562880, 231086335, 231086338, 3, 640x360 
0x12CB3460, 36963306754166312, 231086395, 231086399, 4, 640x360 
0x12CB3460, 36963306754358792, 231086415, 231086418, 3, 640x360 
0x12CB3460, 36963306754680976, 231086445, 231086448, 3, 640x360 
0x12CB3460, 36963306755001872, 231086475, 231086478, 3, 640x360 
0x12CB3460, 36963306755322760, 231086515, 231086518, 3, 640x360 
0x12CB3460, 36963306755647296, 231086545, 231086552, 7, 640x360 
0x12CB3460, 36963306755960376, 231086574, 231086577, 3, 640x360 
0x12CB3460, 36963306756280424, 231086605, 231086612, 7, 640x360 
0x12CB3460, 36963306756600888, 231086635, 231086639, 4, 640x360 
0x12CB3460, 36963306756919832, 231086675, 231086678, 3, 640x360 
0x12CB3460, 36963306757242864, 231086705, 231086708, 3, 640x360 
0x12CB3460, 36963306757720400, 231086745, 231086749, 4, 640x360 
0x12CB3460, 36963306758038776, 231086784, 231086787, 3, 640x360 
0x12CB3460, 36963306758361008, 231086815, 231086817, 2, 640x360 
0x12CB3460, 36963306758680528, 231086845, 231086848, 3, 640x360 
0x12CB3460, 36963306759065904, 231086885, 231086888, 3, 640x360 
0x12CB3460, 36963306759320080, 231086905, 231086908, 3, 640x360 
0x12CB3460, 36963306759639600, 231086945, 231086947, 2, 640x360 
0x12CB3460, 36963306759960688, 231086974, 231086977, 3, 640x360 
0x12CB3460, 36963306760282088, 231087005, 231087008, 3, 640x360 
0x12CB3460, 36963306760602672, 231087035, 231087039, 4, 640x360 
0x12CB3460, 36963306760919800, 231087075, 231087077, 2, 640x360 
0x12CB3460, 36963306761240072, 231087105, 231087108, 3, 640x360 
0x12CB3460, 36963306761720800, 231087155, 231087158, 3, 640x360 
0x12CB3460, 36963306762046928, 231087185, 231087194, 9, 640x360 
0x12CB3460, 36963306762359632, 231087215, 231087218, 3, 640x360 
0x12CB3460, 36963306762679728, 231087245, 231087248, 3, 640x360 
0x12CB3460, 36963306763000432, 231087274, 231087278, 4, 640x360 
0x12CB3460, 36963306763321024, 231087314, 231087317, 3, 640x360 
0x12CB3460, 36963306763641624, 231087373, 231087378, 5, 640x360 
0x12CB3460, 36963306764076048, 231087384, 231087389, 5, 640x360 
0x12CB3460, 36963306764278632, 231087404, 231087407, 3, 640x360 
0x12CB3460, 36963306764598784, 231087435, 231087438, 3, 640x360 
0x12CB3460, 36963306764921024, 231087475, 231087478, 3, 640x360 
0x12CB3460, 36963306765240808, 231087504, 231087508, 4, 640x360 
0x12CB3460, 36963306765721376, 231087556, 231087558, 2, 640x360 
0x12CB3460, 36963306766042840, 231087585, 231087590, 5, 640x360 
0x12CB3460, 36963306766360424, 231087616, 231087619, 3, 640x360 
0x12CB3460, 36963306766681608, 231087646, 231087650, 4, 640x360 
0x12CB3460, 36963306767003256, 231087685, 231087694, 9, 640x360 
0x12CB3460, 36963306767319048, 231087714, 231087717, 3, 640x360 
0x12CB3460, 36963306767638776, 231087744, 231087746, 2, 640x360 
0x12CB3460, 36963306767960440, 231087775, 231087778, 3, 640x360 
0x12CB3460, 36963306768279576, 231087804, 231087807, 3, 640x360 
0x12CB3460, 36963306768598968, 231087836, 231087838, 2, 640x360 
0x12CB3460, 36963306769084680, 231087886, 231087889, 3, 640x360 
0x12CB3460, 36963306769398792, 231087915, 231087918, 3, 640x360 
0x12CB3460, 36963306769719240, 231087946, 231087949, 3, 640x360 
0x12CB3460, 36963306770040368, 231087985, 231087988, 3, 640x360 
0x12CB3460, 36963306770360200, 231088015, 231088017, 2, 640x360 
0x12CB3460, 36963306770680464, 231088045, 231088048, 3, 640x360 
0x12CB3460, 36963306770999568, 231088075, 231088077, 2, 640x360 
0x12CB3460, 36963306771320032, 231088105, 231088108, 3, 640x360 
0x12CB3460, 36963306771639896, 231088145, 231088147, 2, 640x360 
0x12CB3460, 36963306771960776, 231088174, 231088177, 3, 640x360 
0x12CB3460, 36963306772279088, 231088205, 231088207, 2, 640x360 
0x12CB3460, 36963306772600328, 231088234, 231088239, 5, 640x360 
0x12CB3460, 36963306772920456, 231088265, 231088269, 4, 640x360 
0x12CB3460, 36963306773398488, 231088315, 231088318, 3, 640x360 
0x12CB3460, 36963306773718928, 231088376, 231088379, 3, 640x360 
0x12CB3460, 36963306774066560, 231088387, 231088390, 3, 640x360 
0x12CB3460, 36963306774358944, 231088415, 231088417, 2, 640x360 
0x12CB3460, 36963306774679568, 231088445, 231088448, 3, 640x360 
0x12CB3460, 36963306774999824, 231088475, 231088478, 3, 640x360 
0x12CB3460, 36963306775321592, 231088515, 231088518, 3, 640x360 
0x12CB3460, 36963306775642104, 231088545, 231088548, 3, 640x360 
0x12CB3460, 36963306775960272, 231088574, 231088577, 3, 640x360 
0x12CB3460, 36963306776280816, 231088604, 231088607, 3, 640x360 
0x12CB3460, 36963306776599960, 231088636, 231088639, 3, 640x360 
0x12CB3460, 36963306777084624, 231088686, 231088690, 4, 640x360 
0x12CB3460, 36963306777412840, 231088725, 231088732, 7, 640x360 
0x12CB3460, 36963306777718992, 231088754, 231088762, 8, 640x360 
0x12CB3460, 36963306778042056, 231088784, 231088788, 4, 640x360 
0x12CB3460, 36963306778360264, 231088815, 231088818, 3, 640x360 
0x12CB3460, 36963306778682328, 231088845, 231088876, 31, 640x360 
0x12CB3460, 36963306779051976, 231088888, 231088891, 3, 640x360 
0x12CB3460, 36963306779319584, 231088915, 231088918, 3, 640x360 
0x12CB3460, 36963306779640096, 231088944, 231088947, 3, 640x360 
0x12CB3460, 36963306779961424, 231088974, 231088988, 14, 640x360 
0x12CB3460, 36963306780282248, 231089005, 231089008, 3, 640x360 
0x12CB3460, 36963306780602056, 231089035, 231089039, 4, 640x360 
0x12CB3460, 36963306781080216, 231089084, 231089088, 4, 640x360 
0x12CB3460, 36963306781399016, 231089115, 231089118, 3, 640x360 
0x12CB3460, 36963306781719512, 231089155, 231089158, 3, 640x360 
0x12CB3460, 36963306782039952, 231089185, 231089206, 21, 640x360 
0x12CB3460, 36963306782361408, 231089216, 231089219, 3, 640x360 
0x12CB3460, 36963306782679760, 231089244, 231089247, 3, 640x360 
0x12CB3460, 36963306783000976, 231089275, 231089278, 3, 640x360 
0x12CB3460, 36963306783321440, 231089315, 231089319, 4, 640x360 
0x12CB3460, 36963306783644736, 231089346, 231089348, 2, 640x360 
0x12CB3460, 36963306784062520, 231089385, 231089389, 4, 640x360 
0x12CB3460, 36963306784279704, 231089405, 231089407, 2, 640x360 
0x12CB3460, 36963306784600720, 231089436, 231089453, 17, 640x360 
0x12CB3460, 36963306785079568, 231089485, 231089489, 4, 640x360 
0x12CB3460, 36963306785402496, 231089516, 231089519, 3, 640x360 
0x12CB3460, 36963306785723120, 231089554, 231089557, 3, 640x360 
0x12CB3460, 36963306786039384, 231089585, 231089589, 4, 640x360 
0x12CB3460, 36963306786360112, 231089614, 231089631, 17, 640x360 
0x12CB3460, 36963306786679552, 231089645, 231089648, 3, 640x360 
0x12CB3460, 36963306787002752, 231089676, 231089679, 3, 640x360 
0x12CB3460, 36963306787323224, 231089715, 231089718, 3, 640x360 
0x12CB3460, 36963306787639552, 231089744, 231089747, 3, 640x360 
0x12CB3460, 36963306787960472, 231089775, 231089778, 3, 640x360 
0x12CB3460, 36963306788280272, 231089805, 231089807, 2, 640x360 
0x12CB3460, 36963306788980096, 231089875, 231089878, 3, 640x360 
0x12CB3460, 36963306789080200, 231089886, 231089894, 8, 640x360 
0x12CB3460, 36963306789398992, 231089914, 231089918, 4, 640x360 
0x12CB3460, 36963306789720984, 231089945, 231089948, 3, 640x360 
0x12CB3460, 36963306790039992, 231089986, 231089988, 2, 640x360 
0x12CB3460, 36963306790362072, 231090016, 231090019, 3, 640x360 
0x12CB3460, 36963306790682416, 231090045, 231090048, 3, 640x360 
0x12CB3460, 36963306790999008, 231090085, 231090089, 4, 640x360 
0x12CB3460, 36963306791318672, 231090105, 231090109, 4, 640x360 
0x12CB3460, 36963306791961240, 231090174, 231090176, 2, 640x360 
0x12CB3460, 36963306792280376, 231090204, 231090214, 10, 640x360 
0x12CB3460, 36963306792760048, 231090254, 231090257, 3, 640x360 
0x12CB3460, 36963306793078720, 231090284, 231090287, 3, 640x360 
0x12CB3460, 36963306793399920, 231090315, 231090317, 2, 640x360 
0x12CB3460, 36963306793720984, 231090377, 231090380, 3, 640x360 
0x12CB3460, 36963306794051056, 231090384, 231090387, 3, 640x360 
0x12CB3460, 36963306794360240, 231090415, 231090417, 2, 640x360 
0x12CB3460, 36963306794681120, 231090444, 231090447, 3, 640x360 
0x12CB3460, 36963306795000040, 231090475, 231090478, 3, 640x360 
0x12CB3460, 36963306795320600, 231090515, 231090518, 3, 640x360 
0x12CB3460, 36963306795640664, 231090545, 231090548, 3, 640x360 
0x12CB3460, 36963306795959000, 231090574, 231090576, 2, 640x360 
0x12CB3460, 36963306796280232, 231090605, 231090608, 3, 640x360 
0x12CB3460, 36963306796760928, 231090654, 231090657, 3, 640x360 
0x12CB3460, 36963306797078952, 231090685, 231090688, 3, 640x360 
0x12CB3460, 36963306797434304, 231090728, 231090732, 4, 640x360 
0x12CB3460, 36963306797723000, 231090755, 231090758, 3, 640x360 
0x12CB3460, 36963306798039440, 231090785, 231090790, 5, 640x360 
0x12CB3460, 36963306798359704, 231090814, 231090817, 3, 640x360 
0x12CB3460, 36963306798678608, 231090845, 231090848, 3, 640x360 
0x12CB3460, 36963306799343576, 231090914, 231090922, 8, 640x360 
0x12CB3460, 36963306799639928, 231090944, 231090947, 3, 640x360 
0x12CB3460, 36963306799960336, 231090974, 231090977, 3, 640x360 
0x12CB3460, 36963306800440008, 231091025, 231091028, 3, 640x360 
0x12CB3460, 36963306800760232, 231091054, 231091057, 3, 640x360 
0x12CB3460, 36963306801078728, 231091083, 231091086, 3, 640x360 
0x12CB3460, 36963306801399784, 231091115, 231091117, 2, 640x360 
0x12CB3460, 36963306801720480, 231091155, 231091158, 3, 640x360 
0x12CB3460, 36963306802043768, 231091184, 231091189, 5, 640x360 
0x12CB3460, 36963306802359624, 231091215, 231091217, 2, 640x360 
0x12CB3460, 36963306802680064, 231091244, 231091247, 3, 640x360 
0x12CB3460, 36963306802999144, 231091275, 231091283, 8, 640x360 
0x12CB3460, 36963306803318896, 231091305, 231091311, 6, 640x360 
0x12CB3460, 36963306803710512, 231091431, 231091452, 21, 640x360 
0x12CB3460, 36963306804826808, 231091476, 231091481, 5, 640x360 
0x12CB3460, 36963306805082544, 231091486, 231091494, 8, 640x360 
0x12CB3460, 36963306805406920, 231091524, 231091528, 4, 640x360 
0x12CB3460, 36963306806038856, 231091584, 231091588, 4, 640x360 
0x12CB3460, 36963306806358840, 231091613, 231091616, 3, 640x360 
0x12CB3460, 36963306806680192, 231091644, 231091647, 3, 640x360 
0x12CB3460, 36963306806998864, 231091675, 231091678, 3, 640x360 
0x12CB3460, 36963306807320424, 231091715, 231091718, 3, 640x360 
0x12CB3460, 36963306807644080, 231091744, 231091747, 3, 640x360 
0x12CB3460, 36963306808118384, 231091794, 231091798, 4, 640x360 
0x12CB3460, 36963306808441944, 231091824, 231091827, 3, 640x360 
0x12CB3460, 36963306808759072, 231091877, 231091889, 12, 640x360 
0x12CB3460, 36963306809081632, 231091892, 231091897, 5, 640x360 
0x12CB3460, 36963306809399552, 231091915, 231091933, 18, 640x360 
0x12CB3460, 36963306809718960, 231091954, 231091958, 4, 640x360 
0x12CB3460, 36963306810040640, 231091984, 231091987, 3, 640x360 
0x12CB3460, 36963306810361520, 231092015, 231092017, 2, 640x360 
0x12CB3460, 36963306810681840, 231092044, 231092048, 4, 640x360 
0x12CB3460, 36963306810999792, 231092075, 231092078, 3, 640x360 
0x12CB3460, 36963306811318888, 231092115, 231092117, 2, 640x360 
0x12CB3460, 36963306811645400, 231092144, 231092147, 3, 640x360 
0x12CB3460, 36963306812120160, 231092195, 231092202, 7, 640x360 
0x12CB3460, 36963306812464232, 231092224, 231092227, 3, 640x360 
0x12CB3460, 36963306812758544, 231092254, 231092257, 3, 640x360 
0x12CB3460, 36963306813078712, 231092284, 231092286, 2, 640x360 
0x12CB3460, 36963306813400192, 231092315, 231092318, 3, 640x360 
0x12CB3460, 36963306813719800, 231092372, 231092377, 5, 640x360 
0x12CB3460, 36963306814359568, 231092414, 231092417, 3, 640x360 
0x12CB3460, 36963306814678624, 231092445, 231092447, 2, 640x360 
0x12CB3460, 36963306815000088, 231092474, 231092478, 4, 640x360 
0x12CB3460, 36963306815318920, 231092514, 231092517, 3, 640x360 
0x12CB3460, 36963306815641224, 231092544, 231092547, 3, 640x360 
0x12CB3460, 36963306816120128, 231092595, 231092597, 2, 640x360 
0x12CB3460, 36963306816439288, 231092624, 231092626, 2, 640x360 
0x12CB3460, 36963306816760536, 231092655, 231092657, 2, 640x360 
0x12CB3460, 36963306817081416, 231092684, 231092688, 4, 640x360 
0x12CB3460, 36963306817399744, 231092715, 231092719, 4, 640x360 
0x12CB3460, 36963306817718920, 231092755, 231092757, 2, 640x360 
0x12CB3460, 36963306818044728, 231092784, 231092787, 3, 640x360 
0x12CB3460, 36963306818359800, 231092814, 231092817, 3, 640x360 
0x12CB3460, 36963306818679688, 231092844, 231092846, 2, 640x360 
0x12CB3460, 36963306819058016, 231092885, 231092899, 14, 640x360 
0x12CB3460, 36963306819318856, 231092905, 231092908, 3, 640x360 
0x12CB3460, 36963306819800240, 231092955, 231092958, 3, 640x360 
0x12CB3460, 36963306820119864, 231092995, 231092998, 3, 640x360 
0x12CB3460, 36963306820440912, 231093025, 231093028, 3, 640x360 
0x12CB3460, 36963306820760712, 231093055, 231093058, 3, 640x360 
0x12CB3460, 36963306821080656, 231093085, 231093088, 3, 640x360 
0x12CB3460, 36963306821400120, 231093115, 231093117, 2, 640x360 
0x12CB3460, 36963306821718840, 231093155, 231093158, 3, 640x360 
0x12CB3460, 36963306822041728, 231093184, 231093187, 3, 640x360 
0x12CB3460, 36963306822371088, 231093215, 231093218, 3, 640x360 
0x12CB3460, 36963306822678680, 231093244, 231093247, 3, 640x360 
0x12CB3460, 36963306822999376, 231093275, 231093277, 2, 640x360 
0x12CB3460, 36963306823319496, 231093314, 231093317, 3, 640x360 
0x12CB3460, 36963306823975656, 231093374, 231093378, 4, 640x360 
0x12CB3460, 36963306824118552, 231093395, 231093397, 2, 640x360 
0x12CB3460, 36963306824439952, 231093424, 231093426, 2, 640x360 
0x12CB3460, 36963306824759672, 231093454, 231093457, 3, 640x360 
0x12CB3460, 36963306825078856, 231093485, 231093488, 3, 640x360 
0x12CB3460, 36963306825399600, 231093514, 231093517, 3, 640x360 
0x12CB3460, 36963306825719664, 231093545, 231093548, 3, 640x360 
0x12CB3460, 36963306826039568, 231093584, 231093588, 4, 640x360 
0x12CB3460, 36963306826358720, 231093614, 231093616, 2, 640x360 
0x12CB3460, 36963306826680672, 231093644, 231093647, 3, 640x360 
0x12CB3460, 36963306827000112, 231093676, 231093679, 3, 640x360 
0x12CB3460, 36963306827320608, 231093706, 231093709, 3, 640x360 
0x12CB3460, 36963306827800352, 231093755, 231093757, 2, 640x360 
0x12CB3460, 36963306828118624, 231093795, 231093798, 3, 640x360 
0x12CB3460, 36963306828439144, 231093824, 231093827, 3, 640x360 
0x12CB3460, 36963306829020608, 231093882, 231093895, 13, 640x360 
0x12CB3460, 36963306829400456, 231093916, 231093923, 7, 640x360 
0x12CB3460, 36963306829718856, 231093945, 231093949, 4, 640x360 
0x12CB3460, 36963306830039704, 231093984, 231093988, 4, 640x360 
0x12CB3460, 36963306830359264, 231094015, 231094018, 3, 640x360 
0x12CB3460, 36963306831002736, 231094076, 231094080, 4, 640x360 
0x12CB3460, 36963306831480592, 231094124, 231094127, 3, 640x360 
0x12CB3460, 36963306831799928, 231094155, 231094158, 3, 640x360 
0x12CB3460, 36963306832118600, 231094195, 231094197, 2, 640x360 
0x12CB3460, 36963306832439536, 231094224, 231094228, 4, 640x360 
0x12CB3460, 36963306832760920, 231094254, 231094257, 3, 640x360 
0x12CB3460, 36963306833079824, 231094284, 231094287, 3, 640x360 
0x12CB3460, 36963306833400336, 231094315, 231094318, 3, 640x360 
0x12CB3460, 36963306833720232, 231094379, 231094387, 8, 640x360 
0x12CB3460, 36963306834362032, 231094414, 231094420, 6, 640x360 
0x12CB3460, 36963306834678808, 231094445, 231094449, 4, 640x360 
0x12CB3460, 36963306834998856, 231094475, 231094480, 5, 640x360 
0x12CB3460, 36963306835478064, 231094526, 231094529, 3, 640x360 
0x12CB3460, 36963306835798296, 231094555, 231094562, 7, 640x360 
0x12CB3460, 36963306836120072, 231094594, 231094597, 3, 640x360 
0x12CB3460, 36963306836439992, 231094625, 231094627, 2, 640x360 
0x12CB3460, 36963306836760728, 231094654, 231094657, 3, 640x360 
0x12CB3460, 36963306837079896, 231094685, 231094688, 3, 640x360 
0x12CB3460, 36963306837401440, 231094716, 231094720, 4, 640x360 
0x12CB3460, 36963306837719952, 231094755, 231094758, 3, 640x360 
0x12CB3460, 36963306838040080, 231094784, 231094788, 4, 640x360 
0x12CB3460, 36963306838361520, 231094814, 231094817, 3, 640x360 
0x12CB3460, 36963306838682328, 231094845, 231094880, 35, 640x360 
0x12CB3460, 36963306839087560, 231094886, 231094890, 4, 640x360 
0x12CB3460, 36963306839479784, 231094924, 231094927, 3, 640x360 
0x12CB3460, 36963306839799944, 231094955, 231094958, 3, 640x360 
0x12CB3460, 36963306840119736, 231094994, 231094997, 3, 640x360 
0x12CB3460, 36963306840439632, 231095024, 231095027, 3, 640x360 
0x12CB3460, 36963306840758696, 231095055, 231095057, 2, 640x360 
0x12CB3460, 36963306841080160, 231095084, 231095087, 3, 640x360 
0x12CB3460, 36963306841398968, 231095115, 231095118, 3, 640x360 
0x12CB3460, 36963306841719688, 231095146, 231095149, 3, 640x360 
0x12CB3460, 36963306842040704, 231095184, 231095187, 3, 640x360 
0x12CB3460, 36963306842362016, 231095215, 231095233, 18, 640x360 
0x12CB3460, 36963306842680120, 231095244, 231095246, 2, 640x360 
0x12CB3460, 36963306843160872, 231095295, 231095298, 3, 640x360 
0x12CB3460, 36963306843479320, 231095325, 231095330, 5, 640x360 
0x12CB3460, 36963306843804384, 231095386, 231095390, 4, 640x360 
0x12CB3460, 36963306844119552, 231095395, 231095400, 5, 640x360 
0x12CB3460, 36963306844438888, 231095424, 231095427, 3, 640x360 
0x12CB3460, 36963306844759136, 231095454, 231095457, 3, 640x360 
0x12CB3460, 36963306845079816, 231095485, 231095489, 4, 640x360 
0x12CB3460, 36963306845401048, 231095515, 231095518, 3, 640x360 
0x12CB3460, 36963306845720632, 231095555, 231095562, 7, 640x360 
0x12CB3460, 36963306846039432, 231095584, 231095587, 3, 640x360 
0x12CB3460, 36963306846359672, 231095615, 231095618, 3, 640x360 
0x12CB3460, 36963306846682568, 231095645, 231095648, 3, 640x360 
0x12CB3460, 36963306847160560, 231095694, 231095698, 4, 640x360 
0x12CB3460, 36963306847479256, 231095724, 231095727, 3, 640x360 
0x12CB3460, 36963306847799896, 231095755, 231095758, 3, 640x360 
0x12CB3460, 36963306848120392, 231095794, 231095797, 3, 640x360 
0x12CB3460, 36963306848439896, 231095824, 231095827, 3, 640x360 
0x12CB3460, 36963306848981704, 231095875, 231095878, 3, 640x360 
0x12CB3460, 36963306849078936, 231095887, 231095891, 4, 640x360 
0x12CB3460, 36963306849398776, 231095915, 231095918, 3, 640x360 
0x12CB3460, 36963306849718640, 231095955, 231095958, 3, 640x360 
0x12CB3460, 36963306850039264, 231095984, 231095987, 3, 640x360 
0x12CB3460, 36963306850360312, 231096014, 231096018, 4, 640x360 
0x12CB3460, 36963306850838600, 231096064, 231096067, 3, 640x360 
0x12CB3460, 36963306851158040, 231096095, 231096107, 12, 640x360 
0x12CB3460, 36963306851479928, 231096124, 231096126, 2, 640x360 
0x12CB3460, 36963306851800152, 231096155, 231096158, 3, 640x360 
0x12CB3460, 36963306852119608, 231096185, 231096189, 4, 640x360 
0x12CB3460, 36963306852438976, 231096224, 231096226, 2, 640x360 
0x12CB3460, 36963306852758432, 231096255, 231096257, 2, 640x360 
0x12CB3460, 36963306853079336, 231096284, 231096288, 4, 640x360 
0x12CB3460, 36963306853398424, 231096315, 231096318, 3, 640x360 
0x12CB3460, 36963306853719968, 231096375, 231096382, 7, 640x360 
0x12CB3460, 36963306854040608, 231096384, 231096392, 8, 640x360 
0x12CB3460, 36963306854360352, 231096414, 231096417, 3, 640x360 
0x12CB3460, 36963306854840904, 231096465, 231096468, 3, 640x360 
0x12CB3460, 36963306855161688, 231096495, 231096498, 3, 640x360 
0x12CB3460, 36963306855480200, 231096525, 231096528, 3, 640x360 
0x12CB3460, 36963306855798848, 231096554, 231096557, 3, 640x360 
0x12CB3460, 36963306856119320, 231096595, 231096598, 3, 640x360 
0x12CB3460, 36963306856440776, 231096624, 231096628, 4, 640x360 
0x12CB3460, 36963306856764072, 231096655, 231096659, 4, 640x360 
0x12CB3460, 36963306857083328, 231096687, 231096690, 3, 640x360 
0x12CB3460, 36963306857400984, 231096725, 231096728, 3, 640x360 
0x12CB3460, 36963306857720200, 231096754, 231096757, 3, 640x360 
0x12CB3460, 36963306858039504, 231096785, 231096789, 4, 640x360 
0x12CB3460, 36963306858360456, 231096814, 231096817, 3, 640x360 
0x12CB3460, 36963306859132480, 231096895, 231096899, 4, 640x360 
0x12CB3460, 36963306859479592, 231096924, 231096927, 3, 640x360 
0x12CB3460, 36963306860119576, 231096995, 231096997, 2, 640x360 
0x12CB3460, 36963306860440728, 231097024, 231097028, 4, 640x360 
0x12CB3460, 36963306860759672, 231097055, 231097058, 3, 640x360 
0x12CB3460, 36963306861080360, 231097084, 231097089, 5, 640x360 
0x12CB3460, 36963306861399640, 231097115, 231097118, 3, 640x360 
0x12CB3460, 36963306861719200, 231097155, 231097162, 7, 640x360 
0x12CB3460, 36963306862040448, 231097184, 231097189, 5, 640x360 
0x12CB3460, 36963306862517896, 231097234, 231097238, 4, 640x360 
0x12CB3460, 36963306862839400, 231097264, 231097267, 3, 640x360 
0x12CB3460, 36963306863158176, 231097295, 231097297, 2, 640x360 
0x12CB3460, 36963306863480464, 231097325, 231097337, 12, 640x360 
0x12CB3460, 36963306863799880, 231097386, 231097390, 4, 640x360 
0x12CB3460, 36963306864439768, 231097425, 231097428, 3, 640x360 
0x12CB3460, 36963306864760400, 231097454, 231097457, 3, 640x360 
0x12CB3460, 36963306865080600, 231097486, 231097489, 3, 640x360 
0x12CB3460, 36963306865400192, 231097515, 231097519, 4, 640x360 
0x12CB3460, 36963306865719880, 231097555, 231097558, 3, 640x360 
0x12CB3460, 36963306866040272, 231097584, 231097586, 2, 640x360 
0x12CB3460, 36963306866518720, 231097625, 231097628, 3, 640x360 
0x12CB3460, 36963306866839432, 231097664, 231097667, 3, 640x360 
0x12CB3460, 36963306867160136, 231097695, 231097698, 3, 640x360 
0x12CB3460, 36963306867481920, 231097725, 231097738, 13, 640x360 
0x12CB3460, 36963306867799912, 231097754, 231097757, 3, 640x360 
0x12CB3460, 36963306868119064, 231097795, 231097798, 3, 640x360 
0x12CB3460, 36963306868440632, 231097825, 231097828, 3, 640x360 
0x12CB3460, 36963306868978480, 231097876, 231097880, 4, 640x360 
0x12CB3460, 36963306869082440, 231097885, 231097888, 3, 640x360 
0x12CB3460, 36963306869400072, 231097914, 231097918, 4, 640x360 
0x12CB3460, 36963306869719864, 231097954, 231097957, 3, 640x360 
0x12CB3460, 36963306870040328, 231097984, 231097988, 4, 640x360 
0x12CB3460, 36963306870519984, 231098035, 231098039, 4, 640x360 
0x12CB3460, 36963306870838896, 231098064, 231098066, 2, 640x360 
0x12CB3460, 36963306871159232, 231098095, 231098097, 2, 640x360 
0x12CB3460, 36963306871480168, 231098124, 231098127, 3, 640x360 
0x12CB3460, 36963306871800192, 231098155, 231098158, 3, 640x360 
0x12CB3460, 36963306872120672, 231098195, 231098198, 3, 640x360 
0x12CB3460, 36963306872441352, 231098224, 231098230, 6, 640x360 
0x12CB3460, 36963306872758352, 231098255, 231098257, 2, 640x360 
0x12CB3460, 36963306873078936, 231098284, 231098288, 4, 640x360 
0x12CB3460, 36963306873399616, 231098314, 231098318, 4, 640x360 
0x12CB3460, 36963306873721824, 231098383, 231098390, 7, 640x360 
0x12CB3460, 36963306874198408, 231098396, 231098399, 3, 640x360 
0x12CB3460, 36963306874519944, 231098425, 231098429, 4, 640x360 
0x12CB3460, 36963306874838896, 231098464, 231098467, 3, 640x360 
0x12CB3460, 36963306875161296, 231098495, 231098498, 3, 640x360 
0x12CB3460, 36963306875480592, 231098525, 231098527, 2, 640x360 
0x12CB3460, 36963306875800584, 231098566, 231098569, 3, 640x360 
0x12CB3460, 36963306876120680, 231098586, 231098593, 7, 640x360 
0x12CB3460, 36963306876438432, 231098625, 231098627, 2, 640x360 
0x12CB3460, 36963306876759528, 231098654, 231098657, 3, 640x360 
0x12CB3460, 36963306877080248, 231098685, 231098689, 4, 640x360 
0x12CB3460, 36963306877400848, 231098725, 231098730, 5, 640x360 
0x12CB3460, 36963306877718824, 231098745, 231098747, 2, 640x360 
0x12CB3460, 36963306878199088, 231098794, 231098798, 4, 640x360 
0x12CB3460, 36963306878518576, 231098834, 231098839, 5, 640x360 
0x12CB3460, 36963306879001592, 231098886, 231098896, 10, 640x360 
0x12CB3460, 36963306879163200, 231098896, 231098899, 3, 640x360 
0x12CB3460, 36963306879480096, 231098924, 231098927, 3, 640x360 
0x12CB3460, 36963306879800248, 231098956, 231098958, 2, 640x360 
0x12CB3460, 36963306880120160, 231098986, 231098990, 4, 640x360 
0x12CB3460, 36963306880438496, 231099025, 231099028, 3, 640x360 
0x12CB3460, 36963306880762240, 231099055, 231099059, 4, 640x360 
0x12CB3460, 36963306881080256, 231099084, 231099087, 3, 640x360 
0x12CB3460, 36963306881400168, 231099115, 231099118, 3, 640x360 
0x12CB3460, 36963306881878056, 231099164, 231099167, 3, 640x360 
0x12CB3460, 36963306882198336, 231099194, 231099197, 3, 640x360 
0x12CB3460, 36963306882518888, 231099235, 231099238, 3, 640x360 
0x12CB3460, 36963306882839064, 231099264, 231099267, 3, 640x360 
0x12CB3460, 36963306883162128, 231099294, 231099297, 3, 640x360 
0x12CB3460, 36963306883480240, 231099325, 231099328, 3, 640x360 
0x12CB3460, 36963306883997896, 231099375, 231099378, 3, 640x360 
0x12CB3460, 36963306884118520, 231099386, 231099391, 5, 640x360 
0x12CB3460, 36963306884438720, 231099425, 231099428, 3, 640x360 
0x12CB3460, 36963306884759168, 231099454, 231099457, 3, 640x360 
0x12CB3460, 36963306885078672, 231099485, 231099489, 4, 640x360 
0x12CB3460, 36963306885398936, 231099514, 231099517, 3, 640x360 
0x12CB3460, 36963306885878432, 231099564, 231099568, 4, 640x360 
0x12CB3460, 36963306886200040, 231099594, 231099597, 3, 640x360 
0x12CB3460, 36963306886520160, 231099634, 231099637, 3, 640x360 
0x12CB3460, 36963306886838720, 231099664, 231099667, 3, 640x360 
0x12CB3460, 36963306887162224, 231099695, 231099698, 3, 640x360 
0x12CB3460, 36963306887482688, 231099725, 231099728, 3, 640x360 
0x12CB3460, 36963306887798480, 231099755, 231099757, 2, 640x360 
0x12CB3460, 36963306888118704, 231099795, 231099797, 2, 640x360 
0x12CB3460, 36963306888440232, 231099824, 231099827, 3, 640x360 
0x12CB3460, 36963306888982168, 231099875, 231099879, 4, 640x360 
0x12CB3460, 36963306889079544, 231099886, 231099890, 4, 640x360 
0x12CB3460, 36963306889400328, 231099915, 231099919, 4, 640x360 
0x12CB3460, 36963306889878160, 231099965, 231099967, 2, 640x360 
0x12CB3460, 36963306890199392, 231099995, 231099998, 3, 640x360 
0x12CB3460, 36963306890518344, 231100025, 231100033, 8, 640x360 
0x12CB3460, 36963306890837944, 231100064, 231100067, 3, 640x360 
0x12CB3460, 36963306891161096, 231100094, 231100096, 2, 640x360 
0x12CB3460, 36963306891479640, 231100124, 231100127, 3, 640x360 
0x12CB3460, 36963306891800448, 231100154, 231100158, 4, 640x360 
0x12CB3460, 36963306892118192, 231100186, 231100189, 3, 640x360 
0x12CB3460, 36963306892438336, 231100224, 231100227, 3, 640x360 
0x12CB3460, 36963306892759128, 231100255, 231100257, 2, 640x360 
0x12CB3460, 36963306893079528, 231100284, 231100288, 4, 640x360 
0x12CB3460, 36963306893557832, 231100334, 231100337, 3, 640x360 
0x12CB3460, 36963306893980168, 231100375, 231100378, 3, 640x360 
0x12CB3460, 36963306894199104, 231100395, 231100398, 3, 640x360 
0x12CB3460, 36963306894519712, 231100425, 231100429, 4, 640x360 
0x12CB3460, 36963306894838784, 231100464, 231100467, 3, 640x360 
0x12CB3460, 36963306895158664, 231100495, 231100498, 3, 640x360 
0x12CB3460, 36963306895479936, 231100524, 231100538, 14, 640x360 
0x12CB3460, 36963306895800208, 231100554, 231100557, 3, 640x360 
0x12CB3460, 36963306896119248, 231100595, 231100599, 4, 640x360 
0x12CB3460, 36963306896438872, 231100624, 231100627, 3, 640x360 
0x12CB3460, 36963306896760456, 231100654, 231100658, 4, 640x360 
0x12CB3460, 36963306897081616, 231100685, 231100689, 4, 640x360 
0x12CB3460, 36963306897559736, 231100734, 231100737, 3, 640x360 
0x12CB3460, 36963306897879928, 231100765, 231100768, 3, 640x360 
0x12CB3460, 36963306898199632, 231100796, 231100799, 3, 640x360 
0x12CB3460, 36963306898519096, 231100825, 231100829, 4, 640x360 
0x12CB3460, 36963306898953488, 231100875, 231100879, 4, 640x360 
0x12CB3460, 36963306899159016, 231100894, 231100897, 3, 640x360 
0x12CB3460, 36963306899479384, 231100925, 231100927, 2, 640x360 
0x12CB3460, 36963306899799448, 231100954, 231100957, 3, 640x360 
0x12CB3460, 36963306900119224, 231100985, 231100989, 4, 640x360 
0x12CB3460, 36963306900438480, 231101024, 231101027, 3, 640x360 
0x12CB3460, 36963306900759168, 231101055, 231101058, 3, 640x360 
0x12CB3460, 36963306901079704, 231101084, 231101088, 4, 640x360 
0x12CB3460, 36963306901559824, 231101135, 231101139, 4, 640x360 
0x12CB3460, 36963306901878632, 231101165, 231101168, 3, 640x360 
0x12CB3460, 36963306902200832, 231101195, 231101199, 4, 640x360 
0x12CB3460, 36963306902519376, 231101226, 231101230, 4, 640x360 
0x12CB3460, 36963306902839888, 231101264, 231101267, 3, 640x360 
0x12CB3460, 36963306903159912, 231101294, 231101297, 3, 640x360 
0x12CB3460, 36963306903479464, 231101325, 231101328, 3, 640x360 
0x12CB3460, 36963306903798664, 231101386, 231101390, 4, 640x360 
0x12CB3460, 36963306904438984, 231101424, 231101427, 3, 640x360 
0x12CB3460, 36963306904759032, 231101454, 231101456, 2, 640x360 
0x12CB3460, 36963306905239296, 231101505, 231101513, 8, 640x360 
0x12CB3460, 36963306905559216, 231101535, 231101541, 6, 640x360 
0x12CB3460, 36963306905878832, 231101565, 231101568, 3, 640x360 
0x12CB3460, 36963306906201512, 231101596, 231101598, 2, 640x360 
0x12CB3460, 36963306906519360, 231101635, 231101639, 4, 640x360 
0x12CB3460, 36963306906841096, 231101664, 231101667, 3, 640x360 
0x12CB3460, 36963306907165592, 231101697, 231101701, 4, 640x360 
0x12CB3460, 36963306907481568, 231101725, 231101728, 3, 640x360 
0x12CB3460, 36963306907798680, 231101755, 231101758, 3, 640x360 
0x12CB3460, 36963306908119696, 231101795, 231101797, 2, 640x360 
0x12CB3460, 36963306908440672, 231101825, 231101828, 3, 640x360 
0x12CB3460, 36963306908989728, 231101875, 231101883, 8, 640x360 
0x12CB3460, 36963306909239496, 231101904, 231101907, 3, 640x360 
0x12CB3460, 36963306909560664, 231101934, 231101938, 4, 640x360 
0x12CB3460, 36963306909881672, 231101965, 231101969, 4, 640x360 
0x12CB3460, 36963306910231264, 231102005, 231102008, 3, 640x360 
0x12CB3460, 36963306910518176, 231102034, 231102042, 8, 640x360 
0x12CB3460, 36963306910838856, 231102064, 231102068, 4, 640x360 
0x12CB3460, 36963306911158360, 231102094, 231102096, 2, 640x360 
0x12CB3460, 36963306911479528, 231102125, 231102128, 3, 640x360 
0x12CB3460, 36963306911800600, 231102155, 231102158, 3, 640x360 
0x12CB3460, 36963306912121280, 231102195, 231102198, 3, 640x360 
0x12CB3460, 36963306912442256, 231102225, 231102230, 5, 640x360 
0x12CB3460, 36963306912759424, 231102254, 231102257, 3, 640x360 
0x12CB3460, 36963306913240880, 231102305, 231102308, 3, 640x360 
0x12CB3460, 36963306913560760, 231102335, 231102338, 3, 640x360 
0x12CB3460, 36963306914016288, 231102385, 231102388, 3, 640x360 
0x12CB3460, 36963306914201048, 231102395, 231102398, 3, 640x360 
0x12CB3460, 36963306914519760, 231102435, 231102438, 3, 640x360 
0x12CB3460, 36963306914839192, 231102465, 231102467, 2, 640x360 
0x12CB3460, 36963306915159768, 231102494, 231102497, 3, 640x360 
0x12CB3460, 36963306915481632, 231102525, 231102528, 3, 640x360 
0x12CB3460, 36963306915800328, 231102555, 231102559, 4, 640x360 
0x12CB3460, 36963306916118528, 231102595, 231102598, 3, 640x360 
0x12CB3460, 36963306916442176, 231102624, 231102627, 3, 640x360 
0x12CB3460, 36963306916919616, 231102676, 231102679, 3, 640x360 
0x12CB3460, 36963306917251056, 231102704, 231102709, 5, 640x360 
0x12CB3460, 36963306917558984, 231102734, 231102738, 4, 640x360 
0x12CB3460, 36963306917880072, 231102766, 231102768, 2, 640x360 
0x12CB3460, 36963306918200312, 231102796, 231102798, 2, 640x360 
0x12CB3460, 36963306918519640, 231102836, 231102839, 3, 640x360 
0x12CB3460, 36963306919038176, 231102885, 231102895, 10, 640x360 
0x12CB3460, 36963306919172520, 231102896, 231102898, 2, 640x360 
0x12CB3460, 36963306919479336, 231102924, 231102927, 3, 640x360 
0x12CB3460, 36963306919799592, 231102955, 231102957, 2, 640x360 
0x12CB3460, 36963306920120504, 231102995, 231102999, 4, 640x360 
0x12CB3460, 36963306920442272, 231103024, 231103036, 12, 640x360 
0x12CB3460, 36963306920920672, 231103075, 231103078, 3, 640x360 
0x12CB3460, 36963306921238440, 231103104, 231103107, 3, 640x360 
0x12CB3460, 36963306921558952, 231103135, 231103138, 3, 640x360 
0x12CB3460, 36963306921880048, 231103165, 231103167, 2, 640x360 
0x12CB3460, 36963306922200640, 231103195, 231103198, 3, 640x360 
0x12CB3460, 36963306922521000, 231103234, 231103239, 5, 640x360 
0x12CB3460, 36963306922839240, 231103265, 231103268, 3, 640x360 
0x12CB3460, 36963306923159848, 231103294, 231103297, 3, 640x360 
0x12CB3460, 36963306923479336, 231103326, 231103329, 3, 640x360 
0x12CB3460, 36963306924060840, 231103384, 231103389, 5, 640x360 
0x12CB3460, 36963306924118272, 231103395, 231103398, 3, 640x360 
0x12CB3460, 36963306924599648, 231103436, 231103439, 3, 640x360 
0x12CB3460, 36963306924919824, 231103475, 231103478, 3, 640x360 
0x12CB3460, 36963306925241528, 231103504, 231103507, 3, 640x360 
0x12CB3460, 36963306925560824, 231103536, 231103539, 3, 640x360 
0x12CB3460, 36963306925880544, 231103565, 231103569, 4, 640x360 
0x12CB3460, 36963306926198656, 231103596, 231103613, 17, 640x360 
0x12CB3460, 36963306926518888, 231103635, 231103639, 4, 640x360 
0x12CB3460, 36963306926839504, 231103665, 231103668, 3, 640x360 
0x12CB3460, 36963306927163240, 231103694, 231103697, 3, 640x360 
0x12CB3460, 36963306927480016, 231103724, 231103733, 9, 640x360 
0x12CB3460, 36963306927798480, 231103754, 231103757, 3, 640x360 
0x12CB3460, 36963306928119536, 231103795, 231103797, 2, 640x360 
0x12CB3460, 36963306928602176, 231103837, 231103840, 3, 640x360 
0x12CB3460, 36963306929036512, 231103887, 231103892, 5, 640x360 
0x12CB3460, 36963306929239064, 231103905, 231103907, 2, 640x360 
0x12CB3460, 36963306929559080, 231103934, 231103937, 3, 640x360 
0x12CB3460, 36963306929878080, 231103964, 231103967, 3, 640x360 
0x12CB3460, 36963306930199752, 231103994, 231103998, 4, 640x360 
0x12CB3460, 36963306930518904, 231104025, 231104028, 3, 640x360 
0x12CB3460, 36963306930840304, 231104065, 231104068, 3, 640x360 
0x12CB3460, 36963306931160232, 231104094, 231104097, 3, 640x360 
0x12CB3460, 36963306931479000, 231104124, 231104127, 3, 640x360 
0x12CB3460, 36963306931798248, 231104154, 231104157, 3, 640x360 
0x12CB3460, 36963306932118080, 231104185, 231104189, 4, 640x360 
0x12CB3460, 36963306932598840, 231104235, 231104239, 4, 640x360 
0x12CB3460, 36963306932918616, 231104274, 231104276, 2, 640x360 
0x12CB3460, 36963306933238504, 231104304, 231104307, 3, 640x360 
0x12CB3460, 36963306933561424, 231104334, 231104337, 3, 640x360 
0x12CB3460, 36963306934046576, 231104386, 231104396, 10, 640x360 
0x12CB3460, 36963306934201392, 231104396, 231104399, 3, 640x360 
0x12CB3460, 36963306934519296, 231104425, 231104429, 4, 640x360 
0x12CB3460, 36963306934838704, 231104465, 231104468, 3, 640x360 
0x12CB3460, 36963306935159712, 231104495, 231104497, 2, 640x360 
0x12CB3460, 36963306935479080, 231104525, 231104528, 3, 640x360 
0x12CB3460, 36963306935798320, 231104555, 231104558, 3, 640x360 
0x12CB3460, 36963306936279656, 231104604, 231104607, 3, 640x360 
0x12CB3460, 36963306936600264, 231104635, 231104638, 3, 640x360 
0x12CB3460, 36963306936920856, 231104675, 231104678, 3, 640x360 
0x12CB3460, 36963306937240616, 231104706, 231104712, 6, 640x360 
0x12CB3460, 36963306937559352, 231104735, 231104738, 3, 640x360 
0x12CB3460, 36963306937878296, 231104765, 231104767, 2, 640x360 
0x12CB3460, 36963306938199952, 231104795, 231104798, 3, 640x360 
0x12CB3460, 36963306938518968, 231104826, 231104830, 4, 640x360 
0x12CB3460, 36963306938839480, 231104888, 231104897, 9, 640x360 
0x12CB3460, 36963306939163648, 231104904, 231104907, 3, 640x360 
0x12CB3460, 36963306939478504, 231104924, 231104927, 3, 640x360 
0x12CB3460, 36963306939798864, 231104955, 231104957, 2, 640x360 
0x12CB3460, 36963306940278816, 231105005, 231105008, 3, 640x360 
0x12CB3460, 36963306940599616, 231105035, 231105039, 4, 640x360 
0x12CB3460, 36963306940918752, 231105074, 231105076, 2, 640x360 
0x12CB3460, 36963306941240224, 231105104, 231105107, 3, 640x360 
0x12CB3460, 36963306941560320, 231105134, 231105137, 3, 640x360 
0x12CB3460, 36963306941881320, 231105166, 231105168, 2, 640x360 
0x12CB3460, 36963306942203544, 231105204, 231105207, 3, 640x360 
0x12CB3460, 36963306942519528, 231105234, 231105237, 3, 640x360 
0x12CB3460, 36963306942839752, 231105264, 231105282, 18, 640x360 
0x12CB3460, 36963306943160048, 231105295, 231105297, 2, 640x360 
0x12CB3460, 36963306943479936, 231105325, 231105328, 3, 640x360 
0x12CB3460, 36963306943994536, 231105376, 231105378, 2, 640x360 
0x12CB3460, 36963306944278776, 231105404, 231105413, 9, 640x360 
0x12CB3460, 36963306944600040, 231105436, 231105438, 2, 640x360 
0x12CB3460, 36963306944920800, 231105475, 231105478, 3, 640x360 
0x12CB3460, 36963306945239800, 231105504, 231105507, 3, 640x360 
0x12CB3460, 36963306945559736, 231105534, 231105537, 3, 640x360 
0x12CB3460, 36963306945880040, 231105565, 231105568, 3, 640x360 
0x12CB3460, 36963306946199368, 231105595, 231105597, 2, 640x360 
0x12CB3460, 36963306946519448, 231105634, 231105637, 3, 640x360 
0x12CB3460, 36963306946841224, 231105665, 231105668, 3, 640x360 
0x12CB3460, 36963306947160648, 231105694, 231105697, 3, 640x360 
0x12CB3460, 36963306947481184, 231105725, 231105731, 6, 640x360 
0x12CB3460, 36963306947959592, 231105775, 231105781, 6, 640x360 
0x12CB3460, 36963306948279952, 231105805, 231105807, 2, 640x360 
0x12CB3460, 36963306948600496, 231105835, 231105839, 4, 640x360 
0x12CB3460, 36963306948989240, 231105875, 231105878, 3, 640x360 
0x12CB3460, 36963306949239240, 231105905, 231105912, 7, 640x360 
0x12CB3460, 36963306949557984, 231105935, 231105937, 2, 640x360 
0x12CB3460, 36963306949878576, 231105964, 231105967, 3, 640x360 
0x12CB3460, 36963306950198400, 231105995, 231105999, 4, 640x360 
0x12CB3460, 36963306950518728, 231106025, 231106029, 4, 640x360 
0x12CB3460, 36963306950839216, 231106065, 231106068, 3, 640x360 
0x12CB3460, 36963306951159008, 231106094, 231106097, 3, 640x360 
0x12CB3460, 36963306951478208, 231106124, 231106127, 3, 640x360 
0x12CB3460, 36963306951959440, 231106174, 231106176, 2, 640x360 
0x12CB3460, 36963306952279280, 231106205, 231106209, 4, 640x360 
0x12CB3460, 36963306952597464, 231106235, 231106238, 3, 640x360 
0x12CB3460, 36963306952919792, 231106265, 231106268, 3, 640x360 
0x12CB3460, 36963306953240240, 231106304, 231106307, 3, 640x360 
0x12CB3460, 36963306953560352, 231106334, 231106337, 3, 640x360 
0x12CB3460, 36963306954022912, 231106386, 231106393, 7, 640x360 
0x12CB3460, 36963306954200040, 231106394, 231106398, 4, 640x360 
0x12CB3460, 36963306954519064, 231106425, 231106429, 4, 640x360 
0x12CB3460, 36963306954839968, 231106465, 231106468, 3, 640x360 
0x12CB3460, 36963306955159248, 231106495, 231106498, 3, 640x360 
0x12CB3460, 36963306955480504, 231106525, 231106528, 3, 640x360 
0x12CB3460, 36963306955961128, 231106576, 231106580, 4, 640x360 
0x12CB3460, 36963306956278168, 231106605, 231106607, 2, 640x360 
0x12CB3460, 36963306956601352, 231106636, 231106639, 3, 640x360 
0x12CB3460, 36963306956923080, 231106674, 231106677, 3, 640x360 
0x12CB3460, 36963306957238136, 231106705, 231106708, 3, 640x360 
0x12CB3460, 36963306957560224, 231106734, 231106737, 3, 640x360 
0x12CB3460, 36963306957879392, 231106765, 231106768, 3, 640x360 
0x12CB3460, 36963306958200240, 231106795, 231106798, 3, 640x360 
0x12CB3460, 36963306958519688, 231106834, 231106837, 3, 640x360 
0x12CB3460, 36963306958980720, 231106875, 231106878, 3, 640x360 
0x12CB3460, 36963306959164800, 231106895, 231106897, 2, 640x360 
0x12CB3460, 36963306959637272, 231106944, 231106947, 3, 640x360 
0x12CB3460, 36963306959958800, 231106975, 231106978, 3, 640x360 
0x12CB3460, 36963306960279472, 231107004, 231107007, 3, 640x360 
0x12CB3460, 36963306960599976, 231107035, 231107038, 3, 640x360 
0x12CB3460, 36963306960921152, 231107067, 231107070, 3, 640x360 
0x12CB3460, 36963306961238504, 231107104, 231107107, 3, 640x360 
0x12CB3460, 36963306961559568, 231107135, 231107137, 2, 640x360 
0x12CB3460, 36963306961878456, 231107165, 231107168, 3, 640x360 
0x12CB3460, 36963306962198944, 231107194, 231107197, 3, 640x360 
0x12CB3460, 36963306962521608, 231107225, 231107228, 3, 640x360 
0x12CB3460, 36963306962839392, 231107264, 231107267, 3, 640x360 
0x12CB3460, 36963306963160208, 231107294, 231107297, 3, 640x360 
0x12CB3460, 36963306963641800, 231107344, 231107347, 3, 640x360 
0x12CB3460, 36963306964085504, 231107384, 231107387, 3, 640x360 
0x12CB3460, 36963306964277584, 231107404, 231107406, 2, 640x360 
0x12CB3460, 36963306964599136, 231107435, 231107439, 4, 640x360 
0x12CB3460, 36963306964920104, 231107466, 231107469, 3, 640x360 
0x12CB3460, 36963306965238856, 231107506, 231107508, 2, 640x360 
0x12CB3460, 36963306965566032, 231107534, 231107537, 3, 640x360 
0x12CB3460, 36963306965879408, 231107564, 231107567, 3, 640x360 
0x12CB3460, 36963306966198344, 231107595, 231107597, 2, 640x360 
0x12CB3460, 36963306966519400, 231107635, 231107637, 2, 640x360 
0x12CB3460, 36963306966840288, 231107665, 231107667, 2, 640x360 
0x12CB3460, 36963306967321152, 231107715, 231107723, 8, 640x360 
0x12CB3460, 36963306967638640, 231107745, 231107763, 18, 640x360 
0x12CB3460, 36963306967959648, 231107776, 231107778, 2, 640x360 
0x12CB3460, 36963306968278560, 231107805, 231107807, 2, 640x360 
0x12CB3460, 36963306968598584, 231107834, 231107837, 3, 640x360 
0x12CB3460, 36963306968975896, 231107875, 231107877, 2, 640x360 
0x12CB3460, 36963306969238088, 231107904, 231107906, 2, 640x360 
0x12CB3460, 36963306969558664, 231107934, 231107937, 3, 640x360 
0x12CB3460, 36963306969878816, 231107965, 231107967, 2, 640x360 
0x12CB3460, 36963306970199024, 231107994, 231107997, 3, 640x360 
0x12CB3460, 36963306970519456, 231108025, 231108028, 3, 640x360 
0x12CB3460, 36963306970843976, 231108065, 231108067, 2, 640x360 
0x12CB3460, 36963306971319144, 231108105, 231108108, 3, 640x360 
0x12CB3460, 36963306971639272, 231108144, 231108146, 2, 640x360 
0x12CB3460, 36963306971958640, 231108175, 231108177, 2, 640x360 
0x12CB3460, 36963306972278472, 231108204, 231108206, 2, 640x360 
0x12CB3460, 36963306972599352, 231108235, 231108238, 3, 640x360 
0x12CB3460, 36963306972921416, 231108274, 231108277, 3, 640x360 
0x12CB3460, 36963306973238440, 231108304, 231108306, 2, 640x360 
0x12CB3460, 36963306973560456, 231108335, 231108339, 4, 640x360 
0x12CB3460, 36963306974009800, 231108387, 231108397, 10, 640x360 
0x12CB3460, 36963306974202840, 231108398, 231108400, 2, 640x360 
0x12CB3460, 36963306974518904, 231108425, 231108429, 4, 640x360 
0x12CB3460, 36963306974839640, 231108464, 231108467, 3, 640x360 
0x12CB3460, 36963306975319040, 231108515, 231108517, 2, 640x360 
0x12CB3460, 36963306975638472, 231108545, 231108548, 3, 640x360 
0x12CB3460, 36963306975959552, 231108575, 231108577, 2, 640x360 
0x12CB3460, 36963306976279232, 231108604, 231108606, 2, 640x360 
0x12CB3460, 36963306976599424, 231108635, 231108637, 2, 640x360 
0x12CB3460, 36963306976920392, 231108676, 231108679, 3, 640x360 
0x12CB3460, 36963306977241016, 231108704, 231108707, 3, 640x360 
0x12CB3460, 36963306977557568, 231108735, 231108742, 7, 640x360 
0x12CB3460, 36963306977878152, 231108765, 231108767, 2, 640x360 
0x12CB3460, 36963306978199632, 231108794, 231108797, 3, 640x360 
0x12CB3460, 36963306978518008, 231108825, 231108829, 4, 640x360 
0x12CB3460, 36963306979042560, 231108885, 231108891, 6, 640x360 
0x12CB3460, 36963306979318672, 231108905, 231108908, 3, 640x360 
0x12CB3460, 36963306979638488, 231108945, 231108947, 2, 640x360 
0x12CB3460, 36963306979959544, 231108974, 231108977, 3, 640x360 
0x12CB3460, 36963306980280248, 231109006, 231109008, 2, 640x360 
0x12CB3460, 36963306980599048, 231109035, 231109038, 3, 640x360 
0x12CB3460, 36963306980917736, 231109065, 231109068, 3, 640x360 
0x12CB3460, 36963306981239272, 231109105, 231109108, 3, 640x360 
0x12CB3460, 36963306981559056, 231109134, 231109136, 2, 640x360 
0x12CB3460, 36963306981878536, 231109165, 231109168, 3, 640x360 
0x12CB3460, 36963306982201392, 231109195, 231109198, 3, 640x360 
0x12CB3460, 36963306982518640, 231109234, 231109237, 3, 640x360 
0x12CB3460, 36963306982997376, 231109274, 231109277, 3, 640x360 
0x12CB3460, 36963306983318256, 231109314, 231109317, 3, 640x360 
0x12CB3460, 36963306983640520, 231109345, 231109374, 29, 640x360 
0x12CB3460, 36963306984033536, 231109384, 231109391, 7, 640x360 
0x12CB3460, 36963306984277376, 231109404, 231109406, 2, 640x360 
0x12CB3460, 36963306984599360, 231109434, 231109437, 3, 640x360 
0x12CB3460, 36963306984920000, 231109474, 231109477, 3, 640x360 
0x12CB3460, 36963306985239376, 231109505, 231109508, 3, 640x360 
0x12CB3460, 36963306985560520, 231109534, 231109537, 3, 640x360 
0x12CB3460, 36963306985881752, 231109566, 231109569, 3, 640x360 
0x12CB3460, 36963306986198456, 231109594, 231109597, 3, 640x360 
0x12CB3460, 36963306986519096, 231109625, 231109628, 3, 640x360 
0x12CB3460, 36963306987000008, 231109675, 231109677, 2, 640x360 
0x12CB3460, 36963306987320864, 231109716, 231109720, 4, 640x360 
0x12CB3460, 36963306987638520, 231109744, 231109747, 3, 640x360 
0x12CB3460, 36963306987957912, 231109775, 231109780, 5, 640x360 
0x12CB3460, 36963306988279624, 231109804, 231109807, 3, 640x360 
0x12CB3460, 36963306988598808, 231109836, 231109839, 3, 640x360 
0x12CB3460, 36963306989052032, 231109885, 231109888, 3, 640x360 
0x12CB3460, 36963306989237856, 231109905, 231109907, 2, 640x360 
0x12CB3460, 36963306989558608, 231109934, 231109937, 3, 640x360 
0x12CB3460, 36963306989878112, 231109964, 231109967, 3, 640x360 
0x12CB3460, 36963306990199496, 231109994, 231109997, 3, 640x360 
0x12CB3460, 36963306990680616, 231110045, 231110061, 16, 640x360 
0x12CB3460, 36963306991001008, 231110087, 231110092, 5, 640x360 
0x12CB3460, 36963306991317192, 231110114, 231110117, 3, 640x360 
0x12CB3460, 36963306991639072, 231110144, 231110146, 2, 640x360 
0x12CB3460, 36963306991960208, 231110175, 231110177, 2, 640x360 
0x12CB3460, 36963306992280328, 231110206, 231110210, 4, 640x360 
0x12CB3460, 36963306992605768, 231110235, 231110242, 7, 640x360 
0x12CB3460, 36963306992920336, 231110265, 231110269, 4, 640x360 
0x12CB3460, 36963306993238896, 231110304, 231110306, 2, 640x360 
0x12CB3460, 36963306993558048, 231110334, 231110337, 3, 640x360 
0x12CB3460, 36963306994047184, 231110386, 231110389, 3, 640x360 
0x12CB3460, 36963306994203712, 231110394, 231110398, 4, 640x360 
0x12CB3460, 36963306994679224, 231110444, 231110447, 3, 640x360 
0x12CB3460, 36963306994998376, 231110474, 231110478, 4, 640x360 
0x12CB3460, 36963306995317816, 231110505, 231110508, 3, 640x360 
0x12CB3460, 36963306995639936, 231110544, 231110547, 3, 640x360 
0x12CB3460, 36963306995960848, 231110574, 231110577, 3, 640x360 
0x12CB3460, 36963306996279488, 231110605, 231110607, 2, 640x360 
0x12CB3460, 36963306996598912, 231110635, 231110637, 2, 640x360 
0x12CB3460, 36963306996918744, 231110665, 231110668, 3, 640x360 
0x12CB3460, 36963306997239720, 231110704, 231110706, 2, 640x360 
0x12CB3460, 36963306997558168, 231110735, 231110737, 2, 640x360 
0x12CB3460, 36963306997878056, 231110764, 231110773, 9, 640x360 
0x12CB3460, 36963306998360360, 231110814, 231110817, 3, 640x360 
0x12CB3460, 36963306998680680, 231110845, 231110848, 3, 640x360 
0x12CB3460, 36963306999144160, 231110895, 231110897, 2, 640x360 
0x12CB3460, 36963306999317376, 231110905, 231110912, 7, 640x360 
0x12CB3460, 36963306999958640, 231110974, 231110977, 3, 640x360 
0x12CB3460, 36963307000277624, 231111005, 231111007, 2, 640x360 
0x12CB3460, 36963307000597248, 231111035, 231111038, 3, 640x360 
0x12CB3460, 36963307000919768, 231111065, 231111068, 3, 640x360 
0x12CB3460, 36963307001238304, 231111104, 231111107, 3, 640x360 
0x12CB3460, 36963307001559104, 231111134, 231111136, 2, 640x360 
0x12CB3460, 36963307001878680, 231111165, 231111167, 2, 640x360 
0x12CB3460, 36963307002360680, 231111215, 231111217, 2, 640x360 
0x12CB3460, 36963307002678336, 231111244, 231111247, 3, 640x360 
0x12CB3460, 36963307002998856, 231111275, 231111277, 2, 640x360 
0x12CB3460, 36963307003319480, 231111314, 231111317, 3, 640x360 
0x12CB3460, 36963307003639240, 231111367, 231111377, 10, 640x360 
0x12CB3460, 36963307004018512, 231111378, 231111382, 4, 640x360 
0x12CB3460, 36963307004277560, 231111404, 231111406, 2, 640x360 
0x12CB3460, 36963307004598680, 231111434, 231111437, 3, 640x360 
0x12CB3460, 36963307004918384, 231111474, 231111477, 3, 640x360 
0x12CB3460, 36963307005238328, 231111504, 231111506, 2, 640x360 
0x12CB3460, 36963307005558088, 231111535, 231111538, 3, 640x360 
0x12CB3460, 36963307005879088, 231111565, 231111567, 2, 640x360 
0x12CB3460, 36963307006359472, 231111615, 231111618, 3, 640x360 
0x12CB3460, 36963307006679888, 231111645, 231111648, 3, 640x360 
0x12CB3460, 36963307007000680, 231111675, 231111688, 13, 640x360 
0x12CB3460, 36963307007321432, 231111715, 231111718, 3, 640x360 
0x12CB3460, 36963307007637816, 231111745, 231111748, 3, 640x360 
0x12CB3460, 36963307007959104, 231111775, 231111777, 2, 640x360 
0x12CB3460, 36963307008277976, 231111804, 231111806, 2, 640x360 
0x12CB3460, 36963307008599392, 231111836, 231111838, 2, 640x360 
0x12CB3460, 36963307009034968, 231111884, 231111891, 7, 640x360 
0x12CB3460, 36963307009238432, 231111904, 231111907, 3, 640x360 
0x12CB3460, 36963307009559336, 231111935, 231111937, 2, 640x360 
0x12CB3460, 36963307010037080, 231111984, 231111987, 3, 640x360 
0x12CB3460, 36963307010359496, 231112014, 231112018, 4, 640x360 
0x12CB3460, 36963307010677504, 231112044, 231112048, 4, 640x360 
0x12CB3460, 36963307010997568, 231112074, 231112077, 3, 640x360 
0x12CB3460, 36963307011318384, 231112105, 231112113, 8, 640x360 
0x12CB3460, 36963307011637432, 231112145, 231112147, 2, 640x360 
0x12CB3460, 36963307011958592, 231112174, 231112177, 3, 640x360 
0x12CB3460, 36963307012277280, 231112205, 231112208, 3, 640x360 
0x12CB3460, 36963307012599584, 231112235, 231112238, 3, 640x360 
0x12CB3460, 36963307012921184, 231112266, 231112269, 3, 640x360 
0x12CB3460, 36963307013238128, 231112304, 231112313, 9, 640x360 
0x12CB3460, 36963307013559432, 231112334, 231112337, 3, 640x360 
0x12CB3460, 36963307014055280, 231112385, 231112387, 2, 640x360 
0x12CB3460, 36963307014357488, 231112415, 231112417, 2, 640x360 
0x12CB3460, 36963307014678768, 231112444, 231112446, 2, 640x360 
0x12CB3460, 36963307014999944, 231112474, 231112478, 4, 640x360 
0x12CB3460, 36963307015320088, 231112515, 231112518, 3, 640x360 
0x12CB3460, 36963307015641848, 231112544, 231112548, 4, 640x360 
0x12CB3460, 36963307015962936, 231112576, 231112580, 4, 640x360 
0x12CB3460, 36963307016279992, 231112604, 231112607, 3, 640x360 
0x12CB3460, 36963307016597328, 231112635, 231112638, 3, 640x360 
0x12CB3460, 36963307016917880, 231112674, 231112677, 3, 640x360 
0x12CB3460, 36963307017239224, 231112705, 231112712, 7, 640x360 
0x12CB3460, 36963307017558048, 231112734, 231112736, 2, 640x360 
0x12CB3460, 36963307018039192, 231112785, 231112788, 3, 640x360 
0x12CB3460, 36963307018359760, 231112814, 231112816, 2, 640x360 
0x12CB3460, 36963307018681112, 231112870, 231112877, 7, 640x360 
0x12CB3460, 36963307019318136, 231112915, 231112917, 2, 640x360 
0x12CB3460, 36963307019637600, 231112944, 231112946, 2, 640x360 
0x12CB3460, 36963307019959080, 231112974, 231112977, 3, 640x360 
0x12CB3460, 36963307020278352, 231113004, 231113007, 3, 640x360 
0x12CB3460, 36963307020597904, 231113035, 231113038, 3, 640x360 
0x12CB3460, 36963307020921296, 231113074, 231113076, 2, 640x360 
0x12CB3460, 36963307021238432, 231113104, 231113107, 3, 640x360 
0x12CB3460, 36963307021717152, 231113154, 231113157, 3, 640x360 
0x12CB3460, 36963307022038416, 231113186, 231113189, 3, 640x360 
0x12CB3460, 36963307022361424, 231113215, 231113218, 3, 640x360 
0x12CB3460, 36963307022679752, 231113245, 231113248, 3, 640x360 
0x12CB3460, 36963307022999312, 231113275, 231113277, 2, 640x360 
0x12CB3460, 36963307023320064, 231113315, 231113318, 3, 640x360 
0x12CB3460, 36963307023638392, 231113344, 231113347, 3, 640x360 
0x12CB3460, 36963307024071152, 231113385, 231113387, 2, 640x360 
0x12CB3460, 36963307024277904, 231113404, 231113407, 3, 640x360 
0x12CB3460, 36963307024598496, 231113434, 231113436, 2, 640x360 
0x12CB3460, 36963307024919728, 231113474, 231113476, 2, 640x360 
0x12CB3460, 36963307025240752, 231113505, 231113507, 2, 640x360 
0x12CB3460, 36963307025719200, 231113556, 231113560, 4, 640x360 
0x12CB3460, 36963307026040832, 231113584, 231113588, 4, 640x360 
0x12CB3460, 36963307026359272, 231113614, 231113617, 3, 640x360 
0x12CB3460, 36963307026680568, 231113645, 231113648, 3, 640x360 
0x12CB3460, 36963307026999392, 231113675, 231113678, 3, 640x360 
0x12CB3460, 36963307027319512, 231113714, 231113717, 3, 640x360 
0x12CB3460, 36963307027638408, 231113744, 231113747, 3, 640x360 
0x12CB3460, 36963307027958032, 231113774, 231113777, 3, 640x360 
0x12CB3460, 36963307028277704, 231113804, 231113807, 3, 640x360 
0x12CB3460, 36963307028599400, 231113836, 231113839, 3, 640x360 
0x12CB3460, 36963307029036152, 231113885, 231113887, 2, 640x360 
0x12CB3460, 36963307029252168, 231113904, 231113907, 3, 640x360 
0x12CB3460, 36963307029716576, 231113955, 231113957, 2, 640x360 
0x12CB3460, 36963307030039336, 231113984, 231113987, 3, 640x360 
0x12CB3460, 36963307030358072, 231114014, 231114016, 2, 640x360 
0x12CB3460, 36963307030678560, 231114044, 231114047, 3, 640x360 
0x12CB3460, 36963307030997816, 231114074, 231114079, 5, 640x360 
0x12CB3460, 36963307031316952, 231114105, 231114108, 3, 640x360 
0x12CB3460, 36963307031637152, 231114145, 231114147, 2, 640x360 
0x12CB3460, 36963307031958408, 231114175, 231114177, 2, 640x360 
0x12CB3460, 36963307032278360, 231114204, 231114207, 3, 640x360 
0x12CB3460, 36963307032600312, 231114235, 231114238, 3, 640x360 
0x12CB3460, 36963307032921200, 231114274, 231114276, 2, 640x360 
0x12CB3460, 36963307033398336, 231114315, 231114318, 3, 640x360 
0x12CB3460, 36963307033718040, 231114371, 231114375, 4, 640x360 
0x12CB3460, 36963307034038488, 231114385, 231114388, 3, 640x360 
0x12CB3460, 36963307034360360, 231114414, 231114431, 17, 640x360 
0x12CB3460, 36963307034679536, 231114444, 231114447, 3, 640x360 
0x12CB3460, 36963307034997888, 231114474, 231114476, 2, 640x360 
0x12CB3460, 36963307035317768, 231114505, 231114508, 3, 640x360 
0x12CB3460, 36963307035636824, 231114544, 231114547, 3, 640x360 
0x12CB3460, 36963307035957528, 231114574, 231114577, 3, 640x360 
0x12CB3460, 36963307036277624, 231114604, 231114606, 2, 640x360 
0x12CB3460, 36963307036598760, 231114634, 231114637, 3, 640x360 
0x12CB3460, 36963307036918856, 231114674, 231114677, 3, 640x360 
0x12CB3460, 36963307037400160, 231114715, 231114718, 3, 640x360 
0x12CB3460, 36963307037717136, 231114745, 231114748, 3, 640x360 
0x12CB3460, 36963307038037632, 231114785, 231114787, 2, 640x360 
0x12CB3460, 36963307038357696, 231114815, 231114818, 3, 640x360 
0x12CB3460, 36963307038677464, 231114845, 231114847, 2, 640x360 
0x12CB3460, 36963307039113800, 231114885, 231114890, 5, 640x360 
0x12CB3460, 36963307039317944, 231114914, 231114922, 8, 640x360 
0x12CB3460, 36963307039638056, 231114944, 231114947, 3, 640x360 
0x12CB3460, 36963307039958440, 231114975, 231114977, 2, 640x360 
0x12CB3460, 36963307040279800, 231115004, 231115008, 4, 640x360 
0x12CB3460, 36963307040601864, 231115035, 231115039, 4, 640x360 
0x12CB3460, 36963307041079304, 231115084, 231115089, 5, 640x360 
0x12CB3460, 36963307041396952, 231115116, 231115121, 5, 640x360 
0x12CB3460, 36963307041718936, 231115145, 231115149, 4, 640x360 
0x12CB3460, 36963307042037456, 231115185, 231115187, 2, 640x360 
0x12CB3460, 36963307042358472, 231115215, 231115232, 17, 640x360 
0x12CB3460, 36963307042677312, 231115245, 231115248, 3, 640x360 
0x12CB3460, 36963307042997032, 231115274, 231115276, 2, 640x360 
0x12CB3460, 36963307043317704, 231115305, 231115308, 3, 640x360 
0x12CB3460, 36963307043638408, 231115345, 231115372, 27, 640x360 
0x12CB3460, 36963307044011416, 231115386, 231115402, 16, 640x360 
0x12CB3460, 36963307044276800, 231115403, 231115406, 3, 640x360 
0x12CB3460, 36963307044598232, 231115434, 231115437, 3, 640x360 
0x12CB3460, 36963307045079016, 231115485, 231115488, 3, 640x360 
0x12CB3460, 36963307045396912, 231115514, 231115519, 5, 640x360 
0x12CB3460, 36963307045716520, 231115545, 231115549, 4, 640x360 
0x12CB3460, 36963307046056896, 231115585, 231115588, 3, 640x360 
0x12CB3460, 36963307046358400, 231115614, 231115617, 3, 640x360 
0x12CB3460, 36963307046678640, 231115644, 231115647, 3, 640x360 
0x12CB3460, 36963307046997400, 231115674, 231115677, 3, 640x360 
0x12CB3460, 36963307047317264, 231115714, 231115717, 3, 640x360 
0x12CB3460, 36963307047636720, 231115744, 231115747, 3, 640x360 
0x12CB3460, 36963307047958200, 231115774, 231115777, 3, 640x360 
0x12CB3460, 36963307048278824, 231115804, 231115813, 9, 640x360 
0x12CB3460, 36963307048599304, 231115834, 231115837, 3, 640x360 
0x12CB3460, 36963307049076760, 231115884, 231115887, 3, 640x360 
0x12CB3460, 36963307049398048, 231115917, 231115921, 4, 640x360 
0x12CB3460, 36963307049716576, 231115954, 231115956, 2, 640x360 
0x12CB3460, 36963307050038824, 231115984, 231115987, 3, 640x360 
0x12CB3460, 36963307050357616, 231116014, 231116017, 3, 640x360 
0x12CB3460, 36963307050678664, 231116044, 231116047, 3, 640x360 
0x12CB3460, 36963307051049096, 231116086, 231116097, 11, 640x360 
0x12CB3460, 36963307051318416, 231116115, 231116118, 3, 640x360 
0x12CB3460, 36963307051637376, 231116144, 231116147, 3, 640x360 
0x12CB3460, 36963307051959376, 231116175, 231116178, 3, 640x360 
0x12CB3460, 36963307052277248, 231116204, 231116207, 3, 640x360 
0x12CB3460, 36963307052758256, 231116254, 231116257, 3, 640x360 
0x12CB3460, 36963307053078376, 231116284, 231116286, 2, 640x360 
0x12CB3460, 36963307053397520, 231116315, 231116317, 2, 640x360 
0x12CB3460, 36963307053719200, 231116375, 231116378, 3, 640x360 
0x12CB3460, 36963307054044080, 231116385, 231116388, 3, 640x360 
0x12CB3460, 36963307054363184, 231116414, 231116417, 3, 640x360 
0x12CB3460, 36963307054678816, 231116443, 231116446, 3, 640x360 
0x12CB3460, 36963307054998032, 231116475, 231116477, 2, 640x360 
0x12CB3460, 36963307055317728, 231116514, 231116517, 3, 640x360 
0x12CB3460, 36963307055637464, 231116544, 231116547, 3, 640x360 
0x12CB3460, 36963307055959728, 231116575, 231116578, 3, 640x360 
0x12CB3460, 36963307056278656, 231116604, 231116606, 2, 640x360 
0x12CB3460, 36963307056758320, 231116654, 231116657, 3, 640x360 
0x12CB3460, 36963307057079056, 231116685, 231116688, 3, 640x360 
0x12CB3460, 36963307057400064, 231116726, 231116728, 2, 640x360 
0x12CB3460, 36963307057717536, 231116744, 231116747, 3, 640x360 
0x12CB3460, 36963307058038456, 231116785, 231116787, 2, 640x360 
0x12CB3460, 36963307058359496, 231116814, 231116816, 2, 640x360 
0x12CB3460, 36963307058679744, 231116845, 231116848, 3, 640x360 
0x12CB3460, 36963307059108520, 231116885, 231116889, 4, 640x360 
0x12CB3460, 36963307059318000, 231116905, 231116908, 3, 640x360 
0x12CB3460, 36963307059639608, 231116944, 231116947, 3, 640x360 
0x12CB3460, 36963307059958776, 231116974, 231116976, 2, 640x360 
0x12CB3460, 36963307060279296, 231117004, 231117007, 3, 640x360 
0x12CB3460, 36963307060759584, 231117054, 231117057, 3, 640x360 
0x12CB3460, 36963307061076856, 231117085, 231117087, 2, 640x360 
0x12CB3460, 36963307061401736, 231117114, 231117117, 3, 640x360 
0x12CB3460, 36963307061718568, 231117154, 231117157, 3, 640x360 
0x12CB3460, 36963307062039344, 231117185, 231117188, 3, 640x360 
0x12CB3460, 36963307062359360, 231117215, 231117218, 3, 640x360 
0x12CB3460, 36963307062680552, 231117244, 231117248, 4, 640x360 
0x12CB3460, 36963307062996776, 231117274, 231117276, 2, 640x360 
0x12CB3460, 36963307063318368, 231117314, 231117317, 3, 640x360 
0x12CB3460, 36963307063639712, 231117345, 231117376, 31, 640x360 
0x12CB3460, 36963307064050912, 231117385, 231117391, 6, 640x360 
0x12CB3460, 36963307064437040, 231117424, 231117427, 3, 640x360 
0x12CB3460, 36963307064759472, 231117454, 231117457, 3, 640x360 
0x12CB3460, 36963307065077512, 231117484, 231117487, 3, 640x360 
0x12CB3460, 36963307065400224, 231117515, 231117518, 3, 640x360 
0x12CB3460, 36963307065717632, 231117556, 231117558, 2, 640x360 
0x12CB3460, 36963307066037032, 231117585, 231117587, 2, 640x360 
0x12CB3460, 36963307066357032, 231117614, 231117616, 2, 640x360 
0x12CB3460, 36963307066676800, 231117645, 231117648, 3, 640x360 
0x12CB3460, 36963307066997424, 231117675, 231117678, 3, 640x360 
0x12CB3460, 36963307067318512, 231117715, 231117720, 5, 640x360 
0x12CB3460, 36963307067638344, 231117745, 231117747, 2, 640x360 
0x12CB3460, 36963307067958840, 231117774, 231117780, 6, 640x360 
0x12CB3460, 36963307068438288, 231117824, 231117827, 3, 640x360 
0x12CB3460, 36963307068757072, 231117875, 231117878, 3, 640x360 
0x12CB3460, 36963307069089800, 231117886, 231117889, 3, 640x360 
0x12CB3460, 36963307069397144, 231117915, 231117918, 3, 640x360 
0x12CB3460, 36963307069718456, 231117955, 231117957, 2, 640x360 
0x12CB3460, 36963307070037744, 231117984, 231117987, 3, 640x360 
0x12CB3460, 36963307070357840, 231118014, 231118016, 2, 640x360 
0x12CB3460, 36963307070677272, 231118044, 231118047, 3, 640x360 
0x12CB3460, 36963307071000264, 231118075, 231118079, 4, 640x360 
0x12CB3460, 36963307071317736, 231118114, 231118116, 2, 640x360 
0x12CB3460, 36963307071638816, 231118145, 231118147, 2, 640x360 
0x12CB3460, 36963307071959688, 231118175, 231118177, 2, 640x360 
0x12CB3460, 36963307072444056, 231118226, 231118243, 17, 640x360 
0x12CB3460, 36963307072788768, 231118254, 231118257, 3, 640x360 
0x12CB3460, 36963307073078040, 231118284, 231118289, 5, 640x360 
0x12CB3460, 36963307073399408, 231118315, 231118318, 3, 640x360 
0x12CB3460, 36963307073717824, 231118384, 231118387, 3, 640x360 
0x12CB3460, 36963307074357128, 231118415, 231118417, 2, 640x360 
0x12CB3460, 36963307074678976, 231118445, 231118448, 3, 640x360 
0x12CB3460, 36963307074999168, 231118474, 231118477, 3, 640x360 
0x12CB3460, 36963307075320208, 231118515, 231118518, 3, 640x360 
0x12CB3460, 36963307075639416, 231118544, 231118547, 3, 640x360 
0x12CB3460, 36963307076118072, 231118594, 231118601, 7, 640x360 
0x12CB3460, 36963307076437656, 231118625, 231118627, 2, 640x360 
0x12CB3460, 36963307076758896, 231118654, 231118657, 3, 640x360 
0x12CB3460, 36963307077077984, 231118685, 231118687, 2, 640x360 
0x12CB3460, 36963307077400472, 231118714, 231118717, 3, 640x360 
0x12CB3460, 36963307077720136, 231118754, 231118756, 2, 640x360 
0x12CB3460, 36963307078037800, 231118785, 231118788, 3, 640x360 
0x12CB3460, 36963307078359520, 231118815, 231118817, 2, 640x360 
0x12CB3460, 36963307078678752, 231118870, 231118873, 3, 640x360 
0x12CB3460, 36963307079022016, 231118885, 231118890, 5, 640x360 
0x12CB3460, 36963307079316928, 231118914, 231118916, 2, 640x360 
0x12CB3460, 36963307079637992, 231118945, 231118948, 3, 640x360 
0x12CB3460, 36963307080119768, 231118995, 231118998, 3, 640x360 
0x12CB3460, 36963307080441552, 231119025, 231119027, 2, 640x360 
0x12CB3460, 36963307080759688, 231119056, 231119059, 3, 640x360 
0x12CB3460, 36963307081078456, 231119085, 231119089, 4, 640x360 
0x12CB3460, 36963307081397176, 231119115, 231119118, 3, 640x360 
0x12CB3460, 36963307081719112, 231119154, 231119156, 2, 640x360 
0x12CB3460, 36963307082037272, 231119185, 231119187, 2, 640x360 
0x12CB3460, 36963307082359216, 231119215, 231119217, 2, 640x360 
0x12CB3460, 36963307082678112, 231119246, 231119249, 3, 640x360 
0x12CB3460, 36963307082998608, 231119275, 231119277, 2, 640x360 
0x12CB3460, 36963307083319264, 231119306, 231119309, 3, 640x360 
0x12CB3460, 36963307084146992, 231119394, 231119396, 2, 640x360 
0x12CB3460, 36963307084438392, 231119424, 231119426, 2, 640x360 
0x12CB3460, 36963307084758368, 231119454, 231119456, 2, 640x360 
0x12CB3460, 36963307085078760, 231119484, 231119486, 2, 640x360 
0x12CB3460, 36963307085400464, 231119515, 231119518, 3, 640x360 
0x12CB3460, 36963307085717584, 231119555, 231119557, 2, 640x360 
0x12CB3460, 36963307086039016, 231119584, 231119586, 2, 640x360 
0x12CB3460, 36963307086357040, 231119614, 231119617, 3, 640x360 
0x12CB3460, 36963307086680200, 231119644, 231119647, 3, 640x360 
0x12CB3460, 36963307086997480, 231119675, 231119677, 2, 640x360 
0x12CB3460, 36963307087319456, 231119706, 231119709, 3, 640x360 
0x12CB3460, 36963307087798584, 231119755, 231119757, 2, 640x360 
0x12CB3460, 36963307088119344, 231119794, 231119797, 3, 640x360 
0x12CB3460, 36963307088438320, 231119824, 231119827, 3, 640x360 
0x12CB3460, 36963307088758552, 231119874, 231119878, 4, 640x360 
0x12CB3460, 36963307089077520, 231119885, 231119887, 2, 640x360 
0x12CB3460, 36963307089397856, 231119914, 231119917, 3, 640x360 
0x12CB3460, 36963307089717000, 231119944, 231119948, 4, 640x360 
0x12CB3460, 36963307090038224, 231119984, 231119987, 3, 640x360 
0x12CB3460, 36963307090358576, 231120014, 231120017, 3, 640x360 
0x12CB3460, 36963307090678096, 231120045, 231120048, 3, 640x360 
0x12CB3460, 36963307091009664, 231120084, 231120088, 4, 640x360 
0x12CB3460, 36963307091317248, 231120115, 231120117, 2, 640x360 
0x12CB3460, 36963307091797616, 231120155, 231120157, 2, 640x360 
0x12CB3460, 36963307092117760, 231120195, 231120198, 3, 640x360 
0x12CB3460, 36963307092437440, 231120225, 231120227, 2, 640x360 
0x12CB3460, 36963307092757000, 231120254, 231120257, 3, 640x360 
0x12CB3460, 36963307093078872, 231120284, 231120287, 3, 640x360 
0x12CB3460, 36963307093399168, 231120316, 231120318, 2, 640x360 
0x12CB3460, 36963307093717736, 231120372, 231120377, 5, 640x360 
0x12CB3460, 36963307094048272, 231120384, 231120387, 3, 640x360 
0x12CB3460, 36963307094357040, 231120414, 231120417, 3, 640x360 
0x12CB3460, 36963307094678472, 231120444, 231120446, 2, 640x360 
0x12CB3460, 36963307094999536, 231120475, 231120477, 2, 640x360 
0x12CB3460, 36963307095481312, 231120526, 231120530, 4, 640x360 
0x12CB3460, 36963307095798232, 231120555, 231120559, 4, 640x360 
0x12CB3460, 36963307096117944, 231120595, 231120597, 2, 640x360 
0x12CB3460, 36963307096437704, 231120624, 231120639, 15, 640x360 
0x12CB3460, 36963307096757304, 231120654, 231120657, 3, 640x360 
0x12CB3460, 36963307097080024, 231120685, 231120687, 2, 640x360 
0x12CB3460, 36963307097399536, 231120716, 231120719, 3, 640x360 
0x12CB3460, 36963307097716072, 231120744, 231120748, 4, 640x360 
0x12CB3460, 36963307098038360, 231120784, 231120787, 3, 640x360 
0x12CB3460, 36963307098358600, 231120815, 231120817, 2, 640x360 
0x12CB3460, 36963307098677768, 231120844, 231120847, 3, 640x360 
0x12CB3460, 36963307099052816, 231120884, 231120887, 3, 640x360 
0x12CB3460, 36963307099478208, 231120925, 231120927, 2, 640x360 
0x12CB3460, 36963307099798384, 231120955, 231120959, 4, 640x360 
0x12CB3460, 36963307100119008, 231120994, 231120997, 3, 640x360 
0x12CB3460, 36963307100440304, 231121026, 231121029, 3, 640x360 
0x12CB3460, 36963307100758208, 231121055, 231121058, 3, 640x360 
0x12CB3460, 36963307101081336, 231121085, 231121089, 4, 640x360 
0x12CB3460, 36963307101396912, 231121115, 231121118, 3, 640x360 
0x12CB3460, 36963307101716680, 231121154, 231121157, 3, 640x360 
0x12CB3460, 36963307102038336, 231121184, 231121187, 3, 640x360 
0x12CB3460, 36963307102358080, 231121214, 231121218, 4, 640x360 
0x12CB3460, 36963307102676968, 231121245, 231121249, 4, 640x360 
0x12CB3460, 36963307102996880, 231121274, 231121277, 3, 640x360 
0x12CB3460, 36963307103479432, 231121325, 231121328, 3, 640x360 
0x12CB3460, 36963307103996864, 231121374, 231121378, 4, 640x360 
0x12CB3460, 36963307104116744, 231121397, 231121403, 6, 640x360 
0x12CB3460, 36963307104439080, 231121425, 231121428, 3, 640x360 
0x12CB3460, 36963307104847152, 231121488, 231121503, 15, 640x360 
0x12CB3460, 36963307105397752, 231121516, 231121523, 7, 640x360 
0x12CB3460, 36963307105721936, 231121555, 231121557, 2, 640x360 
0x12CB3460, 36963307106039312, 231121584, 231121587, 3, 640x360 
0x12CB3460, 36963307106357552, 231121615, 231121618, 3, 640x360 
0x12CB3460, 36963307106682800, 231121645, 231121647, 2, 640x360 
0x12CB3460, 36963307107156256, 231121694, 231121697, 3, 640x360 
0x12CB3460, 36963307107476504, 231121724, 231121727, 3, 640x360 
0x12CB3460, 36963307107796464, 231121755, 231121758, 3, 640x360 
0x12CB3460, 36963307108117664, 231121794, 231121797, 3, 640x360 
0x12CB3460, 36963307108437264, 231121824, 231121827, 3, 640x360 
0x12CB3460, 36963307108757760, 231121877, 231121881, 4, 640x360 
0x12CB3460, 36963307109078584, 231121886, 231121891, 5, 640x360 
0x12CB3460, 36963307109397768, 231121915, 231121917, 2, 640x360 
0x12CB3460, 36963307109717264, 231121944, 231121947, 3, 640x360 
0x12CB3460, 36963307110038392, 231121984, 231121988, 4, 640x360 
0x12CB3460, 36963307110359688, 231122013, 231122016, 3, 640x360 
0x12CB3460, 36963307110677760, 231122044, 231122047, 3, 640x360 
0x12CB3460, 36963307111157056, 231122094, 231122096, 2, 640x360 
0x12CB3460, 36963307111476208, 231122124, 231122127, 3, 640x360 
0x12CB3460, 36963307111796128, 231122155, 231122157, 2, 640x360 
0x12CB3460, 36963307112117424, 231122195, 231122197, 2, 640x360 
0x12CB3460, 36963307112436640, 231122225, 231122227, 2, 640x360 
0x12CB3460, 36963307112756296, 231122254, 231122257, 3, 640x360 
0x12CB3460, 36963307113076408, 231122284, 231122286, 2, 640x360 
0x12CB3460, 36963307113396968, 231122315, 231122318, 3, 640x360 
0x12CB3460, 36963307113717104, 231122378, 231122382, 4, 640x360 
0x12CB3460, 36963307114069008, 231122385, 231122388, 3, 640x360 
0x12CB3460, 36963307114356784, 231122415, 231122417, 2, 640x360 
0x12CB3460, 36963307114837536, 231122465, 231122467, 2, 640x360 
0x12CB3460, 36963307115156464, 231122494, 231122497, 3, 640x360 
0x12CB3460, 36963307115477616, 231122524, 231122526, 2, 640x360 
0x12CB3460, 36963307115798024, 231122554, 231122557, 3, 640x360 
0x12CB3460, 36963307116117864, 231122585, 231122588, 3, 640x360 
0x12CB3460, 36963307116457784, 231122625, 231122628, 3, 640x360 
0x12CB3460, 36963307116757136, 231122654, 231122657, 3, 640x360 
0x12CB3460, 36963307117076392, 231122685, 231122688, 3, 640x360 
0x12CB3460, 36963307117396576, 231122715, 231122718, 3, 640x360 
0x12CB3460, 36963307117717560, 231122755, 231122757, 2, 640x360 
0x12CB3460, 36963307118036832, 231122784, 231122787, 3, 640x360 
0x12CB3460, 36963307118358168, 231122814, 231122817, 3, 640x360 
0x12CB3460, 36963307119068224, 231122886, 231122896, 10, 640x360 
0x12CB3460, 36963307119157896, 231122896, 231122899, 3, 640x360 
0x12CB3460, 36963307119477784, 231122923, 231122926, 3, 640x360 
0x12CB3460, 36963307119796616, 231122954, 231122957, 3, 640x360 
0x12CB3460, 36963307120118032, 231122993, 231122996, 3, 640x360 
0x12CB3460, 36963307120436776, 231123024, 231123027, 3, 640x360 
0x12CB3460, 36963307120757208, 231123054, 231123056, 2, 640x360 
0x12CB3460, 36963307121076248, 231123084, 231123094, 10, 640x360 
0x12CB3460, 36963307121716376, 231123155, 231123157, 2, 640x360 
0x12CB3460, 36963307122037672, 231123184, 231123187, 3, 640x360 
0x12CB3460, 36963307122357712, 231123215, 231123218, 3, 640x360 
0x12CB3460, 36963307122838088, 231123264, 231123267, 3, 640x360 
0x12CB3460, 36963307123156344, 231123294, 231123297, 3, 640x360 
0x12CB3460, 36963307123478464, 231123325, 231123339, 14, 640x360 
0x12CB3460, 36963307123991664, 231123374, 231123378, 4, 640x360 
0x12CB3460, 36963307124116432, 231123385, 231123389, 4, 640x360 
0x12CB3460, 36963307124436304, 231123425, 231123427, 2, 640x360 
0x12CB3460, 36963307124757928, 231123454, 231123456, 2, 640x360 
0x12CB3460, 36963307125076760, 231123485, 231123488, 3, 640x360 
0x12CB3460, 36963307125397272, 231123514, 231123517, 3, 640x360 
0x12CB3460, 36963307125717736, 231123554, 231123557, 3, 640x360 
0x12CB3460, 36963307126037064, 231123584, 231123587, 3, 640x360 
0x12CB3460, 36963307126517176, 231123635, 231123637, 2, 640x360 
0x12CB3460, 36963307126835944, 231123665, 231123668, 3, 640x360 
0x12CB3460, 36963307127155952, 231123695, 231123698, 3, 640x360 
0x12CB3460, 36963307127477504, 231123724, 231123727, 3, 640x360 
0x12CB3460, 36963307127797200, 231123754, 231123757, 3, 640x360 
0x12CB3460, 36963307128116208, 231123794, 231123796, 2, 640x360 
0x12CB3460, 36963307128440184, 231123825, 231123828, 3, 640x360 
0x12CB3460, 36963307128755984, 231123879, 231123889, 10, 640x360 
0x12CB3460, 36963307129396320, 231123923, 231123926, 3, 640x360 
0x12CB3460, 36963307129716768, 231123954, 231123957, 3, 640x360 
0x12CB3460, 36963307130037504, 231123984, 231123987, 3, 640x360 
0x12CB3460, 36963307130516632, 231124034, 231124037, 3, 640x360 
0x12CB3460, 36963307130836592, 231124066, 231124070, 4, 640x360 
0x12CB3460, 36963307131156296, 231124094, 231124097, 3, 640x360 
0x12CB3460, 36963307131477912, 231124124, 231124127, 3, 640x360 
0x12CB3460, 36963307131796576, 231124155, 231124158, 3, 640x360 
0x12CB3460, 36963307132117144, 231124195, 231124197, 2, 640x360 
0x12CB3460, 36963307132437592, 231124224, 231124232, 8, 640x360 
0x12CB3460, 36963307132757440, 231124254, 231124256, 2, 640x360 
0x12CB3460, 36963307133076776, 231124284, 231124287, 3, 640x360 
0x12CB3460, 36963307133396656, 231124316, 231124319, 3, 640x360 
0x12CB3460, 36963307133716848, 231124377, 231124382, 5, 640x360 
0x12CB3460, 36963307134071312, 231124386, 231124392, 6, 640x360 
0x12CB3460, 36963307134516216, 231124435, 231124440, 5, 640x360 
0x12CB3460, 36963307134836424, 231124465, 231124468, 3, 640x360 
0x12CB3460, 36963307135156672, 231124494, 231124498, 4, 640x360 
0x12CB3460, 36963307135477440, 231124524, 231124529, 5, 640x360 
0x12CB3460, 36963307135796656, 231124555, 231124559, 4, 640x360 
0x12CB3460, 36963307136118216, 231124594, 231124597, 3, 640x360 
0x12CB3460, 36963307136437064, 231124624, 231124629, 5, 640x360 
0x12CB3460, 36963307136756968, 231124654, 231124657, 3, 640x360 
0x12CB3460, 36963307137076400, 231124685, 231124688, 3, 640x360 
0x12CB3460, 36963307137398824, 231124715, 231124718, 3, 640x360 
0x12CB3460, 36963307137717200, 231124745, 231124748, 3, 640x360 
0x12CB3460, 36963307138196424, 231124794, 231124797, 3, 640x360 
0x12CB3460, 36963307138518936, 231124835, 231124838, 3, 640x360 
0x12CB3460, 36963307138972808, 231124875, 231124878, 3, 640x360 
0x12CB3460, 36963307139156368, 231124895, 231124898, 3, 640x360 
0x12CB3460, 36963307139477704, 231124924, 231124927, 3, 640x360 
0x12CB3460, 36963307139798584, 231124955, 231124958, 3, 640x360 
0x12CB3460, 36963307140119176, 231124994, 231124997, 3, 640x360 
0x12CB3460, 36963307140440416, 231125026, 231125028, 2, 640x360 
0x12CB3460, 36963307140760272, 231125055, 231125058, 3, 640x360 
0x12CB3460, 36963307141076752, 231125084, 231125087, 3, 640x360 
0x12CB3460, 36963307141397248, 231125115, 231125119, 4, 640x360 
0x12CB3460, 36963307141717832, 231125154, 231125157, 3, 640x360 
0x12CB3460, 36963307142199072, 231125195, 231125198, 3, 640x360 
0x12CB3460, 36963307142517992, 231125234, 231125237, 3, 640x360 
0x12CB3460, 36963307142837904, 231125265, 231125267, 2, 640x360 
0x12CB3460, 36963307143157560, 231125294, 231125297, 3, 640x360 
0x12CB3460, 36963307143477944, 231125325, 231125327, 2, 640x360 
0x12CB3460, 36963307144010064, 231125385, 231125389, 4, 640x360 
0x12CB3460, 36963307144436920, 231125425, 231125429, 4, 640x360 
0x12CB3460, 36963307144756520, 231125454, 231125465, 11, 640x360 
0x12CB3460, 36963307145078096, 231125484, 231125488, 4, 640x360 
0x12CB3460, 36963307145397616, 231125514, 231125517, 3, 640x360 
0x12CB3460, 36963307145720296, 231125556, 231125559, 3, 640x360 
0x12CB3460, 36963307146197856, 231125595, 231125597, 2, 640x360 
0x12CB3460, 36963307146518512, 231125634, 231125637, 3, 640x360 
0x12CB3460, 36963307146839448, 231125664, 231125667, 3, 640x360 
0x12CB3460, 36963307147158352, 231125695, 231125698, 3, 640x360 
0x12CB3460, 36963307147481912, 231125734, 231125739, 5, 640x360 
0x12CB3460, 36963307147799904, 231125755, 231125759, 4, 640x360 
0x12CB3460, 36963307148116912, 231125784, 231125789, 5, 640x360 
0x12CB3460, 36963307148438096, 231125824, 231125827, 3, 640x360 
0x12CB3460, 36963307148757304, 231125876, 231125880, 4, 640x360 
0x12CB3460, 36963307149093088, 231125885, 231125888, 3, 640x360 
0x12CB3460, 36963307149396696, 231125914, 231125917, 3, 640x360 
0x12CB3460, 36963307149877776, 231125965, 231125967, 2, 640x360 
0x12CB3460, 36963307150197912, 231125994, 231125997, 3, 640x360 
0x12CB3460, 36963307150516616, 231126034, 231126037, 3, 640x360 
0x12CB3460, 36963307150837168, 231126064, 231126067, 3, 640x360 
0x12CB3460, 36963307151157776, 231126094, 231126097, 3, 640x360 
0x12CB3460, 36963307151477592, 231126124, 231126127, 3, 640x360 
0x12CB3460, 36963307151797520, 231126155, 231126158, 3, 640x360 
0x12CB3460, 36963307152117328, 231126194, 231126197, 3, 640x360 
0x12CB3460, 36963307152437816, 231126224, 231126227, 3, 640x360 
0x12CB3460, 36963307152756688, 231126255, 231126258, 3, 640x360 
0x12CB3460, 36963307153077424, 231126284, 231126287, 3, 640x360 
0x12CB3460, 36963307153398312, 231126314, 231126317, 3, 640x360 
0x12CB3460, 36963307153971976, 231126376, 231126379, 3, 640x360 
0x12CB3460, 36963307154196056, 231126395, 231126398, 3, 640x360 
0x12CB3460, 36963307154517872, 231126434, 231126437, 3, 640x360 
0x12CB3460, 36963307154837680, 231126464, 231126467, 3, 640x360 
0x12CB3460, 36963307155157896, 231126495, 231126498, 3, 640x360 
0x12CB3460, 36963307155479792, 231126525, 231126528, 3, 640x360 
0x12CB3460, 36963307155800848, 231126554, 231126558, 4, 640x360 
0x12CB3460, 36963307156119376, 231126595, 231126598, 3, 640x360 
0x12CB3460, 36963307156440240, 231126625, 231126627, 2, 640x360 
0x12CB3460, 36963307156759360, 231126654, 231126657, 3, 640x360 
0x12CB3460, 36963307157080512, 231126685, 231126688, 3, 640x360 
0x12CB3460, 36963307157561864, 231126735, 231126739, 4, 640x360 
0x12CB3460, 36963307157878296, 231126765, 231126767, 2, 640x360 
0x12CB3460, 36963307158196288, 231126794, 231126797, 3, 640x360 
0x12CB3460, 36963307158518304, 231126825, 231126839, 14, 640x360 
0x12CB3460, 36963307158836232, 231126885, 231126888, 3, 640x360 
0x12CB3460, 36963307159157832, 231126894, 231126897, 3, 640x360 
0x12CB3460, 36963307159477232, 231126925, 231126927, 2, 640x360 
0x12CB3460, 36963307159796904, 231126954, 231126957, 3, 640x360 
0x12CB3460, 36963307160116472, 231126985, 231126988, 3, 640x360 
0x12CB3460, 36963307160438208, 231127025, 231127028, 3, 640x360 
0x12CB3460, 36963307160759720, 231127054, 231127057, 3, 640x360 
0x12CB3460, 36963307161077008, 231127084, 231127092, 8, 640x360 
0x12CB3460, 36963307161558048, 231127134, 231127136, 2, 640x360 
0x12CB3460, 36963307161878672, 231127164, 231127167, 3, 640x360 
0x12CB3460, 36963307162199968, 231127195, 231127198, 3, 640x360 
0x12CB3460, 36963307162519200, 231127234, 231127237, 3, 640x360 
0x12CB3460, 36963307162838672, 231127265, 231127268, 3, 640x360 
0x12CB3460, 36963307163157104, 231127294, 231127297, 3, 640x360 
0x12CB3460, 36963307163477520, 231127325, 231127329, 4, 640x360 
0x12CB3460, 36963307164107080, 231127393, 231127396, 3, 640x360 
0x12CB3460, 36963307164442840, 231127424, 231127427, 3, 640x360 
0x12CB3460, 36963307165078096, 231127484, 231127487, 3, 640x360 
0x12CB3460, 36963307165559280, 231127533, 231127536, 3, 640x360 
0x12CB3460, 36963307165879776, 231127565, 231127568, 3, 640x360 
0x12CB3460, 36963307166196960, 231127595, 231127600, 5, 640x360 
0x12CB3460, 36963307166518168, 231127625, 231127629, 4, 640x360 
0x12CB3460, 36963307166838240, 231127665, 231127683, 18, 640x360 
0x12CB3460, 36963307167159728, 231127695, 231127698, 3, 640x360 
0x12CB3460, 36963307167480232, 231127725, 231127727, 2, 640x360 
0x12CB3460, 36963307167799664, 231127756, 231127759, 3, 640x360 
0x12CB3460, 36963307168117400, 231127794, 231127798, 4, 640x360 
0x12CB3460, 36963307168441392, 231127825, 231127828, 3, 640x360 
0x12CB3460, 36963307169016808, 231127883, 231127886, 3, 640x360 
0x12CB3460, 36963307169236064, 231127905, 231127913, 8, 640x360 
0x12CB3460, 36963307169558600, 231127934, 231127940, 6, 640x360 
0x12CB3460, 36963307169876632, 231127966, 231127969, 3, 640x360 
0x12CB3460, 36963307170197328, 231127994, 231127997, 3, 640x360 
0x12CB3460, 36963307170516080, 231128034, 231128037, 3, 640x360 
0x12CB3460, 36963307170837016, 231128065, 231128070, 5, 640x360 
0x12CB3460, 36963307171156224, 231128095, 231128097, 2, 640x360 
0x12CB3460, 36963307171476888, 231128124, 231128127, 3, 640x360 
0x12CB3460, 36963307171796528, 231128154, 231128157, 3, 640x360 
0x12CB3460, 36963307172117520, 231128194, 231128197, 3, 640x360 
0x12CB3460, 36963307172439264, 231128224, 231128227, 3, 640x360 
0x12CB3460, 36963307172757856, 231128255, 231128257, 2, 640x360 
0x12CB3460, 36963307173236552, 231128304, 231128306, 2, 640x360 
0x12CB3460, 36963307173559904, 231128334, 231128338, 4, 640x360 
0x12CB3460, 36963307174161576, 231128394, 231128397, 3, 640x360 
0x12CB3460, 36963307174516152, 231128424, 231128428, 4, 640x360 
0x12CB3460, 36963307174836976, 231128465, 231128468, 3, 640x360 
0x12CB3460, 36963307175478656, 231128525, 231128527, 2, 640x360 
0x12CB3460, 36963307175798376, 231128555, 231128558, 3, 640x360 
0x12CB3460, 36963307176119736, 231128594, 231128597, 3, 640x360 
0x12CB3460, 36963307176439920, 231128624, 231128627, 3, 640x360 
0x12CB3460, 36963307176758568, 231128654, 231128657, 3, 640x360 
0x12CB3460, 36963307177240760, 231128704, 231128707, 3, 640x360 
0x12CB3460, 36963307177556176, 231128735, 231128737, 2, 640x360 
0x12CB3460, 36963307177876528, 231128764, 231128768, 4, 640x360 
0x12CB3460, 36963307178197304, 231128795, 231128797, 2, 640x360 
0x12CB3460, 36963307178518152, 231128834, 231128837, 3, 640x360 
0x12CB3460, 36963307178984416, 231128874, 231128878, 4, 640x360 
0x12CB3460, 36963307179156136, 231128893, 231128896, 3, 640x360 
0x12CB3460, 36963307179477904, 231128924, 231128927, 3, 640x360 
0x12CB3460, 36963307179798464, 231128955, 231128957, 2, 640x360 
0x12CB3460, 36963307180117632, 231128994, 231128997, 3, 640x360 
0x12CB3460, 36963307180439528, 231129026, 231129029, 3, 640x360 
0x12CB3460, 36963307180917232, 231129075, 231129077, 2, 640x360 
0x12CB3460, 36963307181237552, 231129105, 231129108, 3, 640x360 
0x12CB3460, 36963307181557872, 231129134, 231129136, 2, 640x360 
0x12CB3460, 36963307181877832, 231129165, 231129167, 2, 640x360 
0x12CB3460, 36963307182198168, 231129194, 231129198, 4, 640x360 
0x12CB3460, 36963307182519296, 231129234, 231129237, 3, 640x360 
0x12CB3460, 36963307182838728, 231129264, 231129268, 4, 640x360 
0x12CB3460, 36963307183156432, 231129294, 231129296, 2, 640x360 
0x12CB3460, 36963307183476720, 231129324, 231129327, 3, 640x360 
0x12CB3460, 36963307184001304, 231129375, 231129378, 3, 640x360 
0x12CB3460, 36963307184116584, 231129395, 231129397, 2, 640x360 
0x12CB3460, 36963307184438728, 231129424, 231129426, 2, 640x360 
0x12CB3460, 36963307184918280, 231129474, 231129477, 3, 640x360 
0x12CB3460, 36963307185237472, 231129504, 231129507, 3, 640x360 
0x12CB3460, 36963307185559032, 231129534, 231129537, 3, 640x360 
0x12CB3460, 36963307185880488, 231129565, 231129568, 3, 640x360 
0x12CB3460, 36963307186198832, 231129604, 231129607, 3, 640x360 
0x12CB3460, 36963307186518904, 231129635, 231129638, 3, 640x360 
0x12CB3460, 36963307186838752, 231129665, 231129668, 3, 640x360 
0x12CB3460, 36963307187161624, 231129695, 231129699, 4, 640x360 
0x12CB3460, 36963307187483760, 231129725, 231129729, 4, 640x360 
0x12CB3460, 36963307187797928, 231129755, 231129757, 2, 640x360 
0x12CB3460, 36963307188117288, 231129794, 231129796, 2, 640x360 
0x12CB3460, 36963307188438840, 231129824, 231129827, 3, 640x360 
0x12CB3460, 36963307189046296, 231129885, 231129888, 3, 640x360 
0x12CB3460, 36963307189237792, 231129904, 231129911, 7, 640x360 
0x12CB3460, 36963307189556200, 231129934, 231129937, 3, 640x360 
0x12CB3460, 36963307189876160, 231129964, 231129967, 3, 640x360 
0x12CB3460, 36963307190197256, 231129995, 231129998, 3, 640x360 
0x12CB3460, 36963307190517600, 231130025, 231130029, 4, 640x360 
0x12CB3460, 36963307190836240, 231130064, 231130066, 2, 640x360 
0x12CB3460, 36963307191156296, 231130094, 231130098, 4, 640x360 
0x12CB3460, 36963307191477536, 231130124, 231130126, 2, 640x360 
0x12CB3460, 36963307191797800, 231130155, 231130157, 2, 640x360 
0x12CB3460, 36963307192116360, 231130184, 231130188, 4, 640x360 
0x12CB3460, 36963307192597240, 231130234, 231130237, 3, 640x360 
0x12CB3460, 36963307192918368, 231130274, 231130277, 3, 640x360 
0x12CB3460, 36963307193236824, 231130304, 231130306, 2, 640x360 
0x12CB3460, 36963307193557872, 231130336, 231130338, 2, 640x360 
0x12CB3460, 36963307193999424, 231130384, 231130387, 3, 640x360 
0x12CB3460, 36963307194197008, 231130395, 231130398, 3, 640x360 
0x12CB3460, 36963307194517640, 231130434, 231130437, 3, 640x360 
0x12CB3460, 36963307194837760, 231130464, 231130467, 3, 640x360 
0x12CB3460, 36963307195159384, 231130495, 231130498, 3, 640x360 
0x12CB3460, 36963307195478160, 231130524, 231130528, 4, 640x360 
0x12CB3460, 36963307195797696, 231130554, 231130557, 3, 640x360 
0x12CB3460, 36963307196119416, 231130586, 231130590, 4, 640x360 
0x12CB3460, 36963307196600312, 231130635, 231130639, 4, 640x360 
0x12CB3460, 36963307196917296, 231130675, 231130677, 2, 640x360 
0x12CB3460, 36963307197236664, 231130704, 231130707, 3, 640x360 
0x12CB3460, 36963307197557024, 231130734, 231130737, 3, 640x360 
0x12CB3460, 36963307197877856, 231130765, 231130768, 3, 640x360 
0x12CB3460, 36963307198196616, 231130795, 231130797, 2, 640x360 
0x12CB3460, 36963307198518088, 231130835, 231130837, 2, 640x360 
0x12CB3460, 36963307198970704, 231130874, 231130877, 3, 640x360 
0x12CB3460, 36963307199157360, 231130894, 231130897, 3, 640x360 
0x12CB3460, 36963307199477768, 231130924, 231130927, 3, 640x360 
0x12CB3460, 36963307199796448, 231130954, 231130957, 3, 640x360 
0x12CB3460, 36963307200278040, 231131004, 231131007, 3, 640x360 
0x12CB3460, 36963307200598080, 231131034, 231131038, 4, 640x360 
0x12CB3460, 36963307200915792, 231131065, 231131068, 3, 640x360 
0x12CB3460, 36963307201238432, 231131105, 231131107, 2, 640x360 
0x12CB3460, 36963307201557352, 231131134, 231131139, 5, 640x360 
0x12CB3460, 36963307201876744, 231131164, 231131167, 3, 640x360 
0x12CB3460, 36963307202199536, 231131194, 231131198, 4, 640x360 
0x12CB3460, 36963307202516096, 231131235, 231131238, 3, 640x360 
0x12CB3460, 36963307202838528, 231131264, 231131268, 4, 640x360 
0x12CB3460, 36963307203157864, 231131295, 231131297, 2, 640x360 
0x12CB3460, 36963307203476912, 231131324, 231131328, 4, 640x360 
0x12CB3460, 36963307203796656, 231131378, 231131381, 3, 640x360 
0x12CB3460, 36963307204277096, 231131404, 231131406, 2, 640x360 
0x12CB3460, 36963307204597816, 231131434, 231131437, 3, 640x360 
0x12CB3460, 36963307204916648, 231131475, 231131479, 4, 640x360 
0x12CB3460, 36963307205238072, 231131504, 231131507, 3, 640x360 
0x12CB3460, 36963307205557024, 231131534, 231131537, 3, 640x360 
0x12CB3460, 36963307205879416, 231131565, 231131568, 3, 640x360 
0x12CB3460, 36963307206199672, 231131595, 231131598, 3, 640x360 
0x12CB3460, 36963307206516584, 231131634, 231131637, 3, 640x360 
0x12CB3460, 36963307206837488, 231131665, 231131668, 3, 640x360 
0x12CB3460, 36963307207162144, 231131695, 231131698, 3, 640x360 
0x12CB3460, 36963307207479072, 231131724, 231131727, 3, 640x360 
0x12CB3460, 36963307207797544, 231131755, 231131758, 3, 640x360 
0x12CB3460, 36963307208277832, 231131804, 231131807, 3, 640x360 
0x12CB3460, 36963307208598416, 231131833, 231131837, 4, 640x360 
0x12CB3460, 36963307209044840, 231131883, 231131886, 3, 640x360 
0x12CB3460, 36963307209236360, 231131903, 231131906, 3, 640x360 
0x12CB3460, 36963307209561680, 231131934, 231131937, 3, 640x360 
0x12CB3460, 36963307209877352, 231131963, 231131966, 3, 640x360 
0x12CB3460, 36963307210197584, 231131994, 231131997, 3, 640x360 
0x12CB3460, 36963307210517000, 231132034, 231132037, 3, 640x360 
0x12CB3460, 36963307210837584, 231132064, 231132067, 3, 640x360 
0x12CB3460, 36963307211156672, 231132095, 231132103, 8, 640x360 
0x12CB3460, 36963307211477736, 231132124, 231132127, 3, 640x360 
0x12CB3460, 36963307211955720, 231132174, 231132177, 3, 640x360 
0x12CB3460, 36963307212277760, 231132204, 231132207, 3, 640x360 
0x12CB3460, 36963307212597776, 231132234, 231132236, 2, 640x360 
0x12CB3460, 36963307212916384, 231132274, 231132277, 3, 640x360 
0x12CB3460, 36963307213236208, 231132304, 231132307, 3, 640x360 
0x12CB3460, 36963307213556536, 231132334, 231132337, 3, 640x360 
0x12CB3460, 36963307213981112, 231132376, 231132379, 3, 640x360 
0x12CB3460, 36963307214196448, 231132395, 231132413, 18, 640x360 
0x12CB3460, 36963307214516536, 231132425, 231132429, 4, 640x360 
0x12CB3460, 36963307214842688, 231132465, 231132467, 2, 640x360 
0x12CB3460, 36963307215158256, 231132494, 231132497, 3, 640x360 
0x12CB3460, 36963307215477976, 231132524, 231132527, 3, 640x360 
0x12CB3460, 36963307215957520, 231132575, 231132579, 4, 640x360 
0x12CB3460, 36963307216275696, 231132605, 231132607, 2, 640x360 
0x12CB3460, 36963307216597656, 231132634, 231132637, 3, 640x360 
0x12CB3460, 36963307216916312, 231132665, 231132668, 3, 640x360 
0x12CB3460, 36963307217237816, 231132705, 231132708, 3, 640x360 
0x12CB3460, 36963307217557832, 231132735, 231132738, 3, 640x360 
0x12CB3460, 36963307217877232, 231132764, 231132767, 3, 640x360 
0x12CB3460, 36963307218196408, 231132795, 231132797, 2, 640x360 
0x12CB3460, 36963307218517504, 231132834, 231132837, 3, 640x360 
0x12CB3460, 36963307219044464, 231132884, 231132889, 5, 640x360 
0x12CB3460, 36963307219157280, 231132893, 231132896, 3, 640x360 
0x12CB3460, 36963307219476992, 231132924, 231132927, 3, 640x360 
0x12CB3460, 36963307219955568, 231132974, 231132977, 3, 640x360 
0x12CB3460, 36963307220277312, 231133004, 231133006, 2, 640x360 
0x12CB3460, 36963307220598000, 231133035, 231133038, 3, 640x360 
0x12CB3460, 36963307220918520, 231133075, 231133077, 2, 640x360 
0x12CB3460, 36963307221236048, 231133103, 231133109, 6, 640x360 
0x12CB3460, 36963307221558000, 231133135, 231133138, 3, 640x360 
0x12CB3460, 36963307221877024, 231133165, 231133168, 3, 640x360 
0x12CB3460, 36963307222197552, 231133195, 231133198, 3, 640x360 
0x12CB3460, 36963307222517264, 231133234, 231133236, 2, 640x360 
0x12CB3460, 36963307222841640, 231133265, 231133268, 3, 640x360 
0x12CB3460, 36963307223158328, 231133294, 231133296, 2, 640x360 
0x12CB3460, 36963307223638648, 231133344, 231133347, 3, 640x360 
0x12CB3460, 36963307224089112, 231133384, 231133387, 3, 640x360 
0x12CB3460, 36963307224276920, 231133404, 231133410, 6, 640x360 
0x12CB3460, 36963307224595928, 231133435, 231133438, 3, 640x360 
0x12CB3460, 36963307224916288, 231133475, 231133478, 3, 640x360 
0x12CB3460, 36963307225238064, 231133505, 231133507, 2, 640x360 
0x12CB3460, 36963307225558744, 231133535, 231133537, 2, 640x360 
0x12CB3460, 36963307225877808, 231133566, 231133569, 3, 640x360 
0x12CB3460, 36963307226197280, 231133597, 231133602, 5, 640x360 
0x12CB3460, 36963307226517200, 231133625, 231133629, 4, 640x360 
0x12CB3460, 36963307226837816, 231133665, 231133668, 3, 640x360 
0x12CB3460, 36963307227159880, 231133694, 231133697, 3, 640x360 
0x12CB3460, 36963307227636808, 231133745, 231133748, 3, 640x360 
0x12CB3460, 36963307227957312, 231133775, 231133778, 3, 640x360 
0x12CB3460, 36963307228276896, 231133804, 231133806, 2, 640x360 
0x12CB3460, 36963307228596392, 231133834, 231133838, 4, 640x360 
0x12CB3460, 36963307229004440, 231133875, 231133879, 4, 640x360 
0x12CB3460, 36963307229237464, 231133904, 231133907, 3, 640x360 
0x12CB3460, 36963307229556224, 231133935, 231133937, 2, 640x360 
0x12CB3460, 36963307229877064, 231133964, 231133967, 3, 640x360 
0x12CB3460, 36963307230197480, 231133995, 231133997, 2, 640x360 
0x12CB3460, 36963307230517488, 231134034, 231134037, 3, 640x360 
0x12CB3460, 36963307230837472, 231134064, 231134067, 3, 640x360 
0x12CB3460, 36963307231317864, 231134115, 231134118, 3, 640x360 
0x12CB3460, 36963307231636040, 231134144, 231134147, 3, 640x360 
0x12CB3460, 36963307231957840, 231134174, 231134177, 3, 640x360 
0x12CB3460, 36963307232278632, 231134205, 231134208, 3, 640x360 
0x12CB3460, 36963307232596800, 231134234, 231134237, 3, 640x360 
0x12CB3460, 36963307232916160, 231134275, 231134278, 3, 640x360 
0x12CB3460, 36963307233238176, 231134304, 231134307, 3, 640x360 
0x12CB3460, 36963307233557352, 231134334, 231134337, 3, 640x360 
0x12CB3460, 36963307234065248, 231134384, 231134387, 3, 640x360 
0x12CB3460, 36963307234196544, 231134394, 231134397, 3, 640x360 
0x12CB3460, 36963307234517344, 231134435, 231134438, 3, 640x360 
0x12CB3460, 36963307234837896, 231134465, 231134468, 3, 640x360 
0x12CB3460, 36963307235317640, 231134515, 231134518, 3, 640x360 
0x12CB3460, 36963307235637232, 231134546, 231134549, 3, 640x360 
0x12CB3460, 36963307235960016, 231134574, 231134577, 3, 640x360 
0x12CB3460, 36963307236277856, 231134603, 231134613, 10, 640x360 
0x12CB3460, 36963307236597456, 231134635, 231134637, 2, 640x360 
0x12CB3460, 36963307236916440, 231134674, 231134677, 3, 640x360 
0x12CB3460, 36963307237237664, 231134704, 231134707, 3, 640x360 
0x12CB3460, 36963307237555824, 231134733, 231134736, 3, 640x360 
0x12CB3460, 36963307237876800, 231134765, 231134771, 6, 640x360 
0x12CB3460, 36963307238198632, 231134794, 231134797, 3, 640x360 
0x12CB3460, 36963307238517352, 231134833, 231134840, 7, 640x360 
0x12CB3460, 36963307239035952, 231134884, 231134888, 4, 640x360 
0x12CB3460, 36963307239317272, 231134905, 231134909, 4, 640x360 
0x12CB3460, 36963307239636312, 231134944, 231134950, 6, 640x360 
0x12CB3460, 36963307239957160, 231134973, 231134976, 3, 640x360 
0x12CB3460, 36963307240277784, 231135004, 231135007, 3, 640x360 
0x12CB3460, 36963307240599056, 231135045, 231135066, 21, 640x360 
0x12CB3460, 36963307240916832, 231135067, 231135080, 13, 640x360 
0x12CB3460, 36963307241236744, 231135104, 231135107, 3, 640x360 
0x12CB3460, 36963307241556160, 231135135, 231135137, 2, 640x360 
0x12CB3460, 36963307241878064, 231135164, 231135167, 3, 640x360 
0x12CB3460, 36963307242198616, 231135195, 231135198, 3, 640x360 
0x12CB3460, 36963307242519544, 231135234, 231135236, 2, 640x360 
0x12CB3460, 36963307242997288, 231135274, 231135279, 5, 640x360 
0x12CB3460, 36963307243317600, 231135314, 231135317, 3, 640x360 
0x12CB3460, 36963307243638088, 231135345, 231135377, 32, 640x360 
0x12CB3460, 36963307244053192, 231135385, 231135388, 3, 640x360 
0x12CB3460, 36963307244275792, 231135405, 231135407, 2, 640x360 
0x12CB3460, 36963307244597392, 231135434, 231135437, 3, 640x360 
0x12CB3460, 36963307244918112, 231135475, 231135479, 4, 640x360 
0x12CB3460, 36963307245236304, 231135504, 231135507, 3, 640x360 
0x12CB3460, 36963307245558104, 231135534, 231135537, 3, 640x360 
0x12CB3460, 36963307245877360, 231135564, 231135567, 3, 640x360 
0x12CB3460, 36963307246199856, 231135597, 231135601, 4, 640x360 
0x12CB3460, 36963307246517840, 231135634, 231135637, 3, 640x360 
0x12CB3460, 36963307246999040, 231135675, 231135678, 3, 640x360 
0x12CB3460, 36963307247318840, 231135714, 231135717, 3, 640x360 
0x12CB3460, 36963307247637536, 231135744, 231135748, 4, 640x360 
0x12CB3460, 36963307247957192, 231135774, 231135777, 3, 640x360 
0x12CB3460, 36963307248275688, 231135804, 231135807, 3, 640x360 
0x12CB3460, 36963307248596864, 231135835, 231135838, 3, 640x360 
0x12CB3460, 36963307249062528, 231135885, 231135888, 3, 640x360 
0x12CB3460, 36963307249235944, 231135904, 231135906, 2, 640x360 
0x12CB3460, 36963307249557416, 231135935, 231135938, 3, 640x360 
0x12CB3460, 36963307249875768, 231135964, 231135968, 4, 640x360 
0x12CB3460, 36963307250197256, 231135994, 231135997, 3, 640x360 
0x12CB3460, 36963307250517632, 231136034, 231136037, 3, 640x360 
0x12CB3460, 36963307250997944, 231136075, 231136078, 3, 640x360 
0x12CB3460, 36963307251317248, 231136105, 231136109, 4, 640x360 
0x12CB3460, 36963307251635528, 231136144, 231136147, 3, 640x360 
0x12CB3460, 36963307251957368, 231136174, 231136177, 3, 640x360 
0x12CB3460, 36963307252277976, 231136204, 231136207, 3, 640x360 
0x12CB3460, 36963307252597864, 231136235, 231136238, 3, 640x360 
0x12CB3460, 36963307252918392, 231136275, 231136281, 6, 640x360 
0x12CB3460, 36963307253236376, 231136304, 231136306, 2, 640x360 
0x12CB3460, 36963307253556960, 231136334, 231136337, 3, 640x360 
0x12CB3460, 36963307254047752, 231136384, 231136387, 3, 640x360 
0x12CB3460, 36963307254197080, 231136395, 231136398, 3, 640x360 
0x12CB3460, 36963307254677376, 231136445, 231136448, 3, 640x360 
0x12CB3460, 36963307254997248, 231136474, 231136477, 3, 640x360 
0x12CB3460, 36963307255317768, 231136514, 231136517, 3, 640x360 
0x12CB3460, 36963307255636704, 231136545, 231136547, 2, 640x360 
0x12CB3460, 36963307255959800, 231136574, 231136578, 4, 640x360 
0x12CB3460, 36963307256288608, 231136604, 231136612, 8, 640x360 
0x12CB3460, 36963307256596560, 231136635, 231136638, 3, 640x360 
0x12CB3460, 36963307256917984, 231136674, 231136677, 3, 640x360 
0x12CB3460, 36963307257236504, 231136704, 231136707, 3, 640x360 
0x12CB3460, 36963307257557496, 231136735, 231136738, 3, 640x360 
0x12CB3460, 36963307257876656, 231136764, 231136766, 2, 640x360 
0x12CB3460, 36963307258203824, 231136795, 231136800, 5, 640x360 
0x12CB3460, 36963307258677632, 231136845, 231136875, 30, 640x360 
0x12CB3460, 36963307259018592, 231136884, 231136887, 3, 640x360 
0x12CB3460, 36963307259315776, 231136914, 231136932, 18, 640x360 
0x12CB3460, 36963307259636232, 231136944, 231136947, 3, 640x360 
0x12CB3460, 36963307259957032, 231136974, 231136977, 3, 640x360 
0x12CB3460, 36963307260277760, 231137004, 231137007, 3, 640x360 
0x12CB3460, 36963307260598232, 231137035, 231137038, 3, 640x360 
0x12CB3460, 36963307260915928, 231137074, 231137076, 2, 640x360 
0x12CB3460, 36963307261237312, 231137104, 231137107, 3, 640x360 
0x12CB3460, 36963307261557120, 231137134, 231137141, 7, 640x360 
0x12CB3460, 36963307261876392, 231137166, 231137169, 3, 640x360 
0x12CB3460, 36963307262196776, 231137195, 231137197, 2, 640x360 
0x12CB3460, 36963307262677152, 231137245, 231137247, 2, 640x360 
0x12CB3460, 36963307263002744, 231137275, 231137279, 4, 640x360 
0x12CB3460, 36963307263315736, 231137305, 231137308, 3, 640x360 
0x12CB3460, 36963307263636568, 231137345, 231137347, 2, 640x360 
0x12CB3460, 36963307264097568, 231137385, 231137389, 4, 640x360 
0x12CB3460, 36963307264276656, 231137404, 231137407, 3, 640x360 
0x12CB3460, 36963307264596048, 231137435, 231137442, 7, 640x360 
0x12CB3460, 36963307264915992, 231137474, 231137477, 3, 640x360 
0x12CB3460, 36963307265238336, 231137503, 231137506, 3, 640x360 
0x12CB3460, 36963307265558568, 231137534, 231137537, 3, 640x360 
0x12CB3460, 36963307265879040, 231137565, 231137567, 2, 640x360 
0x12CB3460, 36963307266357288, 231137614, 231137617, 3, 640x360 
0x12CB3460, 36963307266676048, 231137645, 231137647, 2, 640x360 
0x12CB3460, 36963307266996992, 231137674, 231137678, 4, 640x360 
0x12CB3460, 36963307267318488, 231137715, 231137718, 3, 640x360 
0x12CB3460, 36963307267635832, 231137744, 231137762, 18, 640x360 
0x12CB3460, 36963307267957224, 231137775, 231137787, 12, 640x360 
0x12CB3460, 36963307268276656, 231137804, 231137806, 2, 640x360 
0x12CB3460, 36963307268597112, 231137834, 231137837, 3, 640x360 
0x12CB3460, 36963307269000192, 231137875, 231137879, 4, 640x360 
0x12CB3460, 36963307269236904, 231137904, 231137907, 3, 640x360 
0x12CB3460, 36963307269556208, 231137933, 231137937, 4, 640x360 
0x12CB3460, 36963307269876576, 231137964, 231137967, 3, 640x360 
0x12CB3460, 36963307270355648, 231138015, 231138018, 3, 640x360 
0x12CB3460, 36963307270677744, 231138044, 231138047, 3, 640x360 
0x12CB3460, 36963307270997424, 231138075, 231138077, 2, 640x360 
0x12CB3460, 36963307271317472, 231138115, 231138118, 3, 640x360 
0x12CB3460, 36963307271636480, 231138144, 231138147, 3, 640x360 
0x12CB3460, 36963307271957992, 231138175, 231138190, 15, 640x360 
0x12CB3460, 36963307272278408, 231138204, 231138207, 3, 640x360 
0x12CB3460, 36963307272596672, 231138234, 231138238, 4, 640x360 
0x12CB3460, 36963307272918432, 231138274, 231138277, 3, 640x360 
0x12CB3460, 36963307273238176, 231138305, 231138309, 4, 640x360 
0x12CB3460, 36963307273556480, 231138334, 231138337, 3, 640x360 
0x12CB3460, 36963307274036712, 231138384, 231138386, 2, 640x360 
0x12CB3460, 36963307274357280, 231138414, 231138417, 3, 640x360 
0x12CB3460, 36963307274678472, 231138444, 231138447, 3, 640x360 
0x12CB3460, 36963307274997168, 231138475, 231138477, 2, 640x360 
0x12CB3460, 36963307275317720, 231138515, 231138518, 3, 640x360 
0x12CB3460, 36963307275636848, 231138545, 231138548, 3, 640x360 
0x12CB3460, 36963307275959560, 231138576, 231138579, 3, 640x360 
0x12CB3460, 36963307276281936, 231138605, 231138608, 3, 640x360 
0x12CB3460, 36963307276596832, 231138635, 231138638, 3, 640x360 
0x12CB3460, 36963307276918104, 231138674, 231138677, 3, 640x360 
0x12CB3460, 36963307277237872, 231138704, 231138708, 4, 640x360 
0x12CB3460, 36963307277556560, 231138734, 231138737, 3, 640x360 
0x12CB3460, 36963307278035208, 231138784, 231138786, 2, 640x360 
0x12CB3460, 36963307278358120, 231138814, 231138817, 3, 640x360 
0x12CB3460, 36963307278677176, 231138844, 231138846, 2, 640x360 
0x12CB3460, 36963307279016832, 231138875, 231138878, 3, 640x360 
0x12CB3460, 36963307279316856, 231138905, 231138908, 3, 640x360 
0x12CB3460, 36963307279636744, 231138945, 231138950, 5, 640x360 
0x12CB3460, 36963307279956080, 231138974, 231138977, 3, 640x360 
0x12CB3460, 36963307280276624, 231139004, 231139007, 3, 640x360 
0x12CB3460, 36963307280596120, 231139034, 231139037, 3, 640x360 
0x12CB3460, 36963307280915760, 231139065, 231139068, 3, 640x360 
0x12CB3460, 36963307281236752, 231139104, 231139107, 3, 640x360 
0x12CB3460, 36963307281557120, 231139133, 231139136, 3, 640x360 
0x12CB3460, 36963307282037864, 231139184, 231139188, 4, 640x360 
0x12CB3460, 36963307282357656, 231139215, 231139218, 3, 640x360 
0x12CB3460, 36963307282676176, 231139244, 231139247, 3, 640x360 
0x12CB3460, 36963307282998208, 231139274, 231139278, 4, 640x360 
0x12CB3460, 36963307283315520, 231139305, 231139308, 3, 640x360 
0x12CB3460, 36963307283636008, 231139345, 231139347, 2, 640x360 
0x12CB3460, 36963307284045184, 231139384, 231139387, 3, 640x360 
0x12CB3460, 36963307284275824, 231139404, 231139407, 3, 640x360 
0x12CB3460, 36963307284597248, 231139434, 231139437, 3, 640x360 
0x12CB3460, 36963307284916544, 231139474, 231139478, 4, 640x360 
0x12CB3460, 36963307285236312, 231139505, 231139507, 2, 640x360 
0x12CB3460, 36963307285717688, 231139555, 231139558, 3, 640x360 
0x12CB3460, 36963307286036400, 231139585, 231139589, 4, 640x360 
0x12CB3460, 36963307286361040, 231139614, 231139617, 3, 640x360 
0x12CB3460, 36963307286676896, 231139645, 231139648, 3, 640x360 
0x12CB3460, 36963307286999600, 231139674, 231139678, 4, 640x360 
0x12CB3460, 36963307287319480, 231139715, 231139718, 3, 640x360 
0x12CB3460, 36963307287636248, 231139744, 231139747, 3, 640x360 
0x12CB3460, 36963307287956952, 231139776, 231139782, 6, 640x360 
0x12CB3460, 36963307288278016, 231139805, 231139808, 3, 640x360 
0x12CB3460, 36963307288596960, 231139834, 231139837, 3, 640x360 
0x12CB3460, 36963307289017392, 231139885, 231139887, 2, 640x360 
0x12CB3460, 36963307289236200, 231139904, 231139907, 3, 640x360 
0x12CB3460, 36963307289716760, 231139945, 231139948, 3, 640x360 
0x12CB3460, 36963307290035304, 231139983, 231139989, 6, 640x360 
0x12CB3460, 36963307290356992, 231140014, 231140017, 3, 640x360 
0x12CB3460, 36963307290676376, 231140044, 231140047, 3, 640x360 
0x12CB3460, 36963307290996120, 231140075, 231140079, 4, 640x360 
0x12CB3460, 36963307291315408, 231140114, 231140120, 6, 640x360 
0x12CB3460, 36963307291635960, 231140144, 231140147, 3, 640x360 
0x12CB3460, 36963307291958144, 231140175, 231140177, 2, 640x360 
0x12CB3460, 36963307292276728, 231140204, 231140207, 3, 640x360 
0x12CB3460, 36963307292595992, 231140234, 231140238, 4, 640x360 
0x12CB3460, 36963307292916744, 231140264, 231140268, 4, 640x360 
0x12CB3460, 36963307293236528, 231140305, 231140308, 3, 640x360 
0x12CB3460, 36963307293716392, 231140386, 231140389, 3, 640x360 
0x12CB3460, 36963307294147408, 231140396, 231140399, 3, 640x360 
0x12CB3460, 36963307294355256, 231140415, 231140418, 3, 640x360 
0x12CB3460, 36963307294680656, 231140444, 231140447, 3, 640x360 
0x12CB3460, 36963307294995728, 231140474, 231140477, 3, 640x360 
0x12CB3460, 36963307295316064, 231140514, 231140517, 3, 640x360 
0x12CB3460, 36963307295635744, 231140544, 231140547, 3, 640x360 
0x12CB3460, 36963307295956040, 231140573, 231140576, 3, 640x360 
0x12CB3460, 36963307296276208, 231140604, 231140607, 3, 640x360 
0x12CB3460, 36963307296598296, 231140635, 231140637, 2, 640x360 
0x12CB3460, 36963307296916248, 231140674, 231140677, 3, 640x360 
0x12CB3460, 36963307297397352, 231140715, 231140718, 3, 640x360 
0x12CB3460, 36963307297714920, 231140744, 231140747, 3, 640x360 
0x12CB3460, 36963307298035864, 231140784, 231140787, 3, 640x360 
0x12CB3460, 36963307298356272, 231140813, 231140817, 4, 640x360 
0x12CB3460, 36963307298677176, 231140844, 231140847, 3, 640x360 
0x12CB3460, 36963307299046808, 231140885, 231140888, 3, 640x360 
0x12CB3460, 36963307299315792, 231140905, 231140908, 3, 640x360 
0x12CB3460, 36963307299637568, 231140944, 231140947, 3, 640x360 
0x12CB3460, 36963307299956616, 231140975, 231140981, 6, 640x360 
0x12CB3460, 36963307300277064, 231141004, 231141006, 2, 640x360 
0x12CB3460, 36963307300596960, 231141035, 231141038, 3, 640x360 
0x12CB3460, 36963307300915832, 231141064, 231141068, 4, 640x360 
0x12CB3460, 36963307301395648, 231141115, 231141118, 3, 640x360 
0x12CB3460, 36963307301715208, 231141145, 231141148, 3, 640x360 
0x12CB3460, 36963307302037688, 231141184, 231141187, 3, 640x360 
0x12CB3460, 36963307302358288, 231141215, 231141218, 3, 640x360 
0x12CB3460, 36963307302675320, 231141244, 231141247, 3, 640x360 
0x12CB3460, 36963307302995864, 231141275, 231141278, 3, 640x360 
0x12CB3460, 36963307303316224, 231141315, 231141318, 3, 640x360 
0x12CB3460, 36963307303636712, 231141344, 231141373, 29, 640x360 
0x12CB3460, 36963307304003816, 231141384, 231141387, 3, 640x360 
0x12CB3460, 36963307304275480, 231141404, 231141407, 3, 640x360 
0x12CB3460, 36963307304597008, 231141434, 231141437, 3, 640x360 
0x12CB3460, 36963307304918872, 231141474, 231141490, 16, 640x360 
0x12CB3460, 36963307305397136, 231141514, 231141517, 3, 640x360 
0x12CB3460, 36963307305715960, 231141545, 231141548, 3, 640x360 
0x12CB3460, 36963307306038952, 231141585, 231141588, 3, 640x360 
0x12CB3460, 36963307306359600, 231141615, 231141618, 3, 640x360 
0x12CB3460, 36963307306676112, 231141644, 231141647, 3, 640x360 
0x12CB3460, 36963307306996792, 231141675, 231141677, 2, 640x360 
0x12CB3460, 36963307307317184, 231141714, 231141717, 3, 640x360 
0x12CB3460, 36963307307635704, 231141744, 231141746, 2, 640x360 
0x12CB3460, 36963307307956056, 231141773, 231141777, 4, 640x360 
0x12CB3460, 36963307308275816, 231141804, 231141806, 2, 640x360 
0x12CB3460, 36963307308597176, 231141833, 231141836, 3, 640x360 
0x12CB3460, 36963307309075248, 231141884, 231141887, 3, 640x360 
0x12CB3460, 36963307309396472, 231141914, 231141917, 3, 640x360 
0x12CB3460, 36963307309714912, 231141954, 231141957, 3, 640x360 
0x12CB3460, 36963307310035104, 231141983, 231141986, 3, 640x360 
0x12CB3460, 36963307310358392, 231142015, 231142018, 3, 640x360 
0x12CB3460, 36963307310676496, 231142044, 231142046, 2, 640x360 
0x12CB3460, 36963307310995584, 231142075, 231142078, 3, 640x360 
0x12CB3460, 36963307311321672, 231142114, 231142116, 2, 640x360 
0x12CB3460, 36963307311635416, 231142144, 231142146, 2, 640x360 
0x12CB3460, 36963307311956784, 231142173, 231142176, 3, 640x360 
0x12CB3460, 36963307312276496, 231142204, 231142207, 3, 640x360 
0x12CB3460, 36963307312597696, 231142234, 231142237, 3, 640x360 
0x12CB3460, 36963307313076480, 231142285, 231142288, 3, 640x360 
0x12CB3460, 36963307313396928, 231142314, 231142317, 3, 640x360 
0x12CB3460, 36963307313715608, 231142345, 231142348, 3, 640x360 
0x12CB3460, 36963307314056832, 231142385, 231142387, 2, 640x360 
0x12CB3460, 36963307314355408, 231142415, 231142417, 2, 640x360 
0x12CB3460, 36963307314675864, 231142445, 231142448, 3, 640x360 
0x12CB3460, 36963307314997536, 231142475, 231142479, 4, 640x360 
0x12CB3460, 36963307315316848, 231142515, 231142517, 2, 640x360 
0x12CB3460, 36963307315637016, 231142544, 231142547, 3, 640x360 
0x12CB3460, 36963307315959000, 231142575, 231142578, 3, 640x360 
0x12CB3460, 36963307316276728, 231142604, 231142607, 3, 640x360 
0x12CB3460, 36963307316757832, 231142655, 231142657, 2, 640x360 
0x12CB3460, 36963307317078584, 231142684, 231142687, 3, 640x360 
0x12CB3460, 36963307317396096, 231142714, 231142718, 4, 640x360 
0x12CB3460, 36963307317715280, 231142744, 231142748, 4, 640x360 
0x12CB3460, 36963307318034992, 231142784, 231142787, 3, 640x360 
0x12CB3460, 36963307318355432, 231142814, 231142817, 3, 640x360 
0x12CB3460, 36963307318676776, 231142844, 231142870, 26, 640x360 
0x12CB3460, 36963307318996256, 231142875, 231142878, 3, 640x360 
0x12CB3460, 36963307319315424, 231142905, 231142908, 3, 640x360 
0x12CB3460, 36963307319637032, 231142944, 231142952, 8, 640x360 
0x12CB3460, 36963307319956608, 231142974, 231142976, 2, 640x360 
0x12CB3460, 36963307320277232, 231143004, 231143007, 3, 640x360 
0x12CB3460, 36963307320759640, 231143055, 231143057, 2, 640x360 
0x12CB3460, 36963307321075144, 231143084, 231143087, 3, 640x360 
0x12CB3460, 36963307321395440, 231143116, 231143119, 3, 640x360 
0x12CB3460, 36963307321715552, 231143154, 231143165, 11, 640x360 
0x12CB3460, 36963307322036272, 231143184, 231143187, 3, 640x360 
0x12CB3460, 36963307322359912, 231143224, 231143227, 3, 640x360 
0x12CB3460, 36963307322677672, 231143244, 231143247, 3, 640x360 
0x12CB3460, 36963307322996704, 231143274, 231143277, 3, 640x360 
0x12CB3460, 36963307323315408, 231143314, 231143318, 4, 640x360 
0x12CB3460, 36963307323635904, 231143345, 231143347, 2, 640x360 
0x12CB3460, 36963307324053688, 231143384, 231143386, 2, 640x360 
0x12CB3460, 36963307324276376, 231143403, 231143406, 3, 640x360 
0x12CB3460, 36963307324755616, 231143455, 231143458, 3, 640x360 
0x12CB3460, 36963307325079832, 231143484, 231143487, 3, 640x360 
0x12CB3460, 36963307325396776, 231143514, 231143517, 3, 640x360 
0x12CB3460, 36963307325715208, 231143545, 231143549, 4, 640x360 
0x12CB3460, 36963307326037272, 231143585, 231143588, 3, 640x360 
0x12CB3460, 36963307326360072, 231143615, 231143633, 18, 640x360 
0x12CB3460, 36963307326677064, 231143644, 231143647, 3, 640x360 
0x12CB3460, 36963307326997168, 231143685, 231143689, 4, 640x360 
0x12CB3460, 36963307327319360, 231143715, 231143733, 18, 640x360 
0x12CB3460, 36963307327635832, 231143745, 231143748, 3, 640x360 
0x12CB3460, 36963307327956976, 231143775, 231143778, 3, 640x360 
0x12CB3460, 36963307328436640, 231143825, 231143827, 2, 640x360 
0x12CB3460, 36963307328757056, 231143878, 231143882, 4, 640x360 
0x12CB3460, 36963307329076712, 231143885, 231143888, 3, 640x360 
0x12CB3460, 36963307329396416, 231143915, 231143918, 3, 640x360 
0x12CB3460, 36963307329716640, 231143945, 231143948, 3, 640x360 
0x12CB3460, 36963307330036584, 231143984, 231143987, 3, 640x360 
0x12CB3460, 36963307330356376, 231144014, 231144017, 3, 640x360 
0x12CB3460, 36963307330676184, 231144044, 231144047, 3, 640x360 
0x12CB3460, 36963307330999016, 231144075, 231144079, 4, 640x360 
0x12CB3460, 36963307331315168, 231144115, 231144117, 2, 640x360 
0x12CB3460, 36963307331634984, 231144144, 231144162, 18, 640x360 
0x12CB3460, 36963307331956776, 231144175, 231144178, 3, 640x360 
0x12CB3460, 36963307332436112, 231144225, 231144228, 3, 640x360 
0x12CB3460, 36963307332756880, 231144255, 231144258, 3, 640x360 
0x12CB3460, 36963307333075440, 231144284, 231144289, 5, 640x360 
0x12CB3460, 36963307333394696, 231144315, 231144319, 4, 640x360 
0x12CB3460, 36963307333717136, 231144375, 231144380, 5, 640x360 
0x12CB3460, 36963307334058864, 231144385, 231144388, 3, 640x360 
0x12CB3460, 36963307334356192, 231144414, 231144417, 3, 640x360 
0x12CB3460, 36963307334676208, 231144444, 231144447, 3, 640x360 
0x12CB3460, 36963307334995360, 231144475, 231144482, 7, 640x360 
0x12CB3460, 36963307335315264, 231144514, 231144517, 3, 640x360 
0x12CB3460, 36963307335636064, 231144544, 231144547, 3, 640x360 
0x12CB3460, 36963307335956416, 231144574, 231144577, 3, 640x360 
0x12CB3460, 36963307336436296, 231144624, 231144626, 2, 640x360 
0x12CB3460, 36963307336756496, 231144654, 231144657, 3, 640x360 
0x12CB3460, 36963307337077456, 231144684, 231144687, 3, 640x360 
0x12CB3460, 36963307337398608, 231144724, 231144728, 4, 640x360 
0x12CB3460, 36963307337714792, 231144745, 231144749, 4, 640x360 
0x12CB3460, 36963307338036072, 231144785, 231144789, 4, 640x360 
0x12CB3460, 36963307338355776, 231144814, 231144820, 6, 640x360 
0x12CB3460, 36963307338674672, 231144845, 231144848, 3, 640x360 
0x12CB3460, 36963307339076640, 231144885, 231144888, 3, 640x360 
0x12CB3460, 36963307339316304, 231144914, 231144917, 3, 640x360 
0x12CB3460, 36963307339637176, 231144944, 231144947, 3, 640x360 
0x12CB3460, 36963307340117672, 231144985, 231144988, 3, 640x360 
0x12CB3460, 36963307340436224, 231145024, 231145027, 3, 640x360 
0x12CB3460, 36963307340758688, 231145055, 231145058, 3, 640x360 
0x12CB3460, 36963307341074616, 231145084, 231145087, 3, 640x360 
0x12CB3460, 36963307341395672, 231145115, 231145118, 3, 640x360 
0x12CB3460, 36963307341716464, 231145154, 231145157, 3, 640x360 
0x12CB3460, 36963307342037288, 231145184, 231145187, 3, 640x360 
0x12CB3460, 36963307342356976, 231145215, 231145218, 3, 640x360 
0x12CB3460, 36963307342677600, 231145244, 231145247, 3, 640x360 
0x12CB3460, 36963307342998624, 231145276, 231145279, 3, 640x360 
0x12CB3460, 36963307343316048, 231145305, 231145309, 4, 640x360 
0x12CB3460, 36963307343637072, 231145369, 231145371, 2, 640x360 
0x12CB3460, 36963307344115528, 231145394, 231145397, 3, 640x360 
0x12CB3460, 36963307344435480, 231145424, 231145427, 3, 640x360 
0x12CB3460, 36963307344757120, 231145455, 231145458, 3, 640x360 
0x12CB3460, 36963307345074856, 231145484, 231145487, 3, 640x360 
0x12CB3460, 36963307345395704, 231145516, 231145519, 3, 640x360 
0x12CB3460, 36963307345715624, 231145545, 231145549, 4, 640x360 
0x12CB3460, 36963307346037496, 231145585, 231145588, 3, 640x360 
0x12CB3460, 36963307346356680, 231145614, 231145617, 3, 640x360 
0x12CB3460, 36963307346676104, 231145644, 231145646, 2, 640x360 
0x12CB3460, 36963307346999696, 231145675, 231145678, 3, 640x360 
0x12CB3460, 36963307347317768, 231145715, 231145718, 3, 640x360 
0x12CB3460, 36963307347794624, 231145755, 231145758, 3, 640x360 
0x12CB3460, 36963307348118232, 231145794, 231145797, 3, 640x360 
0x12CB3460, 36963307348437240, 231145824, 231145826, 2, 640x360 
0x12CB3460, 36963307348762680, 231145886, 231145892, 6, 640x360 
0x12CB3460, 36963307349395072, 231145916, 231145921, 5, 640x360 
0x12CB3460, 36963307349716208, 231145945, 231145948, 3, 640x360 
0x12CB3460, 36963307350035624, 231145985, 231145987, 2, 640x360 
0x12CB3460, 36963307350355352, 231146014, 231146022, 8, 640x360 
0x12CB3460, 36963307350676536, 231146046, 231146049, 3, 640x360 
0x12CB3460, 36963307350998456, 231146075, 231146077, 2, 640x360 
0x12CB3460, 36963307351316728, 231146115, 231146120, 5, 640x360 
0x12CB3460, 36963307351796072, 231146155, 231146157, 2, 640x360 
0x12CB3460, 36963307352116176, 231146194, 231146197, 3, 640x360 
0x12CB3460, 36963307352435200, 231146224, 231146226, 2, 640x360 
0x12CB3460, 36963307352754496, 231146255, 231146258, 3, 640x360 
0x12CB3460, 36963307353078576, 231146285, 231146289, 4, 640x360 
0x12CB3460, 36963307353395568, 231146314, 231146317, 3, 640x360 
0x12CB3460, 36963307353715648, 231146345, 231146349, 4, 640x360 
0x12CB3460, 36963307354096048, 231146384, 231146388, 4, 640x360 
0x12CB3460, 36963307354355008, 231146414, 231146417, 3, 640x360 
0x12CB3460, 36963307354675448, 231146445, 231146448, 3, 640x360 
0x12CB3460, 36963307354996704, 231146475, 231146477, 2, 640x360 
0x12CB3460, 36963307355314856, 231146505, 231146509, 4, 640x360 
0x12CB3460, 36963307355796552, 231146555, 231146558, 3, 640x360 
0x12CB3460, 36963307356116928, 231146594, 231146597, 3, 640x360 
0x12CB3460, 36963307356462232, 231146624, 231146627, 3, 640x360 
0x12CB3460, 36963307356755672, 231146654, 231146657, 3, 640x360 
0x12CB3460, 36963307357076200, 231146683, 231146686, 3, 640x360 
0x12CB3460, 36963307357396336, 231146715, 231146719, 4, 640x360 
0x12CB3460, 36963307357714600, 231146755, 231146757, 2, 640x360 
0x12CB3460, 36963307358037096, 231146784, 231146787, 3, 640x360 
0x12CB3460, 36963307358355776, 231146813, 231146818, 5, 640x360 
0x12CB3460, 36963307358675376, 231146844, 231146847, 3, 640x360 
0x12CB3460, 36963307359067488, 231146885, 231146888, 3, 640x360 
0x12CB3460, 36963307359474024, 231146924, 231146927, 3, 640x360 
0x12CB3460, 36963307359795944, 231146955, 231146958, 3, 640x360 
0x12CB3460, 36963307360114512, 231146995, 231146997, 2, 640x360 
0x12CB3460, 36963307360434664, 231147024, 231147027, 3, 640x360 
0x12CB3460, 36963307360754936, 231147054, 231147057, 3, 640x360 
0x12CB3460, 36963307361075960, 231147083, 231147086, 3, 640x360 
0x12CB3460, 36963307361396696, 231147115, 231147118, 3, 640x360 
0x12CB3460, 36963307361715704, 231147154, 231147157, 3, 640x360 
0x12CB3460, 36963307362034848, 231147184, 231147187, 3, 640x360 
0x12CB3460, 36963307362355832, 231147215, 231147218, 3, 640x360 
0x12CB3460, 36963307362675480, 231147244, 231147246, 2, 640x360 
0x12CB3460, 36963307362997464, 231147275, 231147279, 4, 640x360 
0x12CB3460, 36963307363476144, 231147324, 231147327, 3, 640x360 
0x12CB3460, 36963307364092072, 231147385, 231147397, 12, 640x360 
0x12CB3460, 36963307364121832, 231147398, 231147412, 14, 640x360 
0x12CB3460, 36963307364435968, 231147426, 231147432, 6, 640x360 
0x12CB3460, 36963307365076024, 231147485, 231147494, 9, 640x360 
0x12CB3460, 36963307365395896, 231147514, 231147519, 5, 640x360 
0x12CB3460, 36963307365714736, 231147555, 231147557, 2, 640x360 
0x12CB3460, 36963307366035384, 231147586, 231147605, 19, 640x360 
0x12CB3460, 36963307366360464, 231147617, 231147625, 8, 640x360 
0x12CB3460, 36963307366675104, 231147644, 231147648, 4, 640x360 
0x12CB3460, 36963307366996032, 231147674, 231147683, 9, 640x360 
0x12CB3460, 36963307367475112, 231147724, 231147727, 3, 640x360 
0x12CB3460, 36963307367795992, 231147754, 231147756, 2, 640x360 
0x12CB3460, 36963307368116312, 231147794, 231147797, 3, 640x360 
0x12CB3460, 36963307368434752, 231147824, 231147841, 17, 640x360 
0x12CB3460, 36963307368756616, 231147880, 231147885, 5, 640x360 
0x12CB3460, 36963307369395624, 231147915, 231147918, 3, 640x360 
0x12CB3460, 36963307369714536, 231147955, 231147958, 3, 640x360 
0x12CB3460, 36963307370035288, 231147984, 231147986, 2, 640x360 
0x12CB3460, 36963307370355832, 231148015, 231148018, 3, 640x360 
0x12CB3460, 36963307370676384, 231148045, 231148048, 3, 640x360 
0x12CB3460, 36963307371154496, 231148094, 231148097, 3, 640x360 
0x12CB3460, 36963307371476456, 231148124, 231148127, 3, 640x360 
0x12CB3460, 36963307371797656, 231148155, 231148158, 3, 640x360 
0x12CB3460, 36963307372115672, 231148194, 231148197, 3, 640x360 
0x12CB3460, 36963307372439680, 231148223, 231148226, 3, 640x360 
0x12CB3460, 36963307372756944, 231148254, 231148257, 3, 640x360 
0x12CB3460, 36963307373076168, 231148284, 231148286, 2, 640x360 
0x12CB3460, 36963307373400208, 231148316, 231148322, 6, 640x360 
0x12CB3460, 36963307373716104, 231148374, 231148385, 11, 640x360 
0x12CB3460, 36963307374036952, 231148386, 231148390, 4, 640x360 
0x12CB3460, 36963307374354664, 231148415, 231148419, 4, 640x360 
0x12CB3460, 36963307374675192, 231148444, 231148447, 3, 640x360 
0x12CB3460, 36963307375156168, 231148494, 231148497, 3, 640x360 
0x12CB3460, 36963307375475792, 231148524, 231148527, 3, 640x360 
0x12CB3460, 36963307375796448, 231148555, 231148558, 3, 640x360 
0x12CB3460, 36963307376116144, 231148585, 231148589, 4, 640x360 
0x12CB3460, 36963307376435504, 231148625, 231148632, 7, 640x360 
0x12CB3460, 36963307376756056, 231148654, 231148657, 3, 640x360 
0x12CB3460, 36963307377075040, 231148684, 231148687, 3, 640x360 
0x12CB3460, 36963307377396288, 231148715, 231148718, 3, 640x360 
0x12CB3460, 36963307377714800, 231148745, 231148749, 4, 640x360 
0x12CB3460, 36963307378036400, 231148785, 231148788, 3, 640x360 
0x12CB3460, 36963307378354608, 231148814, 231148819, 5, 640x360 
0x12CB3460, 36963307378675304, 231148844, 231148849, 5, 640x360 
0x12CB3460, 36963307379156032, 231148894, 231148897, 3, 640x360 
0x12CB3460, 36963307379475680, 231148925, 231148928, 3, 640x360 
0x12CB3460, 36963307379794896, 231148954, 231148957, 3, 640x360 
0x12CB3460, 36963307380115400, 231148985, 231148989, 4, 640x360 
0x12CB3460, 36963307380434960, 231149024, 231149027, 3, 640x360 
0x12CB3460, 36963307380755496, 231149053, 231149056, 3, 640x360 
0x12CB3460, 36963307381075424, 231149084, 231149087, 3, 640x360 
0x12CB3460, 36963307381397224, 231149114, 231149119, 5, 640x360 
0x12CB3460, 36963307381714776, 231149145, 231149149, 4, 640x360 
0x12CB3460, 36963307382036512, 231149184, 231149187, 3, 640x360 
0x12CB3460, 36963307382357864, 231149214, 231149217, 3, 640x360 
0x12CB3460, 36963307382836008, 231149265, 231149268, 3, 640x360 
0x12CB3460, 36963307383157096, 231149294, 231149297, 3, 640x360 
0x12CB3460, 36963307383478496, 231149324, 231149327, 3, 640x360 
0x12CB3460, 36963307383795056, 231149396, 231149402, 6, 640x360 
0x12CB3460, 36963307384459984, 231149428, 231149433, 5, 640x360 
0x12CB3460, 36963307384755848, 231149454, 231149457, 3, 640x360 
0x12CB3460, 36963307385074472, 231149483, 231149486, 3, 640x360 
0x12CB3460, 36963307385396072, 231149515, 231149520, 5, 640x360 
0x12CB3460, 36963307385716496, 231149554, 231149557, 3, 640x360 
0x12CB3460, 36963307386035808, 231149585, 231149588, 3, 640x360 
0x12CB3460, 36963307386356944, 231149616, 231149619, 3, 640x360 
0x12CB3460, 36963307386834264, 231149664, 231149667, 3, 640x360 
0x12CB3460, 36963307387155936, 231149694, 231149698, 4, 640x360 
0x12CB3460, 36963307387474632, 231149724, 231149728, 4, 640x360 
0x12CB3460, 36963307387794744, 231149755, 231149758, 3, 640x360 
0x12CB3460, 36963307388115880, 231149794, 231149796, 2, 640x360 
0x12CB3460, 36963307388458632, 231149825, 231149830, 5, 640x360 
0x12CB3460, 36963307388757304, 231149878, 231149882, 4, 640x360 
0x12CB3460, 36963307389110112, 231149886, 231149890, 4, 640x360 
0x12CB3460, 36963307389395296, 231149916, 231149919, 3, 640x360 
0x12CB3460, 36963307389715752, 231149954, 231149957, 3, 640x360 
0x12CB3460, 36963307390035680, 231149984, 231149987, 3, 640x360 
0x12CB3460, 36963307390514552, 231150034, 231150037, 3, 640x360 
0x12CB3460, 36963307390834560, 231150065, 231150069, 4, 640x360 
0x12CB3460, 36963307391156448, 231150093, 231150097, 4, 640x360 
0x12CB3460, 36963307391474896, 231150126, 231150131, 5, 640x360 
0x12CB3460, 36963307391794856, 231150154, 231150157, 3, 640x360 
0x12CB3460, 36963307392114656, 231150194, 231150200, 6, 640x360 
0x12CB3460, 36963307392457336, 231150224, 231150227, 3, 640x360 
0x12CB3460, 36963307392757200, 231150254, 231150257, 3, 640x360 
0x12CB3460, 36963307393074640, 231150284, 231150287, 3, 640x360 
0x12CB3460, 36963307393395144, 231150314, 231150318, 4, 640x360 
0x12CB3460, 36963307393716992, 231150375, 231150382, 7, 640x360 
0x12CB3460, 36963307394037752, 231150385, 231150393, 8, 640x360 
0x12CB3460, 36963307394516368, 231150425, 231150428, 3, 640x360 
0x12CB3460, 36963307394836656, 231150466, 231150470, 4, 640x360 
0x12CB3460, 36963307395154576, 231150494, 231150497, 3, 640x360 
0x12CB3460, 36963307395475936, 231150524, 231150527, 3, 640x360 
0x12CB3460, 36963307395795184, 231150554, 231150557, 3, 640x360 
0x12CB3460, 36963307396116856, 231150585, 231150588, 3, 640x360 
0x12CB3460, 36963307396435712, 231150624, 231150628, 4, 640x360 
0x12CB3460, 36963307396755280, 231150654, 231150656, 2, 640x360 
0x12CB3460, 36963307397076464, 231150684, 231150687, 3, 640x360 
0x12CB3460, 36963307397397616, 231150714, 231150718, 4, 640x360 
0x12CB3460, 36963307397715328, 231150744, 231150747, 3, 640x360 
0x12CB3460, 36963307398036576, 231150784, 231150792, 8, 640x360 
0x12CB3460, 36963307398517232, 231150833, 231150841, 8, 640x360 
0x12CB3460, 36963307398967304, 231150874, 231150878, 4, 640x360 
0x12CB3460, 36963307399175280, 231150894, 231150897, 3, 640x360 
0x12CB3460, 36963307399476168, 231150923, 231150931, 8, 640x360 
0x12CB3460, 36963307399798576, 231150974, 231151010, 36, 640x360 
0x12CB3460, 36963307400454696, 231151026, 231151041, 15, 640x360 
0x12CB3460, 36963307400759264, 231151059, 231151083, 24, 640x360 
0x12CB3460, 36963307401309888, 231151117, 231151122, 5, 640x360 
0x12CB3460, 36963307401399768, 231151127, 231151137, 10, 640x360 
0x12CB3460, 36963307401719640, 231151155, 231151159, 4, 640x360 
0x12CB3460, 36963307402197664, 231151195, 231151200, 5, 640x360 
0x12CB3460, 36963307402516112, 231151226, 231151230, 4, 640x360 
0x12CB3460, 36963307402835112, 231151264, 231151268, 4, 640x360 
0x12CB3460, 36963307403155848, 231151294, 231151297, 3, 640x360 
0x12CB3460, 36963307403475048, 231151323, 231151326, 3, 640x360 
0x12CB3460, 36963307403795152, 231151380, 231151383, 3, 640x360 
0x12CB3460, 36963307404126904, 231151395, 231151398, 3, 640x360 
0x12CB3460, 36963307404434440, 231151424, 231151427, 3, 640x360 
0x12CB3460, 36963307404756256, 231151454, 231151457, 3, 640x360 
0x12CB3460, 36963307405075312, 231151484, 231151487, 3, 640x360 
0x12CB3460, 36963307405396032, 231151514, 231151517, 3, 640x360 
0x12CB3460, 36963307405716760, 231151554, 231151557, 3, 640x360 
0x12CB3460, 36963307406196656, 231151594, 231151597, 3, 640x360 
0x12CB3460, 36963307406515016, 231151634, 231151638, 4, 640x360 
0x12CB3460, 36963307406834816, 231151664, 231151666, 2, 640x360 
0x12CB3460, 36963307407155752, 231151693, 231151696, 3, 640x360 
0x12CB3460, 36963307407475432, 231151725, 231151729, 4, 640x360 
0x12CB3460, 36963307407795976, 231151754, 231151757, 3, 640x360 
0x12CB3460, 36963307408115208, 231151785, 231151789, 4, 640x360 
0x12CB3460, 36963307408440472, 231151823, 231151826, 3, 640x360 
0x12CB3460, 36963307408772328, 231151884, 231151886, 2, 640x360 
0x12CB3460, 36963307409395776, 231151914, 231151917, 3, 640x360 
0x12CB3460, 36963307409715928, 231151955, 231151958, 3, 640x360 
0x12CB3460, 36963307410194552, 231151994, 231151998, 4, 640x360 
0x12CB3460, 36963307410514336, 231152034, 231152037, 3, 640x360 
0x12CB3460, 36963307410834480, 231152064, 231152067, 3, 640x360 
0x12CB3460, 36963307411158464, 231152095, 231152097, 2, 640x360 
0x12CB3460, 36963307411476648, 231152124, 231152128, 4, 640x360 
0x12CB3460, 36963307411796696, 231152154, 231152157, 3, 640x360 
0x12CB3460, 36963307412116456, 231152185, 231152189, 4, 640x360 
0x12CB3460, 36963307412438080, 231152224, 231152227, 3, 640x360 
0x12CB3460, 36963307412754496, 231152255, 231152258, 3, 640x360 
0x12CB3460, 36963307413076720, 231152285, 231152288, 3, 640x360 
0x12CB3460, 36963307413395216, 231152314, 231152317, 3, 640x360 
0x12CB3460, 36963307414031112, 231152384, 231152387, 3, 640x360 
0x12CB3460, 36963307414194512, 231152394, 231152397, 3, 640x360 
0x12CB3460, 36963307414514584, 231152434, 231152437, 3, 640x360 
0x12CB3460, 36963307414835760, 231152466, 231152479, 13, 640x360 
0x12CB3460, 36963307415189648, 231152494, 231152497, 3, 640x360 
0x12CB3460, 36963307415474912, 231152524, 231152527, 3, 640x360 
0x12CB3460, 36963307415795248, 231152566, 231152569, 3, 640x360 
0x12CB3460, 36963307416116096, 231152585, 231152588, 3, 640x360 
0x12CB3460, 36963307416441832, 231152625, 231152629, 4, 640x360 
0x12CB3460, 36963307416754536, 231152653, 231152656, 3, 640x360 
0x12CB3460, 36963307417075272, 231152685, 231152688, 3, 640x360 
0x12CB3460, 36963307417395600, 231152714, 231152717, 3, 640x360 
0x12CB3460, 36963307417874584, 231152765, 231152775, 10, 640x360 
0x12CB3460, 36963307418296328, 231152820, 231152831, 11, 640x360 
0x12CB3460, 36963307418562264, 231152831, 231152835, 4, 640x360 
0x12CB3460, 36963307419176176, 231152904, 231152908, 4, 640x360 
0x12CB3460, 36963307419475840, 231152934, 231152939, 5, 640x360 
0x12CB3460, 36963307419798600, 231152954, 231152958, 4, 640x360 
0x12CB3460, 36963307420115296, 231152986, 231152989, 3, 640x360 
0x12CB3460, 36963307420436008, 231153025, 231153028, 3, 640x360 
0x12CB3460, 36963307420756704, 231153056, 231153059, 3, 640x360 
0x12CB3460, 36963307421076128, 231153086, 231153090, 4, 640x360 
0x12CB3460, 36963307421554736, 231153134, 231153137, 3, 640x360 
0x12CB3460, 36963307421874528, 231153164, 231153167, 3, 640x360 
0x12CB3460, 36963307422195280, 231153194, 231153197, 3, 640x360 
0x12CB3460, 36963307422516016, 231153234, 231153236, 2, 640x360 
0x12CB3460, 36963307422835384, 231153264, 231153267, 3, 640x360 
0x12CB3460, 36963307423154960, 231153294, 231153297, 3, 640x360 
0x12CB3460, 36963307423499336, 231153335, 231153338, 3, 640x360 
0x12CB3460, 36963307423995136, 231153377, 231153381, 4, 640x360 
0x12CB3460, 36963307424116464, 231153386, 231153389, 3, 640x360 
0x12CB3460, 36963307424436856, 231153424, 231153427, 3, 640x360 
0x12CB3460, 36963307424759344, 231153454, 231153457, 3, 640x360 
0x12CB3460, 36963307425075528, 231153483, 231153486, 3, 640x360 
0x12CB3460, 36963307425555880, 231153534, 231153537, 3, 640x360 
0x12CB3460, 36963307425876320, 231153564, 231153566, 2, 640x360 
0x12CB3460, 36963307426194416, 231153595, 231153598, 3, 640x360 
0x12CB3460, 36963307426543512, 231153635, 231153639, 4, 640x360 
0x12CB3460, 36963307426835464, 231153664, 231153682, 18, 640x360 
0x12CB3460, 36963307427155176, 231153694, 231153698, 4, 640x360 
0x12CB3460, 36963307427475280, 231153724, 231153727, 3, 640x360 
0x12CB3460, 36963307427795560, 231153755, 231153758, 3, 640x360 
0x12CB3460, 36963307428116112, 231153795, 231153801, 6, 640x360 
0x12CB3460, 36963307428444528, 231153824, 231153827, 3, 640x360 
0x12CB3460, 36963307428997920, 231153874, 231153893, 19, 640x360 
0x12CB3460, 36963307429080024, 231153893, 231153899, 6, 640x360 
0x12CB3460, 36963307429557072, 231153934, 231153937, 3, 640x360 
0x12CB3460, 36963307429993296, 231153977, 231153980, 3, 640x360 
0x12CB3460, 36963307430197456, 231153995, 231153998, 3, 640x360 
0x12CB3460, 36963307430543384, 231154035, 231154037, 2, 640x360 
0x12CB3460, 36963307430835024, 231154064, 231154067, 3, 640x360 
0x12CB3460, 36963307431466088, 231154124, 231154136, 12, 640x360 
0x12CB3460, 36963307431796680, 231154154, 231154158, 4, 640x360 
0x12CB3460, 36963307432116200, 231154185, 231154189, 4, 640x360 
0x12CB3460, 36963307432440680, 231154224, 231154227, 3, 640x360 
0x12CB3460, 36963307432755456, 231154254, 231154257, 3, 640x360 
0x12CB3460, 36963307433277560, 231154306, 231154318, 12, 640x360 
0x12CB3460, 36963307433556384, 231154335, 231154341, 6, 640x360 
0x12CB3460, 36963307434067688, 231154384, 231154391, 7, 640x360 
0x12CB3460, 36963307434198152, 231154394, 231154398, 4, 640x360 
0x12CB3460, 36963307434516208, 231154434, 231154437, 3, 640x360 
0x12CB3460, 36963307434837464, 231154464, 231154467, 3, 640x360 
0x12CB3460, 36963307435165048, 231154494, 231154505, 11, 640x360 
0x12CB3460, 36963307435477184, 231154524, 231154527, 3, 640x360 
0x12CB3460, 36963307435795432, 231154554, 231154557, 3, 640x360 
0x12CB3460, 36963307436114336, 231154595, 231154598, 3, 640x360 
0x12CB3460, 36963307436443760, 231154624, 231154627, 3, 640x360 
0x12CB3460, 36963307436756616, 231154653, 231154656, 3, 640x360 
0x12CB3460, 36963307437236384, 231154704, 231154707, 3, 640x360 
0x12CB3460, 36963307437629328, 231154745, 231154748, 3, 640x360 
0x12CB3460, 36963307437875840, 231154765, 231154770, 5, 640x360 
0x12CB3460, 36963307438233416, 231154804, 231154808, 4, 640x360 
0x12CB3460, 36963307438514464, 231154825, 231154829, 4, 640x360 
0x12CB3460, 36963307438981600, 231154874, 231154877, 3, 640x360 
0x12CB3460, 36963307439155928, 231154894, 231154897, 3, 640x360 
0x12CB3460, 36963307439475528, 231154924, 231154927, 3, 640x360 
0x12CB3460, 36963307439795528, 231154955, 231154958, 3, 640x360 
0x12CB3460, 36963307440114808, 231154995, 231154999, 4, 640x360 
0x12CB3460, 36963307440437816, 231155024, 231155026, 2, 640x360 
0x12CB3460, 36963307440757256, 231155054, 231155057, 3, 640x360 
0x12CB3460, 36963307441236584, 231155104, 231155107, 3, 640x360 
0x12CB3460, 36963307441555680, 231155134, 231155137, 3, 640x360 
0x12CB3460, 36963307441875480, 231155164, 231155181, 17, 640x360 
0x12CB3460, 36963307442196400, 231155195, 231155197, 2, 640x360 
0x12CB3460, 36963307442514584, 231155233, 231155236, 3, 640x360 
0x12CB3460, 36963307442834280, 231155264, 231155267, 3, 640x360 
0x12CB3460, 36963307443156424, 231155293, 231155297, 4, 640x360 
0x12CB3460, 36963307443474576, 231155324, 231155327, 3, 640x360 
0x12CB3460, 36963307443795584, 231155381, 231155390, 9, 640x360 
0x12CB3460, 36963307444164696, 231155390, 231155395, 5, 640x360 
0x12CB3460, 36963307444447184, 231155424, 231155427, 3, 640x360 
0x12CB3460, 36963307444914480, 231155474, 231155477, 3, 640x360 
0x12CB3460, 36963307445237152, 231155504, 231155507, 3, 640x360 
0x12CB3460, 36963307445557000, 231155533, 231155536, 3, 640x360 
0x12CB3460, 36963307445876240, 231155565, 231155568, 3, 640x360 
0x12CB3460, 36963307446196952, 231155595, 231155598, 3, 640x360 
0x12CB3460, 36963307446517184, 231155635, 231155641, 6, 640x360 
0x12CB3460, 36963307446836528, 231155664, 231155667, 3, 640x360 
0x12CB3460, 36963307447156328, 231155694, 231155696, 2, 640x360 
0x12CB3460, 36963307447477440, 231155727, 231155730, 3, 640x360 
0x12CB3460, 36963307447795376, 231155755, 231155757, 2, 640x360 
0x12CB3460, 36963307448114800, 231155794, 231155797, 3, 640x360 
0x12CB3460, 36963307448435288, 231155824, 231155827, 3, 640x360 
0x12CB3460, 36963307449118024, 231155894, 231155897, 3, 640x360 
0x12CB3460, 36963307449238480, 231155904, 231155906, 2, 640x360 
0x12CB3460, 36963307449554080, 231155934, 231155937, 3, 640x360 
0x12CB3460, 36963307449874968, 231155964, 231155967, 3, 640x360 
0x12CB3460, 36963307450195328, 231155994, 231155997, 3, 640x360 
0x12CB3460, 36963307450515464, 231156034, 231156036, 2, 640x360 
0x12CB3460, 36963307450836064, 231156064, 231156067, 3, 640x360 
0x12CB3460, 36963307451154920, 231156094, 231156096, 2, 640x360 
0x12CB3460, 36963307451577360, 231156135, 231156139, 4, 640x360 
0x12CB3460, 36963307451794720, 231156155, 231156158, 3, 640x360 
0x12CB3460, 36963307452435760, 231156224, 231156227, 3, 640x360 
0x12CB3460, 36963307452914400, 231156274, 231156277, 3, 640x360 
0x12CB3460, 36963307453235576, 231156304, 231156306, 2, 640x360 
0x12CB3460, 36963307453555648, 231156334, 231156336, 2, 640x360 
0x12CB3460, 36963307453985944, 231156384, 231156386, 2, 640x360 
0x12CB3460, 36963307454194688, 231156395, 231156397, 2, 640x360 
0x12CB3460, 36963307454516272, 231156435, 231156437, 2, 640x360 
0x12CB3460, 36963307454834752, 231156464, 231156467, 3, 640x360 
0x12CB3460, 36963307455155336, 231156494, 231156497, 3, 640x360 
0x12CB3460, 36963307455477728, 231156524, 231156527, 3, 640x360 
0x12CB3460, 36963307455798632, 231156565, 231156568, 3, 640x360 
0x12CB3460, 36963307456118408, 231156594, 231156597, 3, 640x360 
0x12CB3460, 36963307456595896, 231156635, 231156639, 4, 640x360 
0x12CB3460, 36963307456919784, 231156675, 231156678, 3, 640x360 
0x12CB3460, 36963307457235728, 231156704, 231156708, 4, 640x360 
0x12CB3460, 36963307457555320, 231156734, 231156737, 3, 640x360 
0x12CB3460, 36963307457875920, 231156765, 231156767, 2, 640x360 
0x12CB3460, 36963307458196472, 231156794, 231156798, 4, 640x360 
0x12CB3460, 36963307458515256, 231156825, 231156828, 3, 640x360 
0x12CB3460, 36963307459085576, 231156884, 231156889, 5, 640x360 
0x12CB3460, 36963307459157608, 231156894, 231156897, 3, 640x360 
0x12CB3460, 36963307459475256, 231156924, 231156926, 2, 640x360 
0x12CB3460, 36963307459795112, 231156954, 231156957, 3, 640x360 
0x12CB3460, 36963307460115416, 231156994, 231156997, 3, 640x360 
0x12CB3460, 36963307460596672, 231157035, 231157039, 4, 640x360 
0x12CB3460, 36963307460915216, 231157065, 231157068, 3, 640x360 
0x12CB3460, 36963307461235944, 231157104, 231157106, 2, 640x360 
0x12CB3460, 36963307461555064, 231157135, 231157139, 4, 640x360 
0x12CB3460, 36963307461874304, 231157164, 231157167, 3, 640x360 
0x12CB3460, 36963307462194440, 231157195, 231157197, 2, 640x360 
0x12CB3460, 36963307462515056, 231157234, 231157237, 3, 640x360 
0x12CB3460, 36963307462836928, 231157264, 231157267, 3, 640x360 
0x12CB3460, 36963307463155744, 231157295, 231157298, 3, 640x360 
0x12CB3460, 36963307463481296, 231157324, 231157329, 5, 640x360 
0x12CB3460, 36963307464033328, 231157384, 231157387, 3, 640x360 
0x12CB3460, 36963307464276520, 231157404, 231157406, 2, 640x360 
0x12CB3460, 36963307464595496, 231157435, 231157437, 2, 640x360 
0x12CB3460, 36963307464915496, 231157473, 231157476, 3, 640x360 
0x12CB3460, 36963307465237376, 231157504, 231157507, 3, 640x360 
0x12CB3460, 36963307465555024, 231157533, 231157536, 3, 640x360 
0x12CB3460, 36963307465878112, 231157564, 231157566, 2, 640x360 
0x12CB3460, 36963307466196072, 231157605, 231157607, 2, 640x360 
0x12CB3460, 36963307466514064, 231157625, 231157628, 3, 640x360 
0x12CB3460, 36963307466834824, 231157664, 231157667, 3, 640x360 
0x12CB3460, 36963307467155600, 231157694, 231157696, 2, 640x360 
0x12CB3460, 36963307467475800, 231157724, 231157726, 2, 640x360 
0x12CB3460, 36963307467794872, 231157754, 231157757, 3, 640x360 
0x12CB3460, 36963307468275176, 231157804, 231157807, 3, 640x360 
0x12CB3460, 36963307468596016, 231157834, 231157837, 3, 640x360 
0x12CB3460, 36963307469001784, 231157875, 231157878, 3, 640x360 
0x12CB3460, 36963307469235512, 231157904, 231157922, 18, 640x360 
0x12CB3460, 36963307469557136, 231157934, 231157936, 2, 640x360 
0x12CB3460, 36963307469877984, 231157965, 231157968, 3, 640x360 
0x12CB3460, 36963307470195016, 231157994, 231157997, 3, 640x360 
0x12CB3460, 36963307470515896, 231158033, 231158036, 3, 640x360 
0x12CB3460, 36963307470836744, 231158064, 231158067, 3, 640x360 
0x12CB3460, 36963307471155048, 231158094, 231158097, 3, 640x360 
0x12CB3460, 36963307471476120, 231158124, 231158134, 10, 640x360 
0x12CB3460, 36963307471795352, 231158154, 231158157, 3, 640x360 
0x12CB3460, 36963307472275016, 231158204, 231158211, 7, 640x360 
0x12CB3460, 36963307472594040, 231158234, 231158237, 3, 640x360 
0x12CB3460, 36963307472916832, 231158274, 231158277, 3, 640x360 
0x12CB3460, 36963307473235392, 231158304, 231158308, 4, 640x360 
0x12CB3460, 36963307473555096, 231158333, 231158336, 3, 640x360 
0x12CB3460, 36963307474018440, 231158384, 231158395, 11, 640x360 
0x12CB3460, 36963307474195384, 231158395, 231158397, 2, 640x360 
0x12CB3460, 36963307474515448, 231158433, 231158436, 3, 640x360 
0x12CB3460, 36963307474836320, 231158465, 231158468, 3, 640x360 
0x12CB3460, 36963307475154168, 231158493, 231158496, 3, 640x360 
0x12CB3460, 36963307475475544, 231158524, 231158527, 3, 640x360 
0x12CB3460, 36963307475955992, 231158574, 231158576, 2, 640x360 
0x12CB3460, 36963307476276216, 231158604, 231158607, 3, 640x360 
0x12CB3460, 36963307476595880, 231158633, 231158636, 3, 640x360 
0x12CB3460, 36963307476915576, 231158674, 231158677, 3, 640x360 
0x12CB3460, 36963307477234088, 231158705, 231158707, 2, 640x360 
0x12CB3460, 36963307477555648, 231158734, 231158736, 2, 640x360 
0x12CB3460, 36963307477875712, 231158764, 231158767, 3, 640x360 
0x12CB3460, 36963307478197040, 231158796, 231158799, 3, 640x360 
0x12CB3460, 36963307478516328, 231158834, 231158836, 2, 640x360 
0x12CB3460, 36963307479099600, 231158894, 231158896, 2, 640x360 
0x12CB3460, 36963307479475168, 231158925, 231158927, 2, 640x360 
0x12CB3460, 36963307479953336, 231158974, 231158976, 2, 640x360 
0x12CB3460, 36963307480275352, 231159004, 231159006, 2, 640x360 
0x12CB3460, 36963307480596936, 231159034, 231159038, 4, 640x360 
0x12CB3460, 36963307480915448, 231159074, 231159076, 2, 640x360 
0x12CB3460, 36963307481234816, 231159104, 231159107, 3, 640x360 
0x12CB3460, 36963307481555528, 231159134, 231159138, 4, 640x360 
0x12CB3460, 36963307481874192, 231159164, 231159167, 3, 640x360 
0x12CB3460, 36963307482194432, 231159195, 231159197, 2, 640x360 
0x12CB3460, 36963307482514584, 231159235, 231159237, 2, 640x360 
0x12CB3460, 36963307482834616, 231159264, 231159266, 2, 640x360 
0x12CB3460, 36963307483154480, 231159294, 231159297, 3, 640x360 
0x12CB3460, 36963307483474864, 231159325, 231159328, 3, 640x360 
0x12CB3460, 36963307484014976, 231159384, 231159387, 3, 640x360 
0x12CB3460, 36963307484273392, 231159403, 231159406, 3, 640x360 
0x12CB3460, 36963307484594712, 231159434, 231159437, 3, 640x360 
0x12CB3460, 36963307484917528, 231159475, 231159477, 2, 640x360 
0x12CB3460, 36963307485235056, 231159504, 231159507, 3, 640x360 
0x12CB3460, 36963307485554952, 231159534, 231159537, 3, 640x360 
0x12CB3460, 36963307485874912, 231159564, 231159567, 3, 640x360 
0x12CB3460, 36963307486195480, 231159595, 231159597, 2, 640x360 
0x12CB3460, 36963307486519872, 231159634, 231159636, 2, 640x360 
0x12CB3460, 36963307486835392, 231159665, 231159667, 2, 640x360 
0x12CB3460, 36963307487154920, 231159694, 231159697, 3, 640x360 
0x12CB3460, 36963307487633432, 231159744, 231159747, 3, 640x360 
0x12CB3460, 36963307487953752, 231159774, 231159777, 3, 640x360 
0x12CB3460, 36963307488275848, 231159804, 231159811, 7, 640x360 
0x12CB3460, 36963307488594872, 231159834, 231159836, 2, 640x360 
0x12CB3460, 36963307489024848, 231159883, 231159885, 2, 640x360 
0x12CB3460, 36963307489235864, 231159904, 231159907, 3, 640x360 
0x12CB3460, 36963307489554184, 231159935, 231159939, 4, 640x360 
0x12CB3460, 36963307489874736, 231159965, 231159968, 3, 640x360 
0x12CB3460, 36963307490195424, 231159995, 231159997, 2, 640x360 
0x12CB3460, 36963307490514736, 231160034, 231160038, 4, 640x360 
0x12CB3460, 36963307490835000, 231160065, 231160070, 5, 640x360 
0x12CB3460, 36963307491155832, 231160094, 231160110, 16, 640x360 
0x12CB3460, 36963307491633432, 231160143, 231160146, 3, 640x360 
0x12CB3460, 36963307491953584, 231160174, 231160176, 2, 640x360 
0x12CB3460, 36963307492274264, 231160205, 231160208, 3, 640x360 
0x12CB3460, 36963307492594776, 231160234, 231160236, 2, 640x360 
0x12CB3460, 36963307492913840, 231160274, 231160277, 3, 640x360 
0x12CB3460, 36963307493234096, 231160304, 231160307, 3, 640x360 
0x12CB3460, 36963307493555200, 231160334, 231160337, 3, 640x360 
0x12CB3460, 36963307493959224, 231160374, 231160378, 4, 640x360 
0x12CB3460, 36963307494198600, 231160396, 231160398, 2, 640x360 
0x12CB3460, 36963307494562344, 231160436, 231160441, 5, 640x360 
0x12CB3460, 36963307494835144, 231160464, 231160467, 3, 640x360 
0x12CB3460, 36963307495156032, 231160494, 231160496, 2, 640x360 
0x12CB3460, 36963307495638808, 231160545, 231160548, 3, 640x360 
0x12CB3460, 36963307495954056, 231160574, 231160576, 2, 640x360 
0x12CB3460, 36963307496273616, 231160604, 231160607, 3, 640x360 
0x12CB3460, 36963307496595288, 231160634, 231160637, 3, 640x360 
0x12CB3460, 36963307496920384, 231160675, 231160677, 2, 640x360 
0x12CB3460, 36963307497235392, 231160704, 231160707, 3, 640x360 
0x12CB3460, 36963307497553880, 231160733, 231160736, 3, 640x360 
0x12CB3460, 36963307497874856, 231160765, 231160769, 4, 640x360 
0x12CB3460, 36963307498194520, 231160795, 231160797, 2, 640x360 
0x12CB3460, 36963307498514320, 231160834, 231160836, 2, 640x360 
0x12CB3460, 36963307498996240, 231160884, 231160887, 3, 640x360 
0x12CB3460, 36963307499314936, 231160914, 231160917, 3, 640x360 
0x12CB3460, 36963307499634112, 231160944, 231160947, 3, 640x360 
0x12CB3460, 36963307499953512, 231160974, 231160977, 3, 640x360 
0x12CB3460, 36963307500274504, 231161003, 231161006, 3, 640x360 
0x12CB3460, 36963307500595432, 231161034, 231161037, 3, 640x360 
0x12CB3460, 36963307500914944, 231161074, 231161076, 2, 640x360 
0x12CB3460, 36963307501236064, 231161103, 231161106, 3, 640x360 
0x12CB3460, 36963307501555336, 231161135, 231161137, 2, 640x360 
0x12CB3460, 36963307501874048, 231161164, 231161166, 2, 640x360 
0x12CB3460, 36963307502195792, 231161195, 231161198, 3, 640x360 
0x12CB3460, 36963307502515416, 231161234, 231161236, 2, 640x360 
0x12CB3460, 36963307502836400, 231161264, 231161267, 3, 640x360 
0x12CB3460, 36963307503315464, 231161315, 231161317, 2, 640x360 
0x12CB3460, 36963307503634904, 231161344, 231161373, 29, 640x360 
0x12CB3460, 36963307504023232, 231161384, 231161387, 3, 640x360 
0x12CB3460, 36963307504275640, 231161404, 231161407, 3, 640x360 
0x12CB3460, 36963307504595600, 231161435, 231161438, 3, 640x360 
0x12CB3460, 36963307504914976, 231161474, 231161477, 3, 640x360 
0x12CB3460, 36963307505240192, 231161505, 231161510, 5, 640x360 
0x12CB3460, 36963307505553728, 231161534, 231161537, 3, 640x360 
0x12CB3460, 36963307505875008, 231161564, 231161567, 3, 640x360 
0x12CB3460, 36963307506194928, 231161594, 231161597, 3, 640x360 
0x12CB3460, 36963307506514512, 231161634, 231161636, 2, 640x360 
0x12CB3460, 36963307506993496, 231161675, 231161678, 3, 640x360 
0x12CB3460, 36963307507314656, 231161714, 231161717, 3, 640x360 
0x12CB3460, 36963307507635472, 231161744, 231161747, 3, 640x360 
0x12CB3460, 36963307507955280, 231161774, 231161777, 3, 640x360 
0x12CB3460, 36963307508276504, 231161805, 231161807, 2, 640x360 
0x12CB3460, 36963307508595064, 231161834, 231161837, 3, 640x360 
0x12CB3460, 36963307509065008, 231161884, 231161887, 3, 640x360 
0x12CB3460, 36963307509235600, 231161904, 231161907, 3, 640x360 
0x12CB3460, 36963307509554952, 231161934, 231161937, 3, 640x360 
0x12CB3460, 36963307509874344, 231161964, 231161967, 3, 640x360 
0x12CB3460, 36963307510194960, 231161995, 231161998, 3, 640x360 
0x12CB3460, 36963307510515056, 231162025, 231162028, 3, 640x360 
0x12CB3460, 36963307510995136, 231162073, 231162078, 5, 640x360 
0x12CB3460, 36963307511313960, 231162115, 231162117, 2, 640x360 
0x12CB3460, 36963307511634760, 231162144, 231162146, 2, 640x360 
0x12CB3460, 36963307511954728, 231162175, 231162177, 2, 640x360 
0x12CB3460, 36963307512275872, 231162204, 231162207, 3, 640x360 
0x12CB3460, 36963307512596472, 231162234, 231162237, 3, 640x360 
0x12CB3460, 36963307512914248, 231162265, 231162268, 3, 640x360 
0x12CB3460, 36963307513233832, 231162304, 231162307, 3, 640x360 
0x12CB3460, 36963307513555464, 231162333, 231162336, 3, 640x360 
0x12CB3460, 36963307513993880, 231162384, 231162386, 2, 640x360 
0x12CB3460, 36963307514194360, 231162394, 231162397, 3, 640x360 
0x12CB3460, 36963307514515600, 231162434, 231162437, 3, 640x360 
0x12CB3460, 36963307514994480, 231162475, 231162477, 2, 640x360 
0x12CB3460, 36963307515314872, 231162505, 231162508, 3, 640x360 
0x12CB3460, 36963307515634192, 231162545, 231162548, 3, 640x360 
0x12CB3460, 36963307515957288, 231162574, 231162577, 3, 640x360 
0x12CB3460, 36963307516274288, 231162605, 231162622, 17, 640x360 
0x12CB3460, 36963307516596448, 231162634, 231162637, 3, 640x360 
0x12CB3460, 36963307516915656, 231162675, 231162678, 3, 640x360 
0x12CB3460, 36963307517235192, 231162703, 231162706, 3, 640x360 
0x12CB3460, 36963307517554024, 231162734, 231162736, 2, 640x360 
0x12CB3460, 36963307517874568, 231162764, 231162766, 2, 640x360 
0x12CB3460, 36963307518195000, 231162794, 231162797, 3, 640x360 
0x12CB3460, 36963307518675392, 231162843, 231162877, 34, 640x360 
0x12CB3460, 36963307519064704, 231162884, 231162887, 3, 640x360 
0x12CB3460, 36963307519315360, 231162905, 231162908, 3, 640x360 
0x12CB3460, 36963307519634352, 231162945, 231162948, 3, 640x360 
0x12CB3460, 36963307519957384, 231162974, 231162977, 3, 640x360 
0x12CB3460, 36963307520274768, 231163003, 231163006, 3, 640x360 
0x12CB3460, 36963307520595544, 231163034, 231163037, 3, 640x360 
0x12CB3460, 36963307520914008, 231163074, 231163076, 2, 640x360 
0x12CB3460, 36963307521233960, 231163104, 231163107, 3, 640x360 
0x12CB3460, 36963307521555280, 231163134, 231163137, 3, 640x360 
0x12CB3460, 36963307521876224, 231163165, 231163167, 2, 640x360 
0x12CB3460, 36963307522196824, 231163195, 231163197, 2, 640x360 
0x12CB3460, 36963307522675936, 231163244, 231163246, 2, 640x360 
0x12CB3460, 36963307522995576, 231163275, 231163278, 3, 640x360 
0x12CB3460, 36963307523316224, 231163315, 231163319, 4, 640x360 
0x12CB3460, 36963307523634688, 231163344, 231163347, 3, 640x360 
0x12CB3460, 36963307524017552, 231163384, 231163387, 3, 640x360 
0x12CB3460, 36963307524274224, 231163404, 231163407, 3, 640x360 
0x12CB3460, 36963307524595960, 231163434, 231163437, 3, 640x360 
0x12CB3460, 36963307524914536, 231163474, 231163477, 3, 640x360 
0x12CB3460, 36963307525235280, 231163504, 231163507, 3, 640x360 
0x12CB3460, 36963307525555120, 231163534, 231163536, 2, 640x360 
0x12CB3460, 36963307525874752, 231163564, 231163567, 3, 640x360 
0x12CB3460, 36963307526196816, 231163594, 231163597, 3, 640x360 
0x12CB3460, 36963307526677496, 231163644, 231163647, 3, 640x360 
0x12CB3460, 36963307526994656, 231163675, 231163677, 2, 640x360 
0x12CB3460, 36963307527319784, 231163714, 231163717, 3, 640x360 
0x12CB3460, 36963307527636144, 231163744, 231163746, 2, 640x360 
0x12CB3460, 36963307527957160, 231163775, 231163778, 3, 640x360 
0x12CB3460, 36963307528274368, 231163805, 231163808, 3, 640x360 
0x12CB3460, 36963307528593888, 231163835, 231163837, 2, 640x360 
0x12CB3460, 36963307528986240, 231163884, 231163886, 2, 640x360 
0x12CB3460, 36963307529235240, 231163905, 231163907, 2, 640x360 
0x12CB3460, 36963307529554720, 231163934, 231163936, 2, 640x360 
0x12CB3460, 36963307529874928, 231163965, 231163971, 6, 640x360 
0x12CB3460, 36963307530354624, 231164014, 231164017, 3, 640x360 
0x12CB3460, 36963307530673376, 231164044, 231164047, 3, 640x360 
0x12CB3460, 36963307530993600, 231164074, 231164077, 3, 640x360 
0x12CB3460, 36963307531314352, 231164113, 231164116, 3, 640x360 
0x12CB3460, 36963307531633976, 231164144, 231164147, 3, 640x360 
0x12CB3460, 36963307531954920, 231164174, 231164176, 2, 640x360 
0x12CB3460, 36963307532274480, 231164205, 231164208, 3, 640x360 
0x12CB3460, 36963307532593968, 231164234, 231164237, 3, 640x360 
0x12CB3460, 36963307532915240, 231164265, 231164268, 3, 640x360 
0x12CB3460, 36963307533234704, 231164305, 231164308, 3, 640x360 
0x12CB3460, 36963307533555464, 231164335, 231164338, 3, 640x360 
0x12CB3460, 36963307534093480, 231164385, 231164389, 4, 640x360 
0x12CB3460, 36963307534362000, 231164425, 231164431, 6, 640x360 
0x12CB3460, 36963307534675872, 231164446, 231164449, 3, 640x360 
0x12CB3460, 36963307534993896, 231164475, 231164478, 3, 640x360 
0x12CB3460, 36963307535313648, 231164505, 231164508, 3, 640x360 
0x12CB3460, 36963307535634160, 231164544, 231164547, 3, 640x360 
0x12CB3460, 36963307535957512, 231164574, 231164577, 3, 640x360 
0x12CB3460, 36963307536275040, 231164604, 231164607, 3, 640x360 
0x12CB3460, 36963307536594736, 231164635, 231164637, 2, 640x360 
0x12CB3460, 36963307536915008, 231164674, 231164677, 3, 640x360 
0x12CB3460, 36963307537234656, 231164703, 231164706, 3, 640x360 
0x12CB3460, 36963307537556376, 231164734, 231164737, 3, 640x360 
0x12CB3460, 36963307538036216, 231164784, 231164787, 3, 640x360 
0x12CB3460, 36963307538356704, 231164814, 231164816, 2, 640x360 
0x12CB3460, 36963307538673816, 231164844, 231164847, 3, 640x360 
0x12CB3460, 36963307539096496, 231164885, 231164888, 3, 640x360 
0x12CB3460, 36963307539315112, 231164904, 231164908, 4, 640x360 
0x12CB3460, 36963307539633768, 231164945, 231164948, 3, 640x360 
0x12CB3460, 36963307539954496, 231164974, 231164977, 3, 640x360 
0x12CB3460, 36963307540274288, 231165004, 231165006, 2, 640x360 
0x12CB3460, 36963307540594912, 231165034, 231165036, 2, 640x360 
0x12CB3460, 36963307540914400, 231165073, 231165076, 3, 640x360 
0x12CB3460, 36963307541235792, 231165104, 231165107, 3, 640x360 
0x12CB3460, 36963307541555392, 231165134, 231165137, 3, 640x360 
0x12CB3460, 36963307542033536, 231165185, 231165187, 2, 640x360 
0x12CB3460, 36963307542353408, 231165214, 231165217, 3, 640x360 
0x12CB3460, 36963307542673536, 231165244, 231165247, 3, 640x360 
0x12CB3460, 36963307542994200, 231165273, 231165276, 3, 640x360 
0x12CB3460, 36963307543314920, 231165315, 231165320, 5, 640x360 
0x12CB3460, 36963307543635416, 231165344, 231165376, 32, 640x360 
0x12CB3460, 36963307544034496, 231165384, 231165402, 18, 640x360 
0x12CB3460, 36963307544274840, 231165402, 231165405, 3, 640x360 
0x12CB3460, 36963307544594968, 231165434, 231165437, 3, 640x360 
0x12CB3460, 36963307544914976, 231165474, 231165476, 2, 640x360 
0x12CB3460, 36963307545235752, 231165504, 231165506, 2, 640x360 
0x12CB3460, 36963307545555120, 231165533, 231165536, 3, 640x360 
0x12CB3460, 36963307546034720, 231165584, 231165588, 4, 640x360 
0x12CB3460, 36963307546354544, 231165614, 231165616, 2, 640x360 
0x12CB3460, 36963307546673840, 231165644, 231165647, 3, 640x360 
0x12CB3460, 36963307546994440, 231165674, 231165677, 3, 640x360 
0x12CB3460, 36963307547314960, 231165714, 231165717, 3, 640x360 
0x12CB3460, 36963307547633312, 231165744, 231165747, 3, 640x360 
0x12CB3460, 36963307547955544, 231165774, 231165777, 3, 640x360 
0x12CB3460, 36963307548274648, 231165805, 231165808, 3, 640x360 
0x12CB3460, 36963307548595480, 231165835, 231165837, 2, 640x360 
0x12CB3460, 36963307549011752, 231165875, 231165879, 4, 640x360 
0x12CB3460, 36963307549234048, 231165904, 231165906, 2, 640x360 
0x12CB3460, 36963307549715480, 231165954, 231165957, 3, 640x360 
0x12CB3460, 36963307550035280, 231165984, 231165986, 2, 640x360 
0x12CB3460, 36963307550355240, 231166014, 231166017, 3, 640x360 
0x12CB3460, 36963307550675856, 231166044, 231166047, 3, 640x360 
0x12CB3460, 36963307550993272, 231166074, 231166077, 3, 640x360 
0x12CB3460, 36963307551314624, 231166114, 231166116, 2, 640x360 
0x12CB3460, 36963307551633984, 231166143, 231166147, 4, 640x360 
0x12CB3460, 36963307551953144, 231166174, 231166176, 2, 640x360 
0x12CB3460, 36963307552274136, 231166204, 231166206, 2, 640x360 
0x12CB3460, 36963307552594616, 231166234, 231166237, 3, 640x360 
0x12CB3460, 36963307552915584, 231166274, 231166276, 2, 640x360 
0x12CB3460, 36963307553234344, 231166304, 231166307, 3, 640x360 
0x12CB3460, 36963307553714856, 231166375, 231166378, 3, 640x360 
0x12CB3460, 36963307554037192, 231166383, 231166386, 3, 640x360 
0x12CB3460, 36963307554354720, 231166414, 231166416, 2, 640x360 
0x12CB3460, 36963307554674616, 231166443, 231166446, 3, 640x360 
0x12CB3460, 36963307554993184, 231166475, 231166478, 3, 640x360 
0x12CB3460, 36963307555314720, 231166515, 231166519, 4, 640x360 
0x12CB3460, 36963307555635840, 231166544, 231166546, 2, 640x360 
0x12CB3460, 36963307555955560, 231166574, 231166576, 2, 640x360 
0x12CB3460, 36963307556275048, 231166605, 231166607, 2, 640x360 
0x12CB3460, 36963307556594352, 231166645, 231166650, 5, 640x360 
0x12CB3460, 36963307556914424, 231166674, 231166676, 2, 640x360 
0x12CB3460, 36963307557234088, 231166703, 231166707, 4, 640x360 
0x12CB3460, 36963307557715256, 231166745, 231166748, 3, 640x360 
0x12CB3460, 36963307558037032, 231166784, 231166786, 2, 640x360 
0x12CB3460, 36963307558356104, 231166814, 231166816, 2, 640x360 
0x12CB3460, 36963307558674424, 231166871, 231166874, 3, 640x360 
0x12CB3460, 36963307559029856, 231166885, 231166888, 3, 640x360 
0x12CB3460, 36963307559313416, 231166914, 231166917, 3, 640x360 
0x12CB3460, 36963307559634408, 231166945, 231166948, 3, 640x360 
0x12CB3460, 36963307559954088, 231166974, 231166981, 7, 640x360 
0x12CB3460, 36963307560275928, 231167004, 231167006, 2, 640x360 
0x12CB3460, 36963307560593520, 231167034, 231167037, 3, 640x360 
0x12CB3460, 36963307560914744, 231167074, 231167077, 3, 640x360 
0x12CB3460, 36963307561395304, 231167116, 231167118, 2, 640x360 
0x12CB3460, 36963307561716456, 231167154, 231167158, 4, 640x360 
0x12CB3460, 36963307562034904, 231167184, 231167186, 2, 640x360 
0x12CB3460, 36963307562353872, 231167213, 231167216, 3, 640x360 
0x12CB3460, 36963307562675184, 231167244, 231167246, 2, 640x360 
0x12CB3460, 36963307562995024, 231167274, 231167277, 3, 640x360 
0x12CB3460, 36963307563315496, 231167314, 231167317, 3, 640x360 
0x12CB3460, 36963307563634744, 231167344, 231167381, 37, 640x360 
0x12CB3460, 36963307564095504, 231167385, 231167388, 3, 640x360 
0x12CB3460, 36963307564273896, 231167404, 231167422, 18, 640x360 
0x12CB3460, 36963307564594672, 231167434, 231167436, 2, 640x360 
0x12CB3460, 36963307564915264, 231167474, 231167476, 2, 640x360 
0x12CB3460, 36963307565395504, 231167514, 231167518, 4, 640x360 
0x12CB3460, 36963307565716128, 231167554, 231167557, 3, 640x360 
0x12CB3460, 36963307566034224, 231167584, 231167587, 3, 640x360 
0x12CB3460, 36963307566354672, 231167614, 231167616, 2, 640x360 
0x12CB3460, 36963307566675216, 231167645, 231167647, 2, 640x360 
0x12CB3460, 36963307566993816, 231167675, 231167680, 5, 640x360 
0x12CB3460, 36963307567315056, 231167705, 231167708, 3, 640x360 
0x12CB3460, 36963307567635752, 231167743, 231167746, 3, 640x360 
0x12CB3460, 36963307567956392, 231167775, 231167779, 4, 640x360 
0x12CB3460, 36963307568275640, 231167804, 231167806, 2, 640x360 
0x12CB3460, 36963307568594888, 231167834, 231167836, 2, 640x360 
0x12CB3460, 36963307569010840, 231167884, 231167901, 17, 640x360 
0x12CB3460, 36963307569395568, 231167914, 231167917, 3, 640x360 
0x12CB3460, 36963307569714752, 231167944, 231167947, 3, 640x360 
0x12CB3460, 36963307570036008, 231167984, 231167987, 3, 640x360 
0x12CB3460, 36963307570354368, 231168014, 231168017, 3, 640x360 
0x12CB3460, 36963307570675696, 231168045, 231168047, 2, 640x360 
0x12CB3460, 36963307570993896, 231168074, 231168077, 3, 640x360 
0x12CB3460, 36963307571314040, 231168105, 231168108, 3, 640x360 
0x12CB3460, 36963307571634616, 231168145, 231168148, 3, 640x360 
0x12CB3460, 36963307571954168, 231168173, 231168176, 3, 640x360 
0x12CB3460, 36963307572275136, 231168204, 231168207, 3, 640x360 
0x12CB3460, 36963307572594200, 231168234, 231168236, 2, 640x360 
0x12CB3460, 36963307573075448, 231168285, 231168287, 2, 640x360 
0x12CB3460, 36963307573397832, 231168315, 231168320, 5, 640x360 
0x12CB3460, 36963307573714712, 231168375, 231168378, 3, 640x360 
0x12CB3460, 36963307574034064, 231168383, 231168386, 3, 640x360 
0x12CB3460, 36963307574354936, 231168414, 231168416, 2, 640x360 
0x12CB3460, 36963307574673688, 231168443, 231168446, 3, 640x360 
0x12CB3460, 36963307574994120, 231168474, 231168478, 4, 640x360 
0x12CB3460, 36963307575314360, 231168514, 231168516, 2, 640x360 
0x12CB3460, 36963307575634808, 231168543, 231168546, 3, 640x360 
0x12CB3460, 36963307575954368, 231168574, 231168577, 3, 640x360 
0x12CB3460, 36963307576273456, 231168604, 231168606, 2, 640x360 
0x12CB3460, 36963307576594152, 231168634, 231168637, 3, 640x360 
0x12CB3460, 36963307577075712, 231168684, 231168687, 3, 640x360 
0x12CB3460, 36963307577393856, 231168724, 231168727, 3, 640x360 
0x12CB3460, 36963307577714168, 231168753, 231168756, 3, 640x360 
0x12CB3460, 36963307578035224, 231168785, 231168788, 3, 640x360 
0x12CB3460, 36963307578354544, 231168814, 231168817, 3, 640x360 
0x12CB3460, 36963307578674624, 231168844, 231168847, 3, 640x360 
0x12CB3460, 36963307579077728, 231168884, 231168887, 3, 640x360 
0x12CB3460, 36963307579314512, 231168905, 231168907, 2, 640x360 
0x12CB3460, 36963307579634176, 231168944, 231168947, 3, 640x360 
0x12CB3460, 36963307579954752, 231168974, 231168985, 11, 640x360 
0x12CB3460, 36963307580274992, 231169003, 231169006, 3, 640x360 
0x12CB3460, 36963307580756976, 231169054, 231169057, 3, 640x360 
0x12CB3460, 36963307581073256, 231169084, 231169086, 2, 640x360 
0x12CB3460, 36963307581394552, 231169114, 231169117, 3, 640x360 
0x12CB3460, 36963307581714408, 231169145, 231169148, 3, 640x360 
0x12CB3460, 36963307582034440, 231169184, 231169186, 2, 640x360 
0x12CB3460, 36963307582354376, 231169214, 231169217, 3, 640x360 
0x12CB3460, 36963307582675288, 231169244, 231169246, 2, 640x360 
0x12CB3460, 36963307582993696, 231169273, 231169276, 3, 640x360 
0x12CB3460, 36963307583315192, 231169314, 231169316, 2, 640x360 
0x12CB3460, 36963307583634216, 231169344, 231169346, 2, 640x360 
0x12CB3460, 36963307584055696, 231169384, 231169386, 2, 640x360 
0x12CB3460, 36963307584274856, 231169404, 231169406, 2, 640x360 
0x12CB3460, 36963307584754320, 231169455, 231169458, 3, 640x360 
0x12CB3460, 36963307585075192, 231169484, 231169487, 3, 640x360 
0x12CB3460, 36963307585393440, 231169515, 231169518, 3, 640x360 
0x12CB3460, 36963307585715648, 231169553, 231169556, 3, 640x360 
0x12CB3460, 36963307586034704, 231169584, 231169587, 3, 640x360 
0x12CB3460, 36963307586355728, 231169614, 231169617, 3, 640x360 
0x12CB3460, 36963307586678976, 231169645, 231169648, 3, 640x360 
0x12CB3460, 36963307586995744, 231169675, 231169677, 2, 640x360 
0x12CB3460, 36963307587317584, 231169715, 231169718, 3, 640x360 
0x12CB3460, 36963307587634288, 231169744, 231169746, 2, 640x360 
0x12CB3460, 36963307587955016, 231169775, 231169780, 5, 640x360 
0x12CB3460, 36963307588276176, 231169805, 231169807, 2, 640x360 
0x12CB3460, 36963307588981488, 231169874, 231169877, 3, 640x360 
0x12CB3460, 36963307589074680, 231169884, 231169886, 2, 640x360 
0x12CB3460, 36963307589393520, 231169914, 231169917, 3, 640x360 
0x12CB3460, 36963307589712840, 231169954, 231169957, 3, 640x360 
0x12CB3460, 36963307590035968, 231169984, 231169987, 3, 640x360 
0x12CB3460, 36963307590354280, 231170014, 231170017, 3, 640x360 
0x12CB3460, 36963307590675256, 231170044, 231170047, 3, 640x360 
0x12CB3460, 36963307590993480, 231170074, 231170077, 3, 640x360 
0x12CB3460, 36963307591314968, 231170114, 231170117, 3, 640x360 
0x12CB3460, 36963307591954976, 231170174, 231170177, 3, 640x360 
0x12CB3460, 36963307592434736, 231170223, 231170226, 3, 640x360 
0x12CB3460, 36963307592754776, 231170254, 231170257, 3, 640x360 
0x12CB3460, 36963307593075296, 231170284, 231170302, 18, 640x360 
0x12CB3460, 36963307593395336, 231170315, 231170318, 3, 640x360 
0x12CB3460, 36963307593713528, 231170344, 231170348, 4, 640x360 
0x12CB3460, 36963307594055616, 231170384, 231170387, 3, 640x360 
0x12CB3460, 36963307594354624, 231170414, 231170416, 2, 640x360 
0x12CB3460, 36963307594675480, 231170445, 231170447, 2, 640x360 
0x12CB3460, 36963307594994840, 231170475, 231170479, 4, 640x360 
0x12CB3460, 36963307595313472, 231170504, 231170508, 4, 640x360 
0x12CB3460, 36963307595634088, 231170543, 231170546, 3, 640x360 
0x12CB3460, 36963307595954752, 231170575, 231170581, 6, 640x360 
0x12CB3460, 36963307596435136, 231170625, 231170628, 3, 640x360 
0x12CB3460, 36963307596753984, 231170654, 231170657, 3, 640x360 
0x12CB3460, 36963307597074232, 231170684, 231170686, 2, 640x360 
0x12CB3460, 36963307597395432, 231170715, 231170718, 3, 640x360 
0x12CB3460, 36963307597713384, 231170754, 231170756, 2, 640x360 
0x12CB3460, 36963307598035616, 231170784, 231170787, 3, 640x360 
0x12CB3460, 36963307598353840, 231170815, 231170818, 3, 640x360 
0x12CB3460, 36963307598673592, 231170844, 231170846, 2, 640x360 
0x12CB3460, 36963307599013888, 231170884, 231170886, 2, 640x360 
0x12CB3460, 36963307599314064, 231170914, 231170916, 2, 640x360 
0x12CB3460, 36963307599634512, 231170945, 231170948, 3, 640x360 
0x12CB3460, 36963307599954064, 231170974, 231170977, 3, 640x360 
0x12CB3460, 36963307600433224, 231171025, 231171042, 17, 640x360 
0x12CB3460, 36963307600755488, 231171054, 231171057, 3, 640x360 
0x12CB3460, 36963307601073264, 231171083, 231171086, 3, 640x360 
0x12CB3460, 36963307601395056, 231171115, 231171118, 3, 640x360 
0x12CB3460, 36963307601713792, 231171154, 231171157, 3, 640x360 
0x12CB3460, 36963307602035984, 231171183, 231171186, 3, 640x360 
0x12CB3460, 36963307602355424, 231171214, 231171232, 18, 640x360 
0x12CB3460, 36963307602673424, 231171243, 231171246, 3, 640x360 
0x12CB3460, 36963307602994272, 231171275, 231171277, 2, 640x360 
0x12CB3460, 36963307603314776, 231171304, 231171308, 4, 640x360 
0x12CB3460, 36963307603634224, 231171343, 231171370, 27, 640x360 
0x12CB3460, 36963307604112792, 231171385, 231171388, 3, 640x360 
0x12CB3460, 36963307604434000, 231171424, 231171426, 2, 640x360 
0x12CB3460, 36963307604753624, 231171454, 231171457, 3, 640x360 
0x12CB3460, 36963307605073184, 231171484, 231171486, 2, 640x360 
0x12CB3460, 36963307605393896, 231171515, 231171518, 3, 640x360 
0x12CB3460, 36963307605714592, 231171554, 231171557, 3, 640x360 
0x12CB3460, 36963307606033544, 231171584, 231171587, 3, 640x360 
0x12CB3460, 36963307606353848, 231171614, 231171619, 5, 640x360 
0x12CB3460, 36963307606674720, 231171644, 231171647, 3, 640x360 
0x12CB3460, 36963307606995384, 231171673, 231171676, 3, 640x360 
0x12CB3460, 36963307607315520, 231171714, 231171717, 3, 640x360 
0x12CB3460, 36963307607633560, 231171744, 231171746, 2, 640x360 
0x12CB3460, 36963307608114736, 231171784, 231171788, 4, 640x360 
0x12CB3460, 36963307608433552, 231171824, 231171826, 2, 640x360 
0x12CB3460, 36963307608754816, 231171875, 231171878, 3, 640x360 
0x12CB3460, 36963307609073800, 231171883, 231171886, 3, 640x360 
0x12CB3460, 36963307609394544, 231171914, 231171917, 3, 640x360 
0x12CB3460, 36963307609714736, 231171954, 231171957, 3, 640x360 
0x12CB3460, 36963307610034640, 231171984, 231171987, 3, 640x360 
0x12CB3460, 36963307610354408, 231172014, 231172016, 2, 640x360 
0x12CB3460, 36963307610673424, 231172043, 231172046, 3, 640x360 
0x12CB3460, 36963307610993840, 231172074, 231172076, 2, 640x360 
0x12CB3460, 36963307611314760, 231172114, 231172117, 3, 640x360 
0x12CB3460, 36963307611634184, 231172143, 231172147, 4, 640x360 
0x12CB3460, 36963307612113032, 231172194, 231172196, 2, 640x360 
0x12CB3460, 36963307612434344, 231172224, 231172227, 3, 640x360 
0x12CB3460, 36963307612754680, 231172253, 231172256, 3, 640x360 
0x12CB3460, 36963307613075504, 231172284, 231172301, 17, 640x360 
0x12CB3460, 36963307613396032, 231172315, 231172317, 2, 640x360 
0x12CB3460, 36963307613714320, 231172368, 231172373, 5, 640x360 
0x12CB3460, 36963307614034240, 231172384, 231172387, 3, 640x360 
0x12CB3460, 36963307614354520, 231172415, 231172417, 2, 640x360 
0x12CB3460, 36963307614675512, 231172444, 231172446, 2, 640x360 
0x12CB3460, 36963307614996824, 231172474, 231172477, 3, 640x360 
0x12CB3460, 36963307615315184, 231172505, 231172511, 6, 640x360 
0x12CB3460, 36963307615795200, 231172554, 231172556, 2, 640x360 
0x12CB3460, 36963307616115616, 231172594, 231172612, 18, 640x360 
0x12CB3460, 36963307616434616, 231172624, 231172627, 3, 640x360 
0x12CB3460, 36963307616757616, 231172655, 231172658, 3, 640x360 
0x12CB3460, 36963307617074840, 231172684, 231172687, 3, 640x360 
0x12CB3460, 36963307617395456, 231172715, 231172718, 3, 640x360 
0x12CB3460, 36963307617713440, 231172754, 231172757, 3, 640x360 
0x12CB3460, 36963307618033848, 231172784, 231172786, 2, 640x360 
0x12CB3460, 36963307618354232, 231172817, 231172822, 5, 640x360 
0x12CB3460, 36963307618673776, 231172843, 231172873, 30, 640x360 
0x12CB3460, 36963307619019272, 231172884, 231172887, 3, 640x360 
0x12CB3460, 36963307619313776, 231172915, 231172917, 2, 640x360 
0x12CB3460, 36963307619794536, 231172955, 231172957, 2, 640x360 
0x12CB3460, 36963307620113240, 231172994, 231172997, 3, 640x360 
0x12CB3460, 36963307620440984, 231173025, 231173027, 2, 640x360 
0x12CB3460, 36963307620754400, 231173054, 231173056, 2, 640x360 
0x12CB3460, 36963307621073496, 231173083, 231173086, 3, 640x360 
0x12CB3460, 36963307621395272, 231173115, 231173118, 3, 640x360 
0x12CB3460, 36963307621715288, 231173155, 231173158, 3, 640x360 
0x12CB3460, 36963307622032680, 231173184, 231173186, 2, 640x360 
0x12CB3460, 36963307622353712, 231173214, 231173217, 3, 640x360 
0x12CB3460, 36963307622674368, 231173243, 231173246, 3, 640x360 
0x12CB3460, 36963307622994000, 231173275, 231173278, 3, 640x360 
0x12CB3460, 36963307623478752, 231173325, 231173329, 4, 640x360 
0x12CB3460, 36963307624014576, 231173384, 231173388, 4, 640x360 
0x12CB3460, 36963307624435080, 231173424, 231173426, 2, 640x360 
0x12CB3460, 36963307624755424, 231173454, 231173457, 3, 640x360 
0x12CB3460, 36963307625085624, 231173496, 231173507, 11, 640x360 
0x12CB3460, 36963307625394096, 231173514, 231173517, 3, 640x360 
0x12CB3460, 36963307625714920, 231173545, 231173550, 5, 640x360 
0x12CB3460, 36963307626034240, 231173584, 231173587, 3, 640x360 
0x12CB3460, 36963307626355024, 231173614, 231173618, 4, 640x360 
0x12CB3460, 36963307626996528, 231173676, 231173679, 3, 640x360 
0x12CB3460, 36963307627479536, 231173724, 231173727, 3, 640x360 
0x12CB3460, 36963307627793936, 231173754, 231173757, 3, 640x360 
0x12CB3460, 36963307628115616, 231173795, 231173798, 3, 640x360 
0x12CB3460, 36963307628434872, 231173825, 231173828, 3, 640x360 
0x12CB3460, 36963307628755120, 231173868, 231173874, 6, 640x360 
0x12CB3460, 36963307629075104, 231173884, 231173887, 3, 640x360 
0x12CB3460, 36963307629394680, 231173914, 231173917, 3, 640x360 
0x12CB3460, 36963307629714208, 231173944, 231173948, 4, 640x360 
0x12CB3460, 36963307630034736, 231173984, 231173986, 2, 640x360 
0x12CB3460, 36963307630354984, 231174015, 231174017, 2, 640x360 
0x12CB3460, 36963307630673264, 231174044, 231174046, 2, 640x360 
0x12CB3460, 36963307630993808, 231174074, 231174077, 3, 640x360 
0x12CB3460, 36963307631474456, 231174124, 231174126, 2, 640x360 
0x12CB3460, 36963307631794128, 231174153, 231174159, 6, 640x360 
0x12CB3460, 36963307632114736, 231174184, 231174187, 3, 640x360 
0x12CB3460, 36963307632435992, 231174224, 231174227, 3, 640x360 
0x12CB3460, 36963307632754520, 231174254, 231174256, 2, 640x360 
0x12CB3460, 36963307633075144, 231174284, 231174287, 3, 640x360 
0x12CB3460, 36963307633396240, 231174315, 231174318, 3, 640x360 
0x12CB3460, 36963307633713496, 231174368, 231174371, 3, 640x360 
0x12CB3460, 36963307634033296, 231174384, 231174387, 3, 640x360 
0x12CB3460, 36963307634354544, 231174414, 231174416, 2, 640x360 
0x12CB3460, 36963307634674040, 231174444, 231174447, 3, 640x360 
0x12CB3460, 36963307635156320, 231174495, 231174498, 3, 640x360 
0x12CB3460, 36963307635473920, 231174525, 231174527, 2, 640x360 
0x12CB3460, 36963307635793520, 231174554, 231174556, 2, 640x360 
0x12CB3460, 36963307636117496, 231174585, 231174589, 4, 640x360 
0x12CB3460, 36963307636434480, 231174624, 231174627, 3, 640x360 
0x12CB3460, 36963307636755440, 231174654, 231174658, 4, 640x360 
0x12CB3460, 36963307637075448, 231174684, 231174687, 3, 640x360 
0x12CB3460, 36963307637393768, 231174714, 231174717, 3, 640x360 
0x12CB3460, 36963307637712640, 231174754, 231174756, 2, 640x360 
0x12CB3460, 36963307638034080, 231174784, 231174786, 2, 640x360 
0x12CB3460, 36963307638354528, 231174815, 231174817, 2, 640x360 
0x12CB3460, 36963307638675512, 231174885, 231174893, 8, 640x360 
0x12CB3460, 36963307639155824, 231174894, 231174902, 8, 640x360 
0x12CB3460, 36963307639473240, 231174924, 231174928, 4, 640x360 
0x12CB3460, 36963307639793704, 231174954, 231174957, 3, 640x360 
0x12CB3460, 36963307640114120, 231174997, 231175003, 6, 640x360 
0x12CB3460, 36963307640451792, 231175025, 231175028, 3, 640x360 
0x12CB3460, 36963307640757832, 231175055, 231175057, 2, 640x360 
0x12CB3460, 36963307641073136, 231175084, 231175087, 3, 640x360 
0x12CB3460, 36963307641393792, 231175115, 231175117, 2, 640x360 
0x12CB3460, 36963307641715464, 231175154, 231175157, 3, 640x360 
0x12CB3460, 36963307642033424, 231175184, 231175186, 2, 640x360 
0x12CB3460, 36963307642354656, 231175213, 231175217, 4, 640x360 
0x12CB3460, 36963307642673688, 231175245, 231175250, 5, 640x360 
0x12CB3460, 36963307643153984, 231175294, 231175296, 2, 640x360 
0x12CB3460, 36963307643474952, 231175325, 231175328, 3, 640x360 
0x12CB3460, 36963307644055416, 231175384, 231175387, 3, 640x360 
0x12CB3460, 36963307644112896, 231175394, 231175396, 2, 640x360 
0x12CB3460, 36963307644434136, 231175423, 231175426, 3, 640x360 
0x12CB3460, 36963307644753256, 231175454, 231175457, 3, 640x360 
0x12CB3460, 36963307645073648, 231175483, 231175486, 3, 640x360 
0x12CB3460, 36963307645393064, 231175515, 231175518, 3, 640x360 
0x12CB3460, 36963307646033760, 231175584, 231175586, 2, 640x360 
0x12CB3460, 36963307646355056, 231175614, 231175617, 3, 640x360 
0x12CB3460, 36963307646835160, 231175665, 231175667, 2, 640x360 
0x12CB3460, 36963307647154336, 231175694, 231175697, 3, 640x360 
0x12CB3460, 36963307647475064, 231175724, 231175726, 2, 640x360 
0x12CB3460, 36963307647794624, 231175756, 231175758, 2, 640x360 
0x12CB3460, 36963307648113264, 231175793, 231175796, 3, 640x360 
0x12CB3460, 36963307648433648, 231175825, 231175828, 3, 640x360 
0x12CB3460, 36963307649046648, 231175884, 231175887, 3, 640x360 
0x12CB3460, 36963307649393680, 231175914, 231175917, 3, 640x360 
0x12CB3460, 36963307649713712, 231175954, 231175957, 3, 640x360 
0x12CB3460, 36963307650032944, 231175984, 231175986, 2, 640x360 
0x12CB3460, 36963307650354728, 231176014, 231176017, 3, 640x360 
0x12CB3460, 36963307650832776, 231176064, 231176066, 2, 640x360 
0x12CB3460, 36963307651154336, 231176094, 231176112, 18, 640x360 
0x12CB3460, 36963307651472704, 231176124, 231176127, 3, 640x360 
0x12CB3460, 36963307651792920, 231176155, 231176158, 3, 640x360 
0x12CB3460, 36963307652113808, 231176194, 231176196, 2, 640x360 
0x12CB3460, 36963307652434328, 231176223, 231176226, 3, 640x360 
0x12CB3460, 36963307652753048, 231176254, 231176257, 3, 640x360 
0x12CB3460, 36963307653074040, 231176284, 231176287, 3, 640x360 
0x12CB3460, 36963307653396080, 231176315, 231176318, 3, 640x360 
0x12CB3460, 36963307653713280, 231176375, 231176378, 3, 640x360 
0x12CB3460, 36963307654039624, 231176384, 231176387, 3, 640x360 
0x12CB3460, 36963307654514400, 231176433, 231176436, 3, 640x360 
0x12CB3460, 36963307654835320, 231176465, 231176468, 3, 640x360 
0x12CB3460, 36963307655154000, 231176494, 231176497, 3, 640x360 
0x12CB3460, 36963307655473392, 231176523, 231176526, 3, 640x360 
0x12CB3460, 36963307655795008, 231176554, 231176557, 3, 640x360 
0x12CB3460, 36963307656114672, 231176594, 231176596, 2, 640x360 
0x12CB3460, 36963307656450288, 231176623, 231176626, 3, 640x360 
0x12CB3460, 36963307656753592, 231176653, 231176671, 18, 640x360 
0x12CB3460, 36963307657074656, 231176684, 231176687, 3, 640x360 
0x12CB3460, 36963307657395328, 231176716, 231176719, 3, 640x360 
0x12CB3460, 36963307657713440, 231176754, 231176756, 2, 640x360 
0x12CB3460, 36963307658035192, 231176785, 231176788, 3, 640x360 
0x12CB3460, 36963307658514712, 231176834, 231176837, 3, 640x360 
0x12CB3460, 36963307659048792, 231176885, 231176889, 4, 640x360 
0x12CB3460, 36963307659474328, 231176924, 231176927, 3, 640x360 
0x12CB3460, 36963307659793368, 231176954, 231176956, 2, 640x360 
0x12CB3460, 36963307660113888, 231176985, 231176992, 7, 640x360 
0x12CB3460, 36963307660434408, 231177025, 231177027, 2, 640x360 
0x12CB3460, 36963307660754464, 231177054, 231177057, 3, 640x360 
0x12CB3460, 36963307661073720, 231177084, 231177086, 2, 640x360 
0x12CB3460, 36963307661393448, 231177115, 231177117, 2, 640x360 
0x12CB3460, 36963307662034720, 231177184, 231177187, 3, 640x360 
0x12CB3460, 36963307662515112, 231177234, 231177236, 2, 640x360 
0x12CB3460, 36963307662834736, 231177263, 231177267, 4, 640x360 
0x12CB3460, 36963307663157552, 231177294, 231177297, 3, 640x360 
0x12CB3460, 36963307663476240, 231177324, 231177327, 3, 640x360 
0x12CB3460, 36963307664028096, 231177384, 231177387, 3, 640x360 
0x12CB3460, 36963307664433800, 231177424, 231177426, 2, 640x360 
0x12CB3460, 36963307664754368, 231177455, 231177457, 2, 640x360 
0x12CB3460, 36963307665075560, 231177484, 231177487, 3, 640x360 
0x12CB3460, 36963307665393240, 231177513, 231177517, 4, 640x360 
0x12CB3460, 36963307665714488, 231177553, 231177556, 3, 640x360 
0x12CB3460, 36963307666193112, 231177594, 231177597, 3, 640x360 
0x12CB3460, 36963307666514456, 231177634, 231177651, 17, 640x360 
0x12CB3460, 36963307666834184, 231177664, 231177669, 5, 640x360 
0x12CB3460, 36963307667152912, 231177693, 231177695, 2, 640x360 
0x12CB3460, 36963307667473432, 231177724, 231177726, 2, 640x360 
0x12CB3460, 36963307667795032, 231177755, 231177757, 2, 640x360 
0x12CB3460, 36963307668113712, 231177794, 231177812, 18, 640x360 
0x12CB3460, 36963307668435552, 231177824, 231177828, 4, 640x360 
0x12CB3460, 36963307668754816, 231177873, 231177876, 3, 640x360 
0x12CB3460, 36963307669074424, 231177884, 231177886, 2, 640x360 
0x12CB3460, 36963307669393840, 231177915, 231177918, 3, 640x360 
0x12CB3460, 36963307669712632, 231177955, 231177957, 2, 640x360 
0x12CB3460, 36963307670195192, 231177994, 231177997, 3, 640x360 
0x12CB3460, 36963307670513448, 231178034, 231178037, 3, 640x360 
0x12CB3460, 36963307670832600, 231178064, 231178067, 3, 640x360 
0x12CB3460, 36963307671152392, 231178093, 231178096, 3, 640x360 
0x12CB3460, 36963307671473352, 231178124, 231178126, 2, 640x360 
0x12CB3460, 36963307671793896, 231178154, 231178157, 3, 640x360 
0x12CB3460, 36963307672113320, 231178194, 231178196, 2, 640x360 
0x12CB3460, 36963307672433160, 231178224, 231178227, 3, 640x360 
0x12CB3460, 36963307672753608, 231178254, 231178256, 2, 640x360 
0x12CB3460, 36963307673074040, 231178285, 231178287, 2, 640x360 
0x12CB3460, 36963307673395712, 231178314, 231178317, 3, 640x360 
0x12CB3460, 36963307673717480, 231178385, 231178388, 3, 640x360 
0x12CB3460, 36963307674192984, 231178395, 231178397, 2, 640x360 
0x12CB3460, 36963307674514224, 231178434, 231178436, 2, 640x360 
0x12CB3460, 36963307674836144, 231178464, 231178467, 3, 640x360 
0x12CB3460, 36963307675155000, 231178495, 231178498, 3, 640x360 
0x12CB3460, 36963307675475080, 231178524, 231178527, 3, 640x360 
0x12CB3460, 36963307675794080, 231178554, 231178556, 2, 640x360 
0x12CB3460, 36963307676113656, 231178585, 231178588, 3, 640x360 
0x12CB3460, 36963307676433384, 231178624, 231178627, 3, 640x360 
0x12CB3460, 36963307676754232, 231178654, 231178656, 2, 640x360 
0x12CB3460, 36963307677073976, 231178684, 231178688, 4, 640x360 
0x12CB3460, 36963307677393520, 231178714, 231178718, 4, 640x360 
0x12CB3460, 36963307677873840, 231178764, 231178767, 3, 640x360 
0x12CB3460, 36963307678192496, 231178794, 231178796, 2, 640x360 
0x12CB3460, 36963307678512752, 231178834, 231178837, 3, 640x360 
0x12CB3460, 36963307679067176, 231178884, 231178892, 8, 640x360 
0x12CB3460, 36963307679473272, 231178924, 231178927, 3, 640x360 
0x12CB3460, 36963307679793712, 231178955, 231178957, 2, 640x360 
0x12CB3460, 36963307680113520, 231178985, 231178988, 3, 640x360 
0x12CB3460, 36963307680432520, 231179024, 231179026, 2, 640x360 
0x12CB3460, 36963307680753768, 231179054, 231179057, 3, 640x360 
0x12CB3460, 36963307681074248, 231179084, 231179086, 2, 640x360 
0x12CB3460, 36963307681874904, 231179164, 231179167, 3, 640x360 
0x12CB3460, 36963307682192560, 231179195, 231179197, 2, 640x360 
0x12CB3460, 36963307682513176, 231179234, 231179236, 2, 640x360 
0x12CB3460, 36963307682834720, 231179264, 231179267, 3, 640x360 
0x12CB3460, 36963307683155144, 231179294, 231179297, 3, 640x360 
0x12CB3460, 36963307683473696, 231179325, 231179328, 3, 640x360 
0x12CB3460, 36963307683792776, 231179373, 231179377, 4, 640x360 
0x12CB3460, 36963307684112144, 231179384, 231179403, 19, 640x360 
0x12CB3460, 36963307684433848, 231179424, 231179441, 17, 640x360 
0x12CB3460, 36963307684755288, 231179455, 231179458, 3, 640x360 
0x12CB3460, 36963307685074752, 231179484, 231179487, 3, 640x360 
0x12CB3460, 36963307685395824, 231179525, 231179527, 2, 640x360 
0x12CB3460, 36963307685873600, 231179565, 231179568, 3, 640x360 
0x12CB3460, 36963307686194824, 231179594, 231179597, 3, 640x360 
0x12CB3460, 36963307686514784, 231179635, 231179637, 2, 640x360 
0x12CB3460, 36963307686836696, 231179664, 231179666, 2, 640x360 
0x12CB3460, 36963307687154048, 231179694, 231179696, 2, 640x360 
0x12CB3460, 36963307687473200, 231179724, 231179727, 3, 640x360 
0x12CB3460, 36963307687794304, 231179755, 231179757, 2, 640x360 
0x12CB3460, 36963307688113528, 231179795, 231179797, 2, 640x360 
0x12CB3460, 36963307688436048, 231179824, 231179828, 4, 640x360 
0x12CB3460, 36963307689075408, 231179884, 231179888, 4, 640x360 
0x12CB3460, 36963307689553952, 231179933, 231179936, 3, 640x360 
0x12CB3460, 36963307689872296, 231179964, 231179967, 3, 640x360 
0x12CB3460, 36963307690192768, 231179994, 231179997, 3, 640x360 
0x12CB3460, 36963307690513144, 231180024, 231180028, 4, 640x360 
0x12CB3460, 36963307690832760, 231180064, 231180068, 4, 640x360 
0x12CB3460, 36963307691153600, 231180093, 231180096, 3, 640x360 
0x12CB3460, 36963307691474048, 231180124, 231180126, 2, 640x360 
0x12CB3460, 36963307691794664, 231180154, 231180157, 3, 640x360 
0x12CB3460, 36963307692113432, 231180184, 231180188, 4, 640x360 
0x12CB3460, 36963307692435656, 231180224, 231180226, 2, 640x360 
0x12CB3460, 36963307692753456, 231180253, 231180256, 3, 640x360 
0x12CB3460, 36963307693075032, 231180284, 231180287, 3, 640x360 
0x12CB3460, 36963307693557824, 231180335, 231180337, 2, 640x360 
0x12CB3460, 36963307693990576, 231180376, 231180380, 4, 640x360 
0x12CB3460, 36963307694193008, 231180394, 231180396, 2, 640x360 
0x12CB3460, 36963307694514488, 231180425, 231180428, 3, 640x360 
0x12CB3460, 36963307694834752, 231180464, 231180466, 2, 640x360 
0x12CB3460, 36963307695153920, 231180494, 231180496, 2, 640x360 
0x12CB3460, 36963307695473784, 231180524, 231180526, 2, 640x360 
0x12CB3460, 36963307695794728, 231180554, 231180557, 3, 640x360 
0x12CB3460, 36963307696114568, 231180594, 231180597, 3, 640x360 
0x12CB3460, 36963307696436496, 231180624, 231180627, 3, 640x360 
0x12CB3460, 36963307696757936, 231180655, 231180658, 3, 640x360 
0x12CB3460, 36963307697234792, 231180704, 231180707, 3, 640x360 
0x12CB3460, 36963307697553640, 231180733, 231180736, 3, 640x360 
0x12CB3460, 36963307697874432, 231180764, 231180766, 2, 640x360 
0x12CB3460, 36963307698194504, 231180794, 231180797, 3, 640x360 
0x12CB3460, 36963307698516152, 231180834, 231180840, 6, 640x360 
0x12CB3460, 36963307699037120, 231180884, 231180887, 3, 640x360 
0x12CB3460, 36963307699154776, 231180894, 231180896, 2, 640x360 
0x12CB3460, 36963307699473888, 231180924, 231180927, 3, 640x360 
0x12CB3460, 36963307699794880, 231180955, 231180973, 18, 640x360 
0x12CB3460, 36963307700115136, 231180994, 231180997, 3, 640x360 
0x12CB3460, 36963307700437112, 231181023, 231181026, 3, 640x360 
0x12CB3460, 36963307700754056, 231181054, 231181056, 2, 640x360 
0x12CB3460, 36963307701232496, 231181103, 231181106, 3, 640x360 
0x12CB3460, 36963307701553928, 231181134, 231181136, 2, 640x360 
0x12CB3460, 36963307701875072, 231181163, 231181166, 3, 640x360 
0x12CB3460, 36963307702192576, 231181194, 231181197, 3, 640x360 
0x12CB3460, 36963307702512984, 231181234, 231181237, 3, 640x360 
0x12CB3460, 36963307702834408, 231181264, 231181267, 3, 640x360 
0x12CB3460, 36963307703154496, 231181294, 231181297, 3, 640x360 
0x12CB3460, 36963307703473632, 231181324, 231181328, 4, 640x360 
0x12CB3460, 36963307704056712, 231181384, 231181387, 3, 640x360 
0x12CB3460, 36963307704118272, 231181394, 231181397, 3, 640x360 
0x12CB3460, 36963307704434568, 231181423, 231181426, 3, 640x360 
0x12CB3460, 36963307704754888, 231181454, 231181457, 3, 640x360 
0x12CB3460, 36963307705232856, 231181504, 231181506, 2, 640x360 
0x12CB3460, 36963307705554312, 231181534, 231181536, 2, 640x360 
0x12CB3460, 36963307705874976, 231181564, 231181567, 3, 640x360 
0x12CB3460, 36963307706196040, 231181594, 231181597, 3, 640x360 
0x12CB3460, 36963307706514144, 231181625, 231181628, 3, 640x360 
0x12CB3460, 36963307706833232, 231181664, 231181667, 3, 640x360 
0x12CB3460, 36963307707154240, 231181693, 231181696, 3, 640x360 
0x12CB3460, 36963307707474208, 231181724, 231181726, 2, 640x360 
0x12CB3460, 36963307707794232, 231181754, 231181756, 2, 640x360 
0x12CB3460, 36963307708115024, 231181785, 231181789, 4, 640x360 
0x12CB3460, 36963307708440264, 231181824, 231181827, 3, 640x360 
0x12CB3460, 36963307708970848, 231181874, 231181877, 3, 640x360 
0x12CB3460, 36963307709234944, 231181904, 231181906, 2, 640x360 
0x12CB3460, 36963307709555304, 231181934, 231181949, 15, 640x360 
0x12CB3460, 36963307709873976, 231181964, 231181967, 3, 640x360 
0x12CB3460, 36963307710192720, 231181995, 231181997, 2, 640x360 
0x12CB3460, 36963307710513240, 231182034, 231182036, 2, 640x360 
0x12CB3460, 36963307710834320, 231182063, 231182066, 3, 640x360 
0x12CB3460, 36963307711153424, 231182094, 231182096, 2, 640x360 
0x12CB3460, 36963307711474720, 231182124, 231182126, 2, 640x360 
0x12CB3460, 36963307711793872, 231182154, 231182157, 3, 640x360 
0x12CB3460, 36963307712112576, 231182194, 231182196, 2, 640x360 
0x12CB3460, 36963307712434064, 231182223, 231182226, 3, 640x360 
0x12CB3460, 36963307712914328, 231182274, 231182276, 2, 640x360 
0x12CB3460, 36963307713234616, 231182303, 231182306, 3, 640x360 
0x12CB3460, 36963307713555440, 231182334, 231182337, 3, 640x360 
0x12CB3460, 36963307714098400, 231182386, 231182391, 5, 640x360 
0x12CB3460, 36963307714513848, 231182433, 231182436, 3, 640x360 
0x12CB3460, 36963307714834680, 231182465, 231182467, 2, 640x360 
0x12CB3460, 36963307715153136, 231182495, 231182497, 2, 640x360 
0x12CB3460, 36963307715476584, 231182524, 231182527, 3, 640x360 
0x12CB3460, 36963307715795112, 231182554, 231182557, 3, 640x360 
0x12CB3460, 36963307716113640, 231182594, 231182597, 3, 640x360 
0x12CB3460, 36963307716435920, 231182624, 231182626, 2, 640x360 
0x12CB3460, 36963307716915424, 231182673, 231182676, 3, 640x360 
0x12CB3460, 36963307717232808, 231182704, 231182706, 2, 640x360 
0x12CB3460, 36963307717552936, 231182733, 231182735, 2, 640x360 
0x12CB3460, 36963307717873872, 231182764, 231182766, 2, 640x360 
0x12CB3460, 36963307718194376, 231182794, 231182796, 2, 640x360 
0x12CB3460, 36963307718513136, 231182834, 231182837, 3, 640x360 
0x12CB3460, 36963307719035056, 231182884, 231182887, 3, 640x360 
0x12CB3460, 36963307719155872, 231182893, 231182895, 2, 640x360 
0x12CB3460, 36963307719473344, 231182924, 231182926, 2, 640x360 
0x12CB3460, 36963307719793712, 231182953, 231182956, 3, 640x360 
0x12CB3460, 36963307720112712, 231182984, 231182987, 3, 640x360 
0x12CB3460, 36963307720592656, 231183034, 231183036, 2, 640x360 
0x12CB3460, 36963307720911992, 231183065, 231183068, 3, 640x360 
0x12CB3460, 36963307721233928, 231183104, 231183106, 2, 640x360 
0x12CB3460, 36963307721552944, 231183134, 231183137, 3, 640x360 
0x12CB3460, 36963307721873512, 231183164, 231183167, 3, 640x360 
0x12CB3460, 36963307722192920, 231183194, 231183197, 3, 640x360 
0x12CB3460, 36963307722513904, 231183234, 231183236, 2, 640x360 
0x12CB3460, 36963307722833536, 231183265, 231183282, 17, 640x360 
0x12CB3460, 36963307723154440, 231183294, 231183296, 2, 640x360 
0x12CB3460, 36963307723474576, 231183323, 231183326, 3, 640x360 
0x12CB3460, 36963307724010864, 231183384, 231183387, 3, 640x360 
0x12CB3460, 36963307724114880, 231183394, 231183396, 2, 640x360 
0x12CB3460, 36963307724594064, 231183434, 231183437, 3, 640x360 
0x12CB3460, 36963307724914568, 231183474, 231183477, 3, 640x360 
0x12CB3460, 36963307725235856, 231183504, 231183507, 3, 640x360 
0x12CB3460, 36963307725553712, 231183533, 231183539, 6, 640x360 
0x12CB3460, 36963307725874104, 231183563, 231183566, 3, 640x360 
0x12CB3460, 36963307726194768, 231183595, 231183597, 2, 640x360 
0x12CB3460, 36963307726514168, 231183634, 231183637, 3, 640x360 
0x12CB3460, 36963307726835864, 231183665, 231183668, 3, 640x360 
0x12CB3460, 36963307727157672, 231183694, 231183697, 3, 640x360 
0x12CB3460, 36963307727474360, 231183723, 231183726, 3, 640x360 
0x12CB3460, 36963307727794176, 231183754, 231183756, 2, 640x360 
0x12CB3460, 36963307728114096, 231183794, 231183797, 3, 640x360 
0x12CB3460, 36963307728595056, 231183833, 231183836, 3, 640x360 
0x12CB3460, 36963307729106824, 231183894, 231183898, 4, 640x360 
0x12CB3460, 36963307729233176, 231183904, 231183907, 3, 640x360 
0x12CB3460, 36963307729553624, 231183933, 231183936, 3, 640x360 
0x12CB3460, 36963307729873408, 231183964, 231183966, 2, 640x360 
0x12CB3460, 36963307730193640, 231183993, 231183997, 4, 640x360 
0x12CB3460, 36963307730512392, 231184024, 231184028, 4, 640x360 
0x12CB3460, 36963307730858504, 231184064, 231184069, 5, 640x360 
0x12CB3460, 36963307731154520, 231184094, 231184096, 2, 640x360 
0x12CB3460, 36963307731473288, 231184124, 231184127, 3, 640x360 
0x12CB3460, 36963307731793416, 231184154, 231184171, 17, 640x360 
0x12CB3460, 36963307732273744, 231184204, 231184206, 2, 640x360 
0x12CB3460, 36963307732594168, 231184234, 231184236, 2, 640x360 
0x12CB3460, 36963307732912640, 231184273, 231184276, 3, 640x360 
0x12CB3460, 36963307733234912, 231184304, 231184306, 2, 640x360 
0x12CB3460, 36963307733554464, 231184334, 231184336, 2, 640x360 
0x12CB3460, 36963307734065016, 231184384, 231184386, 2, 640x360 
0x12CB3460, 36963307734193392, 231184394, 231184396, 2, 640x360 
0x12CB3460, 36963307734513320, 231184434, 231184436, 2, 640x360 
0x12CB3460, 36963307734836192, 231184464, 231184466, 2, 640x360 
0x12CB3460, 36963307735156120, 231184494, 231184496, 2, 640x360 
0x12CB3460, 36963307735474328, 231184525, 231184527, 2, 640x360 
0x12CB3460, 36963307735796552, 231184555, 231184559, 4, 640x360 
0x12CB3460, 36963307736278552, 231184604, 231184607, 3, 640x360 
0x12CB3460, 36963307736594856, 231184644, 231184650, 6, 640x360 
0x12CB3460, 36963307736912640, 231184674, 231184677, 3, 640x360 
0x12CB3460, 36963307737234184, 231184704, 231184706, 2, 640x360 
0x12CB3460, 36963307737552592, 231184734, 231184736, 2, 640x360 
0x12CB3460, 36963307737872600, 231184763, 231184766, 3, 640x360 
0x12CB3460, 36963307738193096, 231184795, 231184797, 2, 640x360 
0x12CB3460, 36963307738512240, 231184834, 231184836, 2, 640x360 
0x12CB3460, 36963307739018312, 231184884, 231184887, 3, 640x360 
0x12CB3460, 36963307739152944, 231184894, 231184896, 2, 640x360 
0x12CB3460, 36963307739473968, 231184924, 231184927, 3, 640x360 
0x12CB3460, 36963307739955216, 231184975, 231184978, 3, 640x360 
0x12CB3460, 36963307740274088, 231185003, 231185016, 13, 640x360 
0x12CB3460, 36963307740593984, 231185034, 231185037, 3, 640x360 
0x12CB3460, 36963307740914536, 231185074, 231185077, 3, 640x360 
0x12CB3460, 36963307741234656, 231185104, 231185107, 3, 640x360 
0x12CB3460, 36963307741554448, 231185134, 231185137, 3, 640x360 
0x12CB3460, 36963307741876440, 231185163, 231185166, 3, 640x360 
0x12CB3460, 36963307742192608, 231185194, 231185197, 3, 640x360 
0x12CB3460, 36963307742513152, 231185234, 231185236, 2, 640x360 
0x12CB3460, 36963307742832960, 231185263, 231185266, 3, 640x360 
0x12CB3460, 36963307743154216, 231185294, 231185296, 2, 640x360 
0x12CB3460, 36963307743475696, 231185324, 231185327, 3, 640x360 
0x12CB3460, 36963307744087544, 231185384, 231185387, 3, 640x360 
0x12CB3460, 36963307744271960, 231185404, 231185406, 2, 640x360 
0x12CB3460, 36963307744594016, 231185435, 231185437, 2, 640x360 
0x12CB3460, 36963307744914504, 231185474, 231185477, 3, 640x360 
0x12CB3460, 36963307745236032, 231185504, 231185507, 3, 640x360 
0x12CB3460, 36963307745558008, 231185535, 231185537, 2, 640x360 
0x12CB3460, 36963307745873160, 231185563, 231185566, 3, 640x360 
0x12CB3460, 36963307746193400, 231185594, 231185597, 3, 640x360 
0x12CB3460, 36963307746516056, 231185634, 231185637, 3, 640x360 
0x12CB3460, 36963307746838536, 231185664, 231185668, 4, 640x360 
0x12CB3460, 36963307747156016, 231185693, 231185696, 3, 640x360 
0x12CB3460, 36963307747475048, 231185724, 231185727, 3, 640x360 
0x12CB3460, 36963307747954256, 231185773, 231185777, 4, 640x360 
0x12CB3460, 36963307748272304, 231185805, 231185807, 2, 640x360 
0x12CB3460, 36963307748592968, 231185835, 231185838, 3, 640x360 
0x12CB3460, 36963307748997672, 231185874, 231185892, 18, 640x360 
0x12CB3460, 36963307749233384, 231185904, 231185922, 18, 640x360 
0x12CB3460, 36963307749553256, 231185933, 231185936, 3, 640x360 
0x12CB3460, 36963307749873232, 231185964, 231185967, 3, 640x360 
0x12CB3460, 36963307750191752, 231185994, 231185996, 2, 640x360 
0x12CB3460, 36963307750511888, 231186034, 231186037, 3, 640x360 
0x12CB3460, 36963307750833632, 231186064, 231186067, 3, 640x360 
0x12CB3460, 36963307751154800, 231186093, 231186096, 3, 640x360 
0x12CB3460, 36963307751631752, 231186144, 231186146, 2, 640x360 
0x12CB3460, 36963307751954448, 231186174, 231186177, 3, 640x360 
0x12CB3460, 36963307752273304, 231186204, 231186206, 2, 640x360 
0x12CB3460, 36963307752593704, 231186234, 231186236, 2, 640x360 
0x12CB3460, 36963307752914000, 231186274, 231186277, 3, 640x360 
0x12CB3460, 36963307753233208, 231186305, 231186308, 3, 640x360 
0x12CB3460, 36963307753554208, 231186334, 231186337, 3, 640x360 
0x12CB3460, 36963307754038936, 231186385, 231186389, 4, 640x360 
0x12CB3460, 36963307754191904, 231186394, 231186396, 2, 640x360 
0x12CB3460, 36963307754513312, 231186433, 231186436, 3, 640x360 
0x12CB3460, 36963307754833664, 231186465, 231186468, 3, 640x360 
0x12CB3460, 36963307755154360, 231186493, 231186496, 3, 640x360 
0x12CB3460, 36963307755632896, 231186544, 231186547, 3, 640x360 
0x12CB3460, 36963307755952760, 231186574, 231186577, 3, 640x360 
0x12CB3460, 36963307756275120, 231186604, 231186607, 3, 640x360 
0x12CB3460, 36963307756594584, 231186634, 231186636, 2, 640x360 
0x12CB3460, 36963307756915560, 231186674, 231186676, 2, 640x360 
0x12CB3460, 36963307757233816, 231186704, 231186707, 3, 640x360 
0x12CB3460, 36963307757551928, 231186734, 231186736, 2, 640x360 
0x12CB3460, 36963307757872352, 231186764, 231186767, 3, 640x360 
0x12CB3460, 36963307758192272, 231186795, 231186798, 3, 640x360 
0x12CB3460, 36963307758512336, 231186834, 231186837, 3, 640x360 
0x12CB3460, 36963307758832768, 231186895, 231186900, 5, 640x360 
0x12CB3460, 36963307759632304, 231186944, 231186946, 2, 640x360 
0x12CB3460, 36963307759955040, 231186975, 231186978, 3, 640x360 
0x12CB3460, 36963307760275384, 231187004, 231187008, 4, 640x360 
0x12CB3460, 36963307760593328, 231187034, 231187038, 4, 640x360 
0x12CB3460, 36963307760911944, 231187065, 231187068, 3, 640x360 
0x12CB3460, 36963307761233928, 231187104, 231187106, 2, 640x360 
0x12CB3460, 36963307761553928, 231187134, 231187136, 2, 640x360 
0x12CB3460, 36963307761872880, 231187164, 231187166, 2, 640x360 
0x12CB3460, 36963307762196560, 231187194, 231187196, 2, 640x360 
0x12CB3460, 36963307762514104, 231187233, 231187235, 2, 640x360 
0x12CB3460, 36963307762833224, 231187264, 231187266, 2, 640x360 
0x12CB3460, 36963307763311832, 231187314, 231187317, 3, 640x360 
0x12CB3460, 36963307763633352, 231187345, 231187348, 3, 640x360 
0x12CB3460, 36963307764062008, 231187385, 231187387, 2, 640x360 
0x12CB3460, 36963307764272920, 231187404, 231187406, 2, 640x360 
0x12CB3460, 36963307764593768, 231187433, 231187437, 4, 640x360 
0x12CB3460, 36963307764914344, 231187475, 231187477, 2, 640x360 
0x12CB3460, 36963307765237856, 231187504, 231187507, 3, 640x360 
0x12CB3460, 36963307765554656, 231187534, 231187537, 3, 640x360 
0x12CB3460, 36963307765873168, 231187563, 231187567, 4, 640x360 
0x12CB3460, 36963307766192256, 231187594, 231187597, 3, 640x360 
0x12CB3460, 36963307766513528, 231187625, 231187628, 3, 640x360 
0x12CB3460, 36963307766833872, 231187664, 231187667, 3, 640x360 
0x12CB3460, 36963307767313584, 231187714, 231187717, 3, 640x360 
0x12CB3460, 36963307767632584, 231187744, 231187746, 2, 640x360 
0x12CB3460, 36963307767952968, 231187773, 231187777, 4, 640x360 
0x12CB3460, 36963307768275512, 231187805, 231187808, 3, 640x360 
0x12CB3460, 36963307768591816, 231187834, 231187838, 4, 640x360 
0x12CB3460, 36963307768973480, 231187874, 231187876, 2, 640x360 
0x12CB3460, 36963307769233592, 231187905, 231187907, 2, 640x360 
0x12CB3460, 36963307769554648, 231187934, 231187936, 2, 640x360 
0x12CB3460, 36963307769872592, 231187964, 231187967, 3, 640x360 
0x12CB3460, 36963307770192856, 231187993, 231187996, 3, 640x360 
0x12CB3460, 36963307770513968, 231188024, 231188028, 4, 640x360 
0x12CB3460, 36963307770994480, 231188074, 231188077, 3, 640x360 
0x12CB3460, 36963307771313528, 231188105, 231188108, 3, 640x360 
0x12CB3460, 36963307771633392, 231188145, 231188147, 2, 640x360 
0x12CB3460, 36963307771952096, 231188173, 231188177, 4, 640x360 
0x12CB3460, 36963307772273304, 231188204, 231188207, 3, 640x360 
0x12CB3460, 36963307772592696, 231188233, 231188236, 3, 640x360 
0x12CB3460, 36963307772913424, 231188274, 231188276, 2, 640x360 
0x12CB3460, 36963307773232736, 231188305, 231188307, 2, 640x360 
0x12CB3460, 36963307773555512, 231188334, 231188337, 3, 640x360 
0x12CB3460, 36963307773996512, 231188376, 231188379, 3, 640x360 
0x12CB3460, 36963307774191832, 231188394, 231188397, 3, 640x360 
0x12CB3460, 36963307774513304, 231188434, 231188436, 2, 640x360 
0x12CB3460, 36963307774994416, 231188475, 231188477, 2, 640x360 
0x12CB3460, 36963307775315416, 231188513, 231188516, 3, 640x360 
0x12CB3460, 36963307775633784, 231188544, 231188547, 3, 640x360 
0x12CB3460, 36963307775954240, 231188574, 231188577, 3, 640x360 
0x12CB3460, 36963307776274616, 231188604, 231188606, 2, 640x360 
0x12CB3460, 36963307776595520, 231188635, 231188639, 4, 640x360 
0x12CB3460, 36963307776915904, 231188675, 231188679, 4, 640x360 
0x12CB3460, 36963307777239456, 231188704, 231188707, 3, 640x360 
0x12CB3460, 36963307777553648, 231188734, 231188737, 3, 640x360 
0x12CB3460, 36963307777871824, 231188764, 231188766, 2, 640x360 
0x12CB3460, 36963307778192224, 231188795, 231188797, 2, 640x360 
0x12CB3460, 36963307778512928, 231188833, 231188836, 3, 640x360 
0x12CB3460, 36963307779059000, 231188884, 231188888, 4, 640x360 
0x12CB3460, 36963307779311336, 231188904, 231188907, 3, 640x360 
0x12CB3460, 36963307779632088, 231188944, 231188946, 2, 640x360 
0x12CB3460, 36963307779953808, 231188975, 231188978, 3, 640x360 
0x12CB3460, 36963307780273640, 231189004, 231189006, 2, 640x360 
0x12CB3460, 36963307780592920, 231189034, 231189037, 3, 640x360 
0x12CB3460, 36963307780912448, 231189073, 231189076, 3, 640x360 
0x12CB3460, 36963307781232400, 231189104, 231189106, 2, 640x360 
0x12CB3460, 36963307781553360, 231189133, 231189136, 3, 640x360 
0x12CB3460, 36963307781872568, 231189164, 231189167, 3, 640x360 
0x12CB3460, 36963307782195864, 231189193, 231189196, 3, 640x360 
0x12CB3460, 36963307782672512, 231189244, 231189246, 2, 640x360 
0x12CB3460, 36963307782994080, 231189274, 231189276, 2, 640x360 
0x12CB3460, 36963307783314120, 231189313, 231189316, 3, 640x360 
0x12CB3460, 36963307783632688, 231189344, 231189376, 32, 640x360 
0x12CB3460, 36963307784054712, 231189384, 231189387, 3, 640x360 
0x12CB3460, 36963307784271976, 231189404, 231189412, 8, 640x360 
0x12CB3460, 36963307784593656, 231189434, 231189437, 3, 640x360 
0x12CB3460, 36963307784912408, 231189465, 231189468, 3, 640x360 
0x12CB3460, 36963307785235904, 231189503, 231189506, 3, 640x360 
0x12CB3460, 36963307785557616, 231189535, 231189538, 3, 640x360 
0x12CB3460, 36963307785875360, 231189565, 231189569, 4, 640x360 
0x12CB3460, 36963307786192776, 231189593, 231189596, 3, 640x360 
0x12CB3460, 36963307786672048, 231189643, 231189646, 3, 640x360 
0x12CB3460, 36963307786996120, 231189675, 231189678, 3, 640x360 
0x12CB3460, 36963307787314424, 231189713, 231189716, 3, 640x360 
0x12CB3460, 36963307787632592, 231189743, 231189746, 3, 640x360 
0x12CB3460, 36963307787953456, 231189773, 231189776, 3, 640x360 
0x12CB3460, 36963307788273784, 231189804, 231189806, 2, 640x360 
0x12CB3460, 36963307788593256, 231189833, 231189837, 4, 640x360 
0x12CB3460, 36963307789055640, 231189884, 231189887, 3, 640x360 
0x12CB3460, 36963307789231928, 231189904, 231189907, 3, 640x360 
0x12CB3460, 36963307789553352, 231189933, 231189936, 3, 640x360 
0x12CB3460, 36963307789871968, 231189964, 231189967, 3, 640x360 
0x12CB3460, 36963307790193200, 231189993, 231189996, 3, 640x360 
0x12CB3460, 36963307790672712, 231190044, 231190047, 3, 640x360 
0x12CB3460, 36963307790993408, 231190074, 231190077, 3, 640x360 
0x12CB3460, 36963307791312648, 231190105, 231190108, 3, 640x360 
0x12CB3460, 36963307791631752, 231190144, 231190146, 2, 640x360 
0x12CB3460, 36963307791953888, 231190173, 231190176, 3, 640x360 
0x12CB3460, 36963307792274296, 231190204, 231190208, 4, 640x360 
0x12CB3460, 36963307792592688, 231190234, 231190236, 2, 640x360 
0x12CB3460, 36963307792914248, 231190264, 231190268, 4, 640x360 
0x12CB3460, 36963307793233768, 231190305, 231190307, 2, 640x360 
0x12CB3460, 36963307793554680, 231190333, 231190336, 3, 640x360 
0x12CB3460, 36963307794071656, 231190384, 231190388, 4, 640x360 
0x12CB3460, 36963307794351528, 231190414, 231190417, 3, 640x360 
0x12CB3460, 36963307794671968, 231190445, 231190448, 3, 640x360 
0x12CB3460, 36963307794993208, 231190474, 231190477, 3, 640x360 
0x12CB3460, 36963307795311464, 231190505, 231190509, 4, 640x360 
0x12CB3460, 36963307795632912, 231190544, 231190551, 7, 640x360 
0x12CB3460, 36963307795957432, 231190574, 231190576, 2, 640x360 
0x12CB3460, 36963307796272496, 231190604, 231190606, 2, 640x360 
0x12CB3460, 36963307796592360, 231190633, 231190636, 3, 640x360 
0x12CB3460, 36963307796912552, 231190673, 231190676, 3, 640x360 
0x12CB3460, 36963307797232232, 231190704, 231190708, 4, 640x360 
0x12CB3460, 36963307797552600, 231190733, 231190736, 3, 640x360 
0x12CB3460, 36963307797872656, 231190764, 231190766, 2, 640x360 
0x12CB3460, 36963307798351608, 231190814, 231190817, 3, 640x360 
0x12CB3460, 36963307798671352, 231190844, 231190877, 33, 640x360 
0x12CB3460, 36963307799016520, 231190878, 231190880, 2, 640x360 
0x12CB3460, 36963307799315288, 231190914, 231190917, 3, 640x360 
0x12CB3460, 36963307799632208, 231190944, 231190947, 3, 640x360 
0x12CB3460, 36963307799954264, 231190974, 231190977, 3, 640x360 
0x12CB3460, 36963307800273064, 231191004, 231191007, 3, 640x360 
0x12CB3460, 36963307800592368, 231191034, 231191036, 2, 640x360 
0x12CB3460, 36963307800912824, 231191074, 231191076, 2, 640x360 
0x12CB3460, 36963307801233264, 231191104, 231191107, 3, 640x360 
0x12CB3460, 36963307801553576, 231191134, 231191137, 3, 640x360 
0x12CB3460, 36963307801873136, 231191164, 231191168, 4, 640x360 
0x12CB3460, 36963307802353816, 231191215, 231191219, 4, 640x360 
0x12CB3460, 36963307802672832, 231191243, 231191246, 3, 640x360 
0x12CB3460, 36963307802992152, 231191275, 231191278, 3, 640x360 
0x12CB3460, 36963307803311984, 231191305, 231191309, 4, 640x360 
0x12CB3460, 36963307803632976, 231191343, 231191347, 4, 640x360 
0x12CB3460, 36963307804069960, 231191384, 231191388, 4, 640x360 
0x12CB3460, 36963307804272072, 231191403, 231191406, 3, 640x360 
0x12CB3460, 36963307804591592, 231191434, 231191436, 2, 640x360 
0x12CB3460, 36963307804913872, 231191474, 231191477, 3, 640x360 
0x12CB3460, 36963307805236088, 231191504, 231191507, 3, 640x360 
0x12CB3460, 36963307805553048, 231191534, 231191537, 3, 640x360 
0x12CB3460, 36963307806034200, 231191584, 231191587, 3, 640x360 
0x12CB3460, 36963307806354376, 231191615, 231191619, 4, 640x360 
0x12CB3460, 36963307806675344, 231191644, 231191647, 3, 640x360 
0x12CB3460, 36963307806995920, 231191685, 231191688, 3, 640x360 
0x12CB3460, 36963307807314704, 231191718, 231191722, 4, 640x360 
0x12CB3460, 36963307807632568, 231191744, 231191746, 2, 640x360 
0x12CB3460, 36963307807953632, 231191774, 231191777, 3, 640x360 
0x12CB3460, 36963307808272872, 231191804, 231191807, 3, 640x360 
0x12CB3460, 36963307808594152, 231191836, 231191839, 3, 640x360 
0x12CB3460, 36963307809075408, 231191884, 231191888, 4, 640x360 
0x12CB3460, 36963307809231696, 231191903, 231191906, 3, 640x360 
0x12CB3460, 36963307809553512, 231191934, 231191937, 3, 640x360 
0x12CB3460, 36963307810033112, 231191984, 231191987, 3, 640x360 
0x12CB3460, 36963307810354344, 231192015, 231192018, 3, 640x360 
0x12CB3460, 36963307810674576, 231192046, 231192049, 3, 640x360 
0x12CB3460, 36963307810992560, 231192074, 231192078, 4, 640x360 
0x12CB3460, 36963307811313024, 231192104, 231192108, 4, 640x360 
0x12CB3460, 36963307811634560, 231192144, 231192146, 2, 640x360 
0x12CB3460, 36963307811953640, 231192174, 231192177, 3, 640x360 
0x12CB3460, 36963307812274472, 231192204, 231192207, 3, 640x360 
0x12CB3460, 36963307812592352, 231192233, 231192236, 3, 640x360 
0x12CB3460, 36963307812912456, 231192274, 231192276, 2, 640x360 
0x12CB3460, 36963307813233128, 231192304, 231192307, 3, 640x360 
0x12CB3460, 36963307813714256, 231192383, 231192386, 3, 640x360 
0x12CB3460, 36963307814353032, 231192414, 231192416, 2, 640x360 
0x12CB3460, 36963307814673968, 231192443, 231192446, 3, 640x360 
0x12CB3460, 36963307814992200, 231192474, 231192477, 3, 640x360 
0x12CB3460, 36963307815311496, 231192514, 231192517, 3, 640x360 
0x12CB3460, 36963307815633520, 231192545, 231192549, 4, 640x360 
0x12CB3460, 36963307815952128, 231192574, 231192577, 3, 640x360 
0x12CB3460, 36963307816272000, 231192604, 231192607, 3, 640x360 
0x12CB3460, 36963307816593384, 231192634, 231192639, 5, 640x360 
0x12CB3460, 36963307816913464, 231192674, 231192676, 2, 640x360 
0x12CB3460, 36963307817233744, 231192704, 231192707, 3, 640x360 
0x12CB3460, 36963307817711696, 231192753, 231192756, 3, 640x360 
0x12CB3460, 36963307818033664, 231192784, 231192787, 3, 640x360 
0x12CB3460, 36963307818352728, 231192814, 231192816, 2, 640x360 
0x12CB3460, 36963307818672352, 231192844, 231192847, 3, 640x360 
0x12CB3460, 36963307819011264, 231192884, 231192890, 6, 640x360 
0x12CB3460, 36963307819313360, 231192904, 231192908, 4, 640x360 
0x12CB3460, 36963307819633496, 231192943, 231192946, 3, 640x360 
0x12CB3460, 36963307819953776, 231192973, 231192976, 3, 640x360 
0x12CB3460, 36963307820275384, 231193004, 231193007, 3, 640x360 
0x12CB3460, 36963307820598216, 231193044, 231193047, 3, 640x360 
0x12CB3460, 36963307820912464, 231193074, 231193077, 3, 640x360 
0x12CB3460, 36963307821232840, 231193104, 231193107, 3, 640x360 
0x12CB3460, 36963307821714848, 231193154, 231193157, 3, 640x360 
0x12CB3460, 36963307822033408, 231193184, 231193187, 3, 640x360 
0x12CB3460, 36963307822353504, 231193214, 231193216, 2, 640x360 
0x12CB3460, 36963307822672184, 231193244, 231193247, 3, 640x360 
0x12CB3460, 36963307822994096, 231193274, 231193277, 3, 640x360 
0x12CB3460, 36963307823313488, 231193315, 231193319, 4, 640x360 
0x12CB3460, 36963307823636856, 231193345, 231193347, 2, 640x360 
0x12CB3460, 36963307824153800, 231193394, 231193397, 3, 640x360 
0x12CB3460, 36963307824592792, 231193433, 231193436, 3, 640x360 
0x12CB3460, 36963307824911904, 231193475, 231193478, 3, 640x360 
0x12CB3460, 36963307825392328, 231193514, 231193517, 3, 640x360 
0x12CB3460, 36963307825711472, 231193554, 231193557, 3, 640x360 
0x12CB3460, 36963307826032120, 231193584, 231193587, 3, 640x360 
0x12CB3460, 36963307826353776, 231193614, 231193618, 4, 640x360 
0x12CB3460, 36963307826675744, 231193646, 231193649, 3, 640x360 
0x12CB3460, 36963307826993208, 231193675, 231193678, 3, 640x360 
0x12CB3460, 36963307827313128, 231193716, 231193720, 4, 640x360 
0x12CB3460, 36963307827631368, 231193744, 231193746, 2, 640x360 
0x12CB3460, 36963307827952856, 231193774, 231193777, 3, 640x360 
0x12CB3460, 36963307828273256, 231193804, 231193807, 3, 640x360 
0x12CB3460, 36963307828595392, 231193835, 231193838, 3, 640x360 
0x12CB3460, 36963307829071008, 231193884, 231193887, 3, 640x360 
0x12CB3460, 36963307829392736, 231193913, 231193916, 3, 640x360 
0x12CB3460, 36963307829711472, 231193944, 231193947, 3, 640x360 
0x12CB3460, 36963307830031688, 231193984, 231193987, 3, 640x360 
0x12CB3460, 36963307830352928, 231194013, 231194017, 4, 640x360 
0x12CB3460, 36963307830672904, 231194044, 231194047, 3, 640x360 
0x12CB3460, 36963307830993144, 231194074, 231194077, 3, 640x360 
0x12CB3460, 36963307831313256, 231194105, 231194108, 3, 640x360 
0x12CB3460, 36963307831632264, 231194143, 231194146, 3, 640x360 
0x12CB3460, 36963307831952440, 231194174, 231194177, 3, 640x360 
0x12CB3460, 36963307832272336, 231194205, 231194208, 3, 640x360 
0x12CB3460, 36963307832592280, 231194234, 231194237, 3, 640x360 
0x12CB3460, 36963307832912504, 231194274, 231194276, 2, 640x360 
0x12CB3460, 36963307833394992, 231194316, 231194319, 3, 640x360 
0x12CB3460, 36963307833714224, 231194376, 231194380, 4, 640x360 
0x12CB3460, 36963307834059288, 231194384, 231194391, 7, 640x360 
0x12CB3460, 36963307834352616, 231194414, 231194417, 3, 640x360 
0x12CB3460, 36963307834673328, 231194444, 231194447, 3, 640x360 
0x12CB3460, 36963307834994208, 231194475, 231194478, 3, 640x360 
0x12CB3460, 36963307835312848, 231194514, 231194517, 3, 640x360 
0x12CB3460, 36963307835636920, 231194544, 231194547, 3, 640x360 
0x12CB3460, 36963307835952064, 231194573, 231194576, 3, 640x360 
0x12CB3460, 36963307836273096, 231194604, 231194606, 2, 640x360 
0x12CB3460, 36963307836597096, 231194635, 231194638, 3, 640x360 
0x12CB3460, 36963307837073552, 231194683, 231194686, 3, 640x360 
0x12CB3460, 36963307837392576, 231194714, 231194717, 3, 640x360 
0x12CB3460, 36963307837711408, 231194754, 231194757, 3, 640x360 
0x12CB3460, 36963307838033272, 231194783, 231194786, 3, 640x360 
0x12CB3460, 36963307838352960, 231194814, 231194817, 3, 640x360 
0x12CB3460, 36963307838672592, 231194843, 231194846, 3, 640x360 
0x12CB3460, 36963307839043920, 231194884, 231194890, 6, 640x360 
0x12CB3460, 36963307839311752, 231194905, 231194908, 3, 640x360 
0x12CB3460, 36963307839632464, 231194944, 231194948, 4, 640x360 
0x12CB3460, 36963307839951920, 231194973, 231194976, 3, 640x360 
0x12CB3460, 36963307840272824, 231195004, 231195007, 3, 640x360 
0x12CB3460, 36963307840592560, 231195033, 231195040, 7, 640x360 
0x12CB3460, 36963307841072568, 231195084, 231195087, 3, 640x360 
0x12CB3460, 36963307841393080, 231195114, 231195118, 4, 640x360 
0x12CB3460, 36963307841713456, 231195154, 231195157, 3, 640x360 
0x12CB3460, 36963307842033392, 231195184, 231195187, 3, 640x360 
0x12CB3460, 36963307842353192, 231195214, 231195218, 4, 640x360 
0x12CB3460, 36963307842672552, 231195243, 231195246, 3, 640x360 
0x12CB3460, 36963307842993216, 231195274, 231195277, 3, 640x360 
0x12CB3460, 36963307843313408, 231195315, 231195319, 4, 640x360 
0x12CB3460, 36963307843631664, 231195344, 231195376, 32, 640x360 
0x12CB3460, 36963307844048856, 231195385, 231195391, 6, 640x360 
0x12CB3460, 36963307844272384, 231195404, 231195407, 3, 640x360 
0x12CB3460, 36963307844593320, 231195433, 231195436, 3, 640x360 
0x12CB3460, 36963307845073624, 231195485, 231195487, 2, 640x360 
0x12CB3460, 36963307845394464, 231195515, 231195518, 3, 640x360 
0x12CB3460, 36963307845711912, 231195545, 231195549, 4, 640x360 
0x12CB3460, 36963307846032976, 231195583, 231195586, 3, 640x360 
0x12CB3460, 36963307846353208, 231195614, 231195617, 3, 640x360 
0x12CB3460, 36963307846673952, 231195644, 231195647, 3, 640x360 
0x12CB3460, 36963307846994752, 231195675, 231195678, 3, 640x360 
0x12CB3460, 36963307847316976, 231195714, 231195722, 8, 640x360 
0x12CB3460, 36963307847632976, 231195744, 231195746, 2, 640x360 
0x12CB3460, 36963307847954112, 231195774, 231195777, 3, 640x360 
0x12CB3460, 36963307848272928, 231195803, 231195806, 3, 640x360 
0x12CB3460, 36963307848951192, 231195874, 231195877, 3, 640x360 
0x12CB3460, 36963307849075144, 231195883, 231195886, 3, 640x360 
0x12CB3460, 36963307849392504, 231195913, 231195916, 3, 640x360 
0x12CB3460, 36963307849713736, 231195953, 231195956, 3, 640x360 
0x12CB3460, 36963307850040552, 231195984, 231195987, 3, 640x360 
0x12CB3460, 36963307850351632, 231196014, 231196017, 3, 640x360 
0x12CB3460, 36963307850675912, 231196044, 231196051, 7, 640x360 
0x12CB3460, 36963307850993528, 231196074, 231196077, 3, 640x360 
0x12CB3460, 36963307851311816, 231196114, 231196117, 3, 640x360 
0x12CB3460, 36963307851633664, 231196145, 231196149, 4, 640x360 
0x12CB3460, 36963307851952008, 231196174, 231196177, 3, 640x360 
0x12CB3460, 36963307852753040, 231196254, 231196256, 2, 640x360 
0x12CB3460, 36963307853073640, 231196285, 231196287, 2, 640x360 
0x12CB3460, 36963307853394360, 231196315, 231196318, 3, 640x360 
0x12CB3460, 36963307853713512, 231196384, 231196388, 4, 640x360 
0x12CB3460, 36963307854352088, 231196414, 231196417, 3, 640x360 
0x12CB3460, 36963307854671672, 231196443, 231196446, 3, 640x360 
0x12CB3460, 36963307854993032, 231196475, 231196477, 2, 640x360 
0x12CB3460, 36963307855313832, 231196515, 231196518, 3, 640x360 
0x12CB3460, 36963307855632112, 231196545, 231196548, 3, 640x360 
0x12CB3460, 36963307855952280, 231196574, 231196577, 3, 640x360 
0x12CB3460, 36963307856434920, 231196624, 231196627, 3, 640x360 
0x12CB3460, 36963307856755936, 231196655, 231196658, 3, 640x360 
0x12CB3460, 36963307857073720, 231196684, 231196688, 4, 640x360 
0x12CB3460, 36963307857394512, 231196714, 231196719, 5, 640x360 
0x12CB3460, 36963307857710992, 231196744, 231196747, 3, 640x360 
0x12CB3460, 36963307858033224, 231196783, 231196786, 3, 640x360 
0x12CB3460, 36963307858352440, 231196814, 231196817, 3, 640x360 
0x12CB3460, 36963307858672800, 231196844, 231196876, 32, 640x360 
0x12CB3460, 36963307859047552, 231196884, 231196890, 6, 640x360 
0x12CB3460, 36963307859312464, 231196904, 231196908, 4, 640x360 
0x12CB3460, 36963307859632368, 231196943, 231196946, 3, 640x360 
0x12CB3460, 36963307859952656, 231196974, 231196977, 3, 640x360 
0x12CB3460, 36963307860435056, 231197024, 231197027, 3, 640x360 
0x12CB3460, 36963307860751320, 231197054, 231197056, 2, 640x360 
0x12CB3460, 36963307861072728, 231197083, 231197086, 3, 640x360 
0x12CB3460, 36963307861392936, 231197114, 231197117, 3, 640x360 
0x12CB3460, 36963307861712528, 231197154, 231197157, 3, 640x360 
0x12CB3460, 36963307862035144, 231197185, 231197188, 3, 640x360 
0x12CB3460, 36963307862353272, 231197214, 231197221, 7, 640x360 
0x12CB3460, 36963307862672520, 231197243, 231197246, 3, 640x360 
0x12CB3460, 36963307862993424, 231197274, 231197277, 3, 640x360 
0x12CB3460, 36963307863313800, 231197315, 231197318, 3, 640x360 
0x12CB3460, 36963307863634184, 231197345, 231197348, 3, 640x360 
0x12CB3460, 36963307864151480, 231197394, 231197397, 3, 640x360 
0x12CB3460, 36963307864432424, 231197424, 231197427, 3, 640x360 
0x12CB3460, 36963307864751984, 231197454, 231197456, 2, 640x360 
0x12CB3460, 36963307865074144, 231197484, 231197487, 3, 640x360 
0x12CB3460, 36963307865395192, 231197514, 231197518, 4, 640x360 
0x12CB3460, 36963307865715936, 231197554, 231197556, 2, 640x360 
0x12CB3460, 36963307866032216, 231197583, 231197586, 3, 640x360 
0x12CB3460, 36963307866353200, 231197613, 231197616, 3, 640x360 
0x12CB3460, 36963307866673120, 231197644, 231197647, 3, 640x360 
0x12CB3460, 36963307866994496, 231197675, 231197678, 3, 640x360 
0x12CB3460, 36963307867632720, 231197743, 231197746, 3, 640x360 
0x12CB3460, 36963307868113424, 231197794, 231197796, 2, 640x360 
0x12CB3460, 36963307868432128, 231197824, 231197828, 4, 640x360 
0x12CB3460, 36963307868752864, 231197885, 231197890, 5, 640x360 
0x12CB3460, 36963307869120392, 231197894, 231197899, 5, 640x360 
0x12CB3460, 36963307869392480, 231197914, 231197932, 18, 640x360 
0x12CB3460, 36963307869714664, 231197954, 231197956, 2, 640x360 
0x12CB3460, 36963307870032248, 231197983, 231197986, 3, 640x360 
0x12CB3460, 36963307870351784, 231198014, 231198017, 3, 640x360 
0x12CB3460, 36963307870672152, 231198044, 231198047, 3, 640x360 
0x12CB3460, 36963307870991968, 231198074, 231198078, 4, 640x360 
0x12CB3460, 36963307871311352, 231198104, 231198108, 4, 640x360 
0x12CB3460, 36963307871631632, 231198144, 231198147, 3, 640x360 
0x12CB3460, 36963307872111384, 231198184, 231198198, 14, 640x360 
0x12CB3460, 36963307872432360, 231198224, 231198227, 3, 640x360 
0x12CB3460, 36963307872752952, 231198253, 231198271, 18, 640x360 
0x12CB3460, 36963307873073272, 231198284, 231198287, 3, 640x360 
0x12CB3460, 36963307873394352, 231198314, 231198318, 4, 640x360 
0x12CB3460, 36963307873711992, 231198374, 231198378, 4, 640x360 
0x12CB3460, 36963307874032312, 231198383, 231198389, 6, 640x360 
0x12CB3460, 36963307874352520, 231198414, 231198416, 2, 640x360 
0x12CB3460, 36963307874673344, 231198443, 231198446, 3, 640x360 
0x12CB3460, 36963307874993792, 231198474, 231198478, 4, 640x360 
0x12CB3460, 36963307875314152, 231198514, 231198517, 3, 640x360 
0x12CB3460, 36963307875635720, 231198545, 231198548, 3, 640x360 
0x12CB3460, 36963307876118232, 231198594, 231198599, 5, 640x360 
0x12CB3460, 36963307876431880, 231198623, 231198626, 3, 640x360 
0x12CB3460, 36963307876754840, 231198653, 231198657, 4, 640x360 
0x12CB3460, 36963307877073888, 231198684, 231198687, 3, 640x360 
0x12CB3460, 36963307877396880, 231198714, 231198718, 4, 640x360 
0x12CB3460, 36963307877711704, 231198744, 231198747, 3, 640x360 
0x12CB3460, 36963307878031584, 231198784, 231198787, 3, 640x360 
0x12CB3460, 36963307878351456, 231198813, 231198816, 3, 640x360 
0x12CB3460, 36963307878671984, 231198844, 231198846, 2, 640x360 
0x12CB3460, 36963307879110032, 231198894, 231198898, 4, 640x360 
0x12CB3460, 36963307879312408, 231198905, 231198908, 3, 640x360 
0x12CB3460, 36963307879792856, 231198954, 231198956, 2, 640x360 
0x12CB3460, 36963307880113696, 231198993, 231198996, 3, 640x360 
0x12CB3460, 36963307880435760, 231199023, 231199026, 3, 640x360 
0x12CB3460, 36963307880753768, 231199054, 231199056, 2, 640x360 
0x12CB3460, 36963307881072352, 231199083, 231199086, 3, 640x360 
0x12CB3460, 36963307881393672, 231199114, 231199117, 3, 640x360 
0x12CB3460, 36963307881712320, 231199144, 231199148, 4, 640x360 
0x12CB3460, 36963307882032992, 231199183, 231199186, 3, 640x360 
0x12CB3460, 36963307882355424, 231199215, 231199219, 4, 640x360 
0x12CB3460, 36963307882671352, 231199244, 231199246, 2, 640x360 
0x12CB3460, 36963307882993024, 231199274, 231199277, 3, 640x360 
0x12CB3460, 36963307883313776, 231199314, 231199326, 12, 640x360 
0x12CB3460, 36963307883795920, 231199393, 231199397, 4, 640x360 
0x12CB3460, 36963307884431344, 231199424, 231199426, 2, 640x360 
0x12CB3460, 36963307884751640, 231199453, 231199456, 3, 640x360 
0x12CB3460, 36963307885073920, 231199485, 231199487, 2, 640x360 
0x12CB3460, 36963307885395032, 231199515, 231199518, 3, 640x360 
0x12CB3460, 36963307885715176, 231199553, 231199556, 3, 640x360 
0x12CB3460, 36963307886031880, 231199583, 231199586, 3, 640x360 
0x12CB3460, 36963307886353976, 231199614, 231199617, 3, 640x360 
0x12CB3460, 36963307886673664, 231199644, 231199647, 3, 640x360 
0x12CB3460, 36963307886994688, 231199675, 231199678, 3, 640x360 
0x12CB3460, 36963307887477648, 231199725, 231199728, 3, 640x360 
0x12CB3460, 36963307887792296, 231199754, 231199756, 2, 640x360 
0x12CB3460, 36963307888111368, 231199785, 231199788, 3, 640x360 
0x12CB3460, 36963307888434824, 231199824, 231199826, 2, 640x360 
0x12CB3460, 36963307888996456, 231199874, 231199878, 4, 640x360 
0x12CB3460, 36963307889071576, 231199884, 231199887, 3, 640x360 
0x12CB3460, 36963307889393080, 231199914, 231199917, 3, 640x360 
0x12CB3460, 36963307889712208, 231199954, 231199957, 3, 640x360 
0x12CB3460, 36963307890032136, 231199984, 231199986, 2, 640x360 
0x12CB3460, 36963307890352256, 231200014, 231200017, 3, 640x360 
0x12CB3460, 36963307890674464, 231200044, 231200047, 3, 640x360 
0x12CB3460, 36963307891472704, 231200123, 231200126, 3, 640x360 
0x12CB3460, 36963307891793496, 231200155, 231200158, 3, 640x360 
0x12CB3460, 36963307892112224, 231200194, 231200197, 3, 640x360 
0x12CB3460, 36963307892460792, 231200223, 231200226, 3, 640x360 
0x12CB3460, 36963307892752816, 231200254, 231200256, 2, 640x360 
0x12CB3460, 36963307893072040, 231200284, 231200286, 2, 640x360 
0x12CB3460, 36963307893394504, 231200315, 231200318, 3, 640x360 
0x12CB3460, 36963307893713752, 231200378, 231200382, 4, 640x360 
0x12CB3460, 36963307894080752, 231200385, 231200392, 7, 640x360 
0x12CB3460, 36963307894351280, 231200413, 231200416, 3, 640x360 
0x12CB3460, 36963307894673032, 231200443, 231200446, 3, 640x360 
0x12CB3460, 36963307894992960, 231200475, 231200477, 2, 640x360 
0x12CB3460, 36963307895472600, 231200525, 231200528, 3, 640x360 
0x12CB3460, 36963307895792184, 231200554, 231200557, 3, 640x360 
0x12CB3460, 36963307896114616, 231200594, 231200598, 4, 640x360 
0x12CB3460, 36963307896435104, 231200625, 231200629, 4, 640x360 
0x12CB3460, 36963307896751000, 231200653, 231200656, 3, 640x360 
0x12CB3460, 36963307897071664, 231200684, 231200686, 2, 640x360 
0x12CB3460, 36963307897391872, 231200714, 231200717, 3, 640x360 
0x12CB3460, 36963307897712648, 231200754, 231200757, 3, 640x360 
0x12CB3460, 36963307898034416, 231200783, 231200786, 3, 640x360 
0x12CB3460, 36963307898354512, 231200814, 231200817, 3, 640x360 
0x12CB3460, 36963307898675424, 231200845, 231200881, 36, 640x360 
0x12CB3460, 36963307899150616, 231200893, 231200899, 6, 640x360 
0x12CB3460, 36963307899472888, 231200923, 231200942, 19, 640x360 
0x12CB3460, 36963307899793176, 231200954, 231200957, 3, 640x360 
0x12CB3460, 36963307900112784, 231200985, 231200989, 4, 640x360 
0x12CB3460, 36963307900432400, 231201024, 231201027, 3, 640x360 
0x12CB3460, 36963307900753896, 231201054, 231201057, 3, 640x360 
0x12CB3460, 36963307901073064, 231201084, 231201088, 4, 640x360 
0x12CB3460, 36963307901392272, 231201113, 231201117, 4, 640x360 
0x12CB3460, 36963307901714752, 231201154, 231201156, 2, 640x360 
0x12CB3460, 36963307902032208, 231201185, 231201188, 3, 640x360 
0x12CB3460, 36963307902352080, 231201214, 231201217, 3, 640x360 
0x12CB3460, 36963307902671920, 231201244, 231201247, 3, 640x360 
0x12CB3460, 36963307903153896, 231201295, 231201298, 3, 640x360 
0x12CB3460, 36963307903473560, 231201325, 231201328, 3, 640x360 
0x12CB3460, 36963307904036720, 231201384, 231201388, 4, 640x360 
0x12CB3460, 36963307904432864, 231201423, 231201426, 3, 640x360 
0x12CB3460, 36963307904751640, 231201454, 231201456, 2, 640x360 
0x12CB3460, 36963307905073112, 231201484, 231201487, 3, 640x360 
0x12CB3460, 36963307905393960, 231201516, 231201519, 3, 640x360 
0x12CB3460, 36963307905711840, 231201553, 231201556, 3, 640x360 
0x12CB3460, 36963307906354872, 231201613, 231201617, 4, 640x360 
0x12CB3460, 36963307906673928, 231201645, 231201649, 4, 640x360 
0x12CB3460, 36963307907152880, 231201694, 231201696, 2, 640x360 
0x12CB3460, 36963307907471688, 231201723, 231201726, 3, 640x360 
0x12CB3460, 36963307907793120, 231201754, 231201756, 2, 640x360 
0x12CB3460, 36963307908113240, 231201794, 231201796, 2, 640x360 
0x12CB3460, 36963307908434736, 231201824, 231201826, 2, 640x360 
0x12CB3460, 36963307908755848, 231201885, 231201888, 3, 640x360 
0x12CB3460, 36963307909113568, 231201893, 231201897, 4, 640x360 
0x12CB3460, 36963307909391056, 231201913, 231201916, 3, 640x360 
0x12CB3460, 36963307909711592, 231201953, 231201956, 3, 640x360 
0x12CB3460, 36963307910033040, 231201984, 231201986, 2, 640x360 
0x12CB3460, 36963307910353600, 231202013, 231202016, 3, 640x360 
0x12CB3460, 36963307910831128, 231202063, 231202066, 3, 640x360 
0x12CB3460, 36963307911151144, 231202094, 231202097, 3, 640x360 
0x12CB3460, 36963307911471240, 231202123, 231202127, 4, 640x360 
0x12CB3460, 36963307911793104, 231202154, 231202157, 3, 640x360 
0x12CB3460, 36963307912113520, 231202194, 231202199, 5, 640x360 
0x12CB3460, 36963307912436528, 231202224, 231202227, 3, 640x360 
0x12CB3460, 36963307912752416, 231202253, 231202256, 3, 640x360 
0x12CB3460, 36963307913070952, 231202284, 231202286, 2, 640x360 
0x12CB3460, 36963307913391600, 231202314, 231202317, 3, 640x360 
0x12CB3460, 36963307913712880, 231202344, 231202348, 4, 640x360 
0x12CB3460, 36963307914038584, 231202384, 231202388, 4, 640x360 
0x12CB3460, 36963307914351392, 231202414, 231202417, 3, 640x360 
0x12CB3460, 36963307914831720, 231202464, 231202467, 3, 640x360 
0x12CB3460, 36963307915151928, 231202494, 231202497, 3, 640x360 
0x12CB3460, 36963307915474512, 231202524, 231202527, 3, 640x360 
0x12CB3460, 36963307915795944, 231202565, 231202569, 4, 640x360 
0x12CB3460, 36963307916113000, 231202584, 231202588, 4, 640x360 
0x12CB3460, 36963307916432816, 231202624, 231202627, 3, 640x360 
0x12CB3460, 36963307916754368, 231202655, 231202658, 3, 640x360 
0x12CB3460, 36963307917074000, 231202684, 231202688, 4, 640x360 
0x12CB3460, 36963307917391728, 231202714, 231202717, 3, 640x360 
0x12CB3460, 36963307917716152, 231202754, 231202757, 3, 640x360 
0x12CB3460, 36963307918035656, 231202783, 231202786, 3, 640x360 
0x12CB3460, 36963307918351688, 231202814, 231202817, 3, 640x360 
0x12CB3460, 36963307918971848, 231202877, 231202883, 6, 640x360 
0x12CB3460, 36963307919150776, 231202894, 231202897, 3, 640x360 
0x12CB3460, 36963307919471112, 231202923, 231202926, 3, 640x360 
0x12CB3460, 36963307919791216, 231202954, 231202957, 3, 640x360 
0x12CB3460, 36963307920110952, 231202985, 231202988, 3, 640x360 
0x12CB3460, 36963307920431296, 231203025, 231203028, 3, 640x360 
0x12CB3460, 36963307920751496, 231203054, 231203057, 3, 640x360 
0x12CB3460, 36963307921071080, 231203084, 231203087, 3, 640x360 
0x12CB3460, 36963307921392032, 231203114, 231203117, 3, 640x360 
0x12CB3460, 36963307921711200, 231203144, 231203148, 4, 640x360 
0x12CB3460, 36963307922034112, 231203184, 231203197, 13, 640x360 
0x12CB3460, 36963307922510472, 231203224, 231203228, 4, 640x360 
0x12CB3460, 36963307922830776, 231203263, 231203266, 3, 640x360 
0x12CB3460, 36963307923151200, 231203294, 231203297, 3, 640x360 
0x12CB3460, 36963307923471056, 231203324, 231203327, 3, 640x360 
0x12CB3460, 36963307923790968, 231203354, 231203380, 26, 640x360 
0x12CB3460, 36963307924111784, 231203394, 231203398, 4, 640x360 
0x12CB3460, 36963307924431256, 231203424, 231203427, 3, 640x360 
0x12CB3460, 36963307924751680, 231203453, 231203457, 4, 640x360 
0x12CB3460, 36963307925071232, 231203483, 231203486, 3, 640x360 
0x12CB3460, 36963307925391104, 231203514, 231203517, 3, 640x360 
0x12CB3460, 36963307925711168, 231203554, 231203556, 2, 640x360 
0x12CB3460, 36963307926032680, 231203583, 231203586, 3, 640x360 
0x12CB3460, 36963307926510536, 231203634, 231203636, 2, 640x360 
0x12CB3460, 36963307926831376, 231203663, 231203666, 3, 640x360 
0x12CB3460, 36963307927150824, 231203694, 231203697, 3, 640x360 
0x12CB3460, 36963307927471376, 231203724, 231203727, 3, 640x360 
0x12CB3460, 36963307927790848, 231203753, 231203771, 18, 640x360 
0x12CB3460, 36963307928111976, 231203784, 231203787, 3, 640x360 
0x12CB3460, 36963307928432784, 231203824, 231203827, 3, 640x360 
0x12CB3460, 36963307928751752, 231203884, 231203888, 4, 640x360 
0x12CB3460, 36963307929391528, 231203914, 231203918, 4, 640x360 
0x12CB3460, 36963307929713088, 231203944, 231203947, 3, 640x360 
0x12CB3460, 36963307930190824, 231203994, 231203997, 3, 640x360 
0x12CB3460, 36963307930511232, 231204025, 231204029, 4, 640x360 
0x12CB3460, 36963307930831408, 231204063, 231204067, 4, 640x360 
0x12CB3460, 36963307931150960, 231204094, 231204096, 2, 640x360 
0x12CB3460, 36963307931472480, 231204123, 231204126, 3, 640x360 
0x12CB3460, 36963307931793416, 231204154, 231204157, 3, 640x360 
0x12CB3460, 36963307932116032, 231204193, 231204196, 3, 640x360 
0x12CB3460, 36963307932432416, 231204225, 231204230, 5, 640x360 
0x12CB3460, 36963307932752464, 231204254, 231204256, 2, 640x360 
0x12CB3460, 36963307933071792, 231204283, 231204286, 3, 640x360 
0x12CB3460, 36963307933393392, 231204315, 231204318, 3, 640x360 
0x12CB3460, 36963307933712160, 231204369, 231204372, 3, 640x360 
0x12CB3460, 36963307934192760, 231204395, 231204412, 17, 640x360 
0x12CB3460, 36963307934510728, 231204424, 231204428, 4, 640x360 
0x12CB3460, 36963307934830944, 231204463, 231204466, 3, 640x360 
0x12CB3460, 36963307935152696, 231204494, 231204496, 2, 640x360 
0x12CB3460, 36963307935472704, 231204524, 231204527, 3, 640x360 
0x12CB3460, 36963307935793208, 231204554, 231204557, 3, 640x360 
0x12CB3460, 36963307936112352, 231204584, 231204588, 4, 640x360 
0x12CB3460, 36963307936431280, 231204624, 231204626, 2, 640x360 
0x12CB3460, 36963307936753656, 231204654, 231204656, 2, 640x360 
0x12CB3460, 36963307937073240, 231204685, 231204688, 3, 640x360 
0x12CB3460, 36963307937392928, 231204727, 231204730, 3, 640x360 
0x12CB3460, 36963307937711568, 231204744, 231204748, 4, 640x360 
0x12CB3460, 36963307938193456, 231204793, 231204797, 4, 640x360 
0x12CB3460, 36963307938513464, 231204825, 231204828, 3, 640x360 
0x12CB3460, 36963307939068456, 231204884, 231204888, 4, 640x360 
0x12CB3460, 36963307939156248, 231204894, 231204898, 4, 640x360 
0x12CB3460, 36963307939475192, 231204923, 231204926, 3, 640x360 
0x12CB3460, 36963307939792904, 231204954, 231204957, 3, 640x360 
0x12CB3460, 36963307940113520, 231204995, 231204998, 3, 640x360 
0x12CB3460, 36963307940434376, 231205024, 231205027, 3, 640x360 
0x12CB3460, 36963307940756616, 231205053, 231205056, 3, 640x360 
0x12CB3460, 36963307941072040, 231205084, 231205087, 3, 640x360 
0x12CB3460, 36963307941872240, 231205164, 231205167, 3, 640x360 
0x12CB3460, 36963307942191000, 231205194, 231205197, 3, 640x360 
0x12CB3460, 36963307942512768, 231205225, 231205228, 3, 640x360 
0x12CB3460, 36963307942832136, 231205264, 231205267, 3, 640x360 
0x12CB3460, 36963307943152840, 231205293, 231205296, 3, 640x360 
0x12CB3460, 36963307943474424, 231205325, 231205328, 3, 640x360 
0x12CB3460, 36963307943794440, 231205354, 231205357, 3, 640x360 
0x12CB3460, 36963307944159792, 231205394, 231205399, 5, 640x360 
0x12CB3460, 36963307944431888, 231205424, 231205427, 3, 640x360 
0x12CB3460, 36963307944752712, 231205454, 231205456, 2, 640x360 
0x12CB3460, 36963307945073528, 231205484, 231205488, 4, 640x360 
0x12CB3460, 36963307945391984, 231205514, 231205518, 4, 640x360 
0x12CB3460, 36963307945872712, 231205563, 231205566, 3, 640x360 
0x12CB3460, 36963307946190904, 231205594, 231205597, 3, 640x360 
0x12CB3460, 36963307946513136, 231205634, 231205637, 3, 640x360 
0x12CB3460, 36963307946834144, 231205665, 231205668, 3, 640x360 
0x12CB3460, 36963307947151736, 231205694, 231205697, 3, 640x360 
0x12CB3460, 36963307947473480, 231205725, 231205729, 4, 640x360 
0x12CB3460, 36963307947791800, 231205754, 231205756, 2, 640x360 
0x12CB3460, 36963307948111312, 231205785, 231205788, 3, 640x360 
0x12CB3460, 36963307948433224, 231205824, 231205827, 3, 640x360 
0x12CB3460, 36963307948998456, 231205884, 231205887, 3, 640x360 
0x12CB3460, 36963307949392560, 231205914, 231205917, 3, 640x360 
0x12CB3460, 36963307949872576, 231205963, 231205966, 3, 640x360 
0x12CB3460, 36963307950192448, 231205994, 231205997, 3, 640x360 
0x12CB3460, 36963307950511504, 231206035, 231206037, 2, 640x360 
0x12CB3460, 36963307950830792, 231206063, 231206066, 3, 640x360 
0x12CB3460, 36963307951152520, 231206094, 231206112, 18, 640x360 
0x12CB3460, 36963307951473264, 231206124, 231206127, 3, 640x360 
0x12CB3460, 36963307951792568, 231206155, 231206159, 4, 640x360 
0x12CB3460, 36963307952111224, 231206184, 231206188, 4, 640x360 
0x12CB3460, 36963307952431960, 231206224, 231206226, 2, 640x360 
0x12CB3460, 36963307952752176, 231206253, 231206255, 2, 640x360 
0x12CB3460, 36963307953071760, 231206283, 231206286, 3, 640x360 
0x12CB3460, 36963307953552432, 231206334, 231206337, 3, 640x360 
0x12CB3460, 36963307954007816, 231206375, 231206378, 3, 640x360 
0x12CB3460, 36963307954191824, 231206393, 231206396, 3, 640x360 
0x12CB3460, 36963307954512272, 231206424, 231206428, 4, 640x360 
0x12CB3460, 36963307954832248, 231206464, 231206467, 3, 640x360 
0x12CB3460, 36963307955153840, 231206494, 231206497, 3, 640x360 
0x12CB3460, 36963307955473192, 231206524, 231206527, 3, 640x360 
0x12CB3460, 36963307955792792, 231206555, 231206558, 3, 640x360 
0x12CB3460, 36963307956112192, 231206593, 231206596, 3, 640x360 
0x12CB3460, 36963307956432944, 231206623, 231206627, 4, 640x360 
0x12CB3460, 36963307956754464, 231206654, 231206657, 3, 640x360 
0x12CB3460, 36963307957073512, 231206684, 231206687, 3, 640x360 
0x12CB3460, 36963307957553192, 231206734, 231206736, 2, 640x360 
0x12CB3460, 36963307957872568, 231206763, 231206766, 3, 640x360 
0x12CB3460, 36963307958193936, 231206793, 231206797, 4, 640x360 
0x12CB3460, 36963307958514352, 231206835, 231206839, 4, 640x360 
0x12CB3460, 36963307959145256, 231206895, 231206898, 3, 640x360 
0x12CB3460, 36963307959791368, 231206955, 231206958, 3, 640x360 
0x12CB3460, 36963307960111536, 231206994, 231206996, 2, 640x360 
0x12CB3460, 36963307960431536, 231207024, 231207026, 2, 640x360 
0x12CB3460, 36963307960757848, 231207053, 231207056, 3, 640x360 
0x12CB3460, 36963307961072560, 231207084, 231207087, 3, 640x360 
0x12CB3460, 36963307961552464, 231207133, 231207136, 3, 640x360 
0x12CB3460, 36963307961872936, 231207164, 231207167, 3, 640x360 
0x12CB3460, 36963307962191616, 231207194, 231207197, 3, 640x360 
0x12CB3460, 36963307962516872, 231207233, 231207236, 3, 640x360 
0x12CB3460, 36963307962831376, 231207263, 231207266, 3, 640x360 
0x12CB3460, 36963307963152632, 231207293, 231207296, 3, 640x360 
0x12CB3460, 36963307963473120, 231207324, 231207327, 3, 640x360 
0x12CB3460, 36963307964060120, 231207384, 231207388, 4, 640x360 
0x12CB3460, 36963307964111792, 231207393, 231207397, 4, 640x360 
0x12CB3460, 36963307964432104, 231207424, 231207427, 3, 640x360 
0x12CB3460, 36963307964752856, 231207453, 231207456, 3, 640x360 
0x12CB3460, 36963307965233176, 231207506, 231207509, 3, 640x360 
0x12CB3460, 36963307965554080, 231207534, 231207537, 3, 640x360 
0x12CB3460, 36963307965872496, 231207563, 231207566, 3, 640x360 
0x12CB3460, 36963307966193384, 231207595, 231207597, 2, 640x360 
0x12CB3460, 36963307966513672, 231207634, 231207637, 3, 640x360 
0x12CB3460, 36963307966832352, 231207663, 231207666, 3, 640x360 
0x12CB3460, 36963307967153648, 231207694, 231207697, 3, 640x360 
0x12CB3460, 36963307967473368, 231207724, 231207727, 3, 640x360 
0x12CB3460, 36963307967790648, 231207753, 231207756, 3, 640x360 
0x12CB3460, 36963307968115104, 231207793, 231207796, 3, 640x360 
0x12CB3460, 36963307968432984, 231207824, 231207827, 3, 640x360 
0x12CB3460, 36963307968755096, 231207887, 231207891, 4, 640x360 
0x12CB3460, 36963307969231200, 231207905, 231207908, 3, 640x360 
0x12CB3460, 36963307969552360, 231207933, 231207936, 3, 640x360 
0x12CB3460, 36963307969870968, 231207963, 231207966, 3, 640x360 
0x12CB3460, 36963307970191792, 231207995, 231207998, 3, 640x360 
0x12CB3460, 36963307970512608, 231208034, 231208037, 3, 640x360 
0x12CB3460, 36963307970831848, 231208064, 231208067, 3, 640x360 
0x12CB3460, 36963307971151616, 231208093, 231208096, 3, 640x360 
0x12CB3460, 36963307971471016, 231208125, 231208128, 3, 640x360 
0x12CB3460, 36963307971792528, 231208154, 231208157, 3, 640x360 
0x12CB3460, 36963307972113544, 231208194, 231208197, 3, 640x360 
0x12CB3460, 36963307972434720, 231208224, 231208232, 8, 640x360 
0x12CB3460, 36963307972911808, 231208274, 231208277, 3, 640x360 
0x12CB3460, 36963307973231848, 231208303, 231208306, 3, 640x360 
0x12CB3460, 36963307973551952, 231208334, 231208336, 2, 640x360 
0x12CB3460, 36963307973914096, 231208375, 231208378, 3, 640x360 
0x12CB3460, 36963307974194672, 231208394, 231208398, 4, 640x360 
0x12CB3460, 36963307974511808, 231208434, 231208436, 2, 640x360 
0x12CB3460, 36963307974833000, 231208463, 231208466, 3, 640x360 
0x12CB3460, 36963307975153072, 231208494, 231208497, 3, 640x360 
0x12CB3460, 36963307975473896, 231208525, 231208542, 17, 640x360 
0x12CB3460, 36963307975793184, 231208556, 231208559, 3, 640x360 
0x12CB3460, 36963307976112064, 231208585, 231208589, 4, 640x360 
0x12CB3460, 36963307976431280, 231208623, 231208626, 3, 640x360 
0x12CB3460, 36963307976913072, 231208673, 231208676, 3, 640x360 
0x12CB3460, 36963307977232664, 231208705, 231208708, 3, 640x360 
0x12CB3460, 36963307977552712, 231208733, 231208736, 3, 640x360 
0x12CB3460, 36963307977872312, 231208764, 231208766, 2, 640x360 
0x12CB3460, 36963307978191464, 231208794, 231208797, 3, 640x360 
0x12CB3460, 36963307978515912, 231208824, 231208828, 4, 640x360 
0x12CB3460, 36963307978979616, 231208874, 231208877, 3, 640x360 
0x12CB3460, 36963307979154144, 231208893, 231208896, 3, 640x360 
0x12CB3460, 36963307979471088, 231208924, 231208926, 2, 640x360 
0x12CB3460, 36963307979792648, 231208953, 231208956, 3, 640x360 
0x12CB3460, 36963307980112352, 231208993, 231208996, 3, 640x360 
0x12CB3460, 36963307980432152, 231209024, 231209027, 3, 640x360 
0x12CB3460, 36963307980912616, 231209074, 231209077, 3, 640x360 
0x12CB3460, 36963307981236248, 231209103, 231209107, 4, 640x360 
0x12CB3460, 36963307981551272, 231209134, 231209136, 2, 640x360 
0x12CB3460, 36963307981872536, 231209163, 231209166, 3, 640x360 
0x12CB3460, 36963307982193576, 231209194, 231209198, 4, 640x360 
0x12CB3460, 36963307982511512, 231209225, 231209229, 4, 640x360 
0x12CB3460, 36963307982832024, 231209263, 231209266, 3, 640x360 
0x12CB3460, 36963307983151400, 231209293, 231209296, 3, 640x360 
0x12CB3460, 36963307983471792, 231209324, 231209328, 4, 640x360 
0x12CB3460, 36963307983791048, 231209384, 231209388, 4, 640x360 
0x12CB3460, 36963307984593048, 231209434, 231209437, 3, 640x360 
0x12CB3460, 36963307984912712, 231209473, 231209476, 3, 640x360 
0x12CB3460, 36963307985232440, 231209503, 231209506, 3, 640x360 
0x12CB3460, 36963307985553488, 231209534, 231209537, 3, 640x360 
0x12CB3460, 36963307985874064, 231209563, 231209566, 3, 640x360 
0x12CB3460, 36963307986192840, 231209594, 231209597, 3, 640x360 
0x12CB3460, 36963307986513240, 231209634, 231209637, 3, 640x360 
0x12CB3460, 36963307986833000, 231209665, 231209668, 3, 640x360 
0x12CB3460, 36963307987154864, 231209694, 231209697, 3, 640x360 
0x12CB3460, 36963307987476632, 231209723, 231209726, 3, 640x360 
0x12CB3460, 36963307987791960, 231209754, 231209756, 2, 640x360 
0x12CB3460, 36963307988112576, 231209794, 231209797, 3, 640x360 
0x12CB3460, 36963307988597744, 231209834, 231209838, 4, 640x360 
0x12CB3460, 36963307989114768, 231209893, 231209897, 4, 640x360 
0x12CB3460, 36963307989232816, 231209904, 231209907, 3, 640x360 
0x12CB3460, 36963307989552144, 231209934, 231209937, 3, 640x360 
0x12CB3460, 36963307989870744, 231209964, 231209966, 2, 640x360 
0x12CB3460, 36963307990191744, 231209995, 231209997, 2, 640x360 
0x12CB3460, 36963307990512272, 231210024, 231210028, 4, 640x360 
0x12CB3460, 36963307990831640, 231210064, 231210067, 3, 640x360 
0x12CB3460, 36963307991152584, 231210093, 231210096, 3, 640x360 
0x12CB3460, 36963307991472064, 231210124, 231210126, 2, 640x360 
0x12CB3460, 36963307991793088, 231210154, 231210157, 3, 640x360 
0x12CB3460, 36963307992592256, 231210234, 231210237, 3, 640x360 
0x12CB3460, 36963307992912864, 231210265, 231210269, 4, 640x360 
0x12CB3460, 36963307993231544, 231210303, 231210305, 2, 640x360 
0x12CB3460, 36963307993551624, 231210334, 231210336, 2, 640x360 
0x12CB3460, 36963307993991136, 231210375, 231210378, 3, 640x360 
0x12CB3460, 36963307994191528, 231210394, 231210397, 3, 640x360 
0x12CB3460, 36963307994511624, 231210433, 231210448, 15, 640x360 
0x12CB3460, 36963307994832696, 231210463, 231210465, 2, 640x360 
0x12CB3460, 36963307995152728, 231210494, 231210512, 18, 640x360 
0x12CB3460, 36963307995473816, 231210524, 231210527, 3, 640x360 
0x12CB3460, 36963307995791520, 231210554, 231210557, 3, 640x360 
0x12CB3460, 36963307996272696, 231210603, 231210606, 3, 640x360 
0x12CB3460, 36963307996593896, 231210633, 231210637, 4, 640x360 
0x12CB3460, 36963307996914616, 231210675, 231210679, 4, 640x360 
0x12CB3460, 36963307997239296, 231210705, 231210709, 4, 640x360 
0x12CB3460, 36963307997552424, 231210734, 231210737, 3, 640x360 
0x12CB3460, 36963307997871584, 231210763, 231210766, 3, 640x360 
0x12CB3460, 36963307998192528, 231210795, 231210797, 2, 640x360 
0x12CB3460, 36963307998510936, 231210834, 231210837, 3, 640x360 
0x12CB3460, 36963307998833200, 231210884, 231210888, 4, 640x360 
0x12CB3460, 36963307999151128, 231210894, 231210900, 6, 640x360 
0x12CB3460, 36963307999472936, 231210923, 231210926, 3, 640x360 
0x12CB3460, 36963307999792352, 231210954, 231210972, 18, 640x360 
0x12CB3460, 36963308000273248, 231211005, 231211023, 18, 640x360 
0x12CB3460, 36963308000594688, 231211044, 231211048, 4, 640x360 
0x12CB3460, 36963308000912728, 231211074, 231211078, 4, 640x360 
0x12CB3460, 36963308001231328, 231211104, 231211107, 3, 640x360 
0x12CB3460, 36963308001551320, 231211133, 231211135, 2, 640x360 
0x12CB3460, 36963308001872504, 231211164, 231211166, 2, 640x360 
0x12CB3460, 36963308002192944, 231211193, 231211197, 4, 640x360 
0x12CB3460, 36963308002511312, 231211224, 231211228, 4, 640x360 
0x12CB3460, 36963308002832216, 231211264, 231211267, 3, 640x360 
0x12CB3460, 36963308003151304, 231211294, 231211296, 2, 640x360 
0x12CB3460, 36963308003471432, 231211324, 231211328, 4, 640x360 
0x12CB3460, 36963308004059872, 231211383, 231211386, 3, 640x360 
0x12CB3460, 36963308004270664, 231211403, 231211406, 3, 640x360 
0x12CB3460, 36963308004592264, 231211434, 231211437, 3, 640x360 
0x12CB3460, 36963308004913104, 231211474, 231211477, 3, 640x360 
0x12CB3460, 36963308005233592, 231211503, 231211507, 4, 640x360 
0x12CB3460, 36963308005554520, 231211533, 231211551, 18, 640x360 
0x12CB3460, 36963308005877768, 231211568, 231211572, 4, 640x360 
0x12CB3460, 36963308006191088, 231211595, 231211598, 3, 640x360 
0x12CB3460, 36963308006511624, 231211634, 231211637, 3, 640x360 
0x12CB3460, 36963308006833080, 231211665, 231211668, 3, 640x360 
0x12CB3460, 36963308007156144, 231211694, 231211697, 3, 640x360 
0x12CB3460, 36963308007471872, 231211723, 231211726, 3, 640x360 
0x12CB3460, 36963308007950592, 231211774, 231211777, 3, 640x360 
0x12CB3460, 36963308008270792, 231211804, 231211807, 3, 640x360 
0x12CB3460, 36963308008592840, 231211834, 231211838, 4, 640x360 
0x12CB3460, 36963308009077392, 231211884, 231211892, 8, 640x360 
0x12CB3460, 36963308009232368, 231211903, 231211906, 3, 640x360 
0x12CB3460, 36963308009552256, 231211935, 231211937, 2, 640x360 
0x12CB3460, 36963308009871632, 231211963, 231211966, 3, 640x360 
0x12CB3460, 36963308010190760, 231211994, 231211997, 3, 640x360 
0x12CB3460, 36963308010511544, 231212024, 231212028, 4, 640x360 
0x12CB3460, 36963308010832080, 231212063, 231212067, 4, 640x360 
0x12CB3460, 36963308011151176, 231212094, 231212096, 2, 640x360 
0x12CB3460, 36963308011471248, 231212124, 231212127, 3, 640x360 
0x12CB3460, 36963308011951168, 231212174, 231212177, 3, 640x360 
0x12CB3460, 36963308012271664, 231212204, 231212207, 3, 640x360 
0x12CB3460, 36963308012590256, 231212234, 231212237, 3, 640x360 
0x12CB3460, 36963308012912576, 231212274, 231212277, 3, 640x360 
0x12CB3460, 36963308013230376, 231212303, 231212306, 3, 640x360 
0x12CB3460, 36963308013551896, 231212334, 231212337, 3, 640x360 
0x12CB3460, 36963308014066536, 231212384, 231212388, 4, 640x360 
0x12CB3460, 36963308014195280, 231212395, 231212398, 3, 640x360 
0x12CB3460, 36963308014511672, 231212434, 231212437, 3, 640x360 
0x12CB3460, 36963308014833016, 231212464, 231212467, 3, 640x360 
0x12CB3460, 36963308015151472, 231212493, 231212495, 2, 640x360 
0x12CB3460, 36963308015630544, 231212544, 231212547, 3, 640x360 
0x12CB3460, 36963308015956296, 231212574, 231212577, 3, 640x360 
0x12CB3460, 36963308016271424, 231212603, 231212606, 3, 640x360 
0x12CB3460, 36963308016592024, 231212633, 231212637, 4, 640x360 
0x12CB3460, 36963308016912800, 231212674, 231212677, 3, 640x360 
0x12CB3460, 36963308017232000, 231212705, 231212708, 3, 640x360 
0x12CB3460, 36963308017553136, 231212734, 231212737, 3, 640x360 
0x12CB3460, 36963308017871000, 231212764, 231212766, 2, 640x360 
0x12CB3460, 36963308018192184, 231212794, 231212797, 3, 640x360 
0x12CB3460, 36963308018512432, 231212834, 231212837, 3, 640x360 
0x12CB3460, 36963308019009072, 231212884, 231212892, 8, 640x360 
0x12CB3460, 36963308019156760, 231212894, 231212897, 3, 640x360 
0x12CB3460, 36963308019630384, 231212943, 231212946, 3, 640x360 
0x12CB3460, 36963308019950496, 231212974, 231212976, 2, 640x360 
0x12CB3460, 36963308020271464, 231213003, 231213005, 2, 640x360 
0x12CB3460, 36963308020591576, 231213034, 231213037, 3, 640x360 
0x12CB3460, 36963308020912112, 231213065, 231213075, 10, 640x360 
0x12CB3460, 36963308021237480, 231213104, 231213106, 2, 640x360 
0x12CB3460, 36963308021551872, 231213134, 231213137, 3, 640x360 
0x12CB3460, 36963308021872000, 231213164, 231213167, 3, 640x360 
0x12CB3460, 36963308022192928, 231213193, 231213197, 4, 640x360 
0x12CB3460, 36963308022511480, 231213235, 231213238, 3, 640x360 
0x12CB3460, 36963308022830960, 231213264, 231213267, 3, 640x360 
0x12CB3460, 36963308023152384, 231213293, 231213296, 3, 640x360 
0x12CB3460, 36963308023631192, 231213343, 231213376, 33, 640x360 
0x12CB3460, 36963308024048528, 231213384, 231213390, 6, 640x360 
0x12CB3460, 36963308024271352, 231213403, 231213406, 3, 640x360 
0x12CB3460, 36963308024592336, 231213433, 231213436, 3, 640x360 
0x12CB3460, 36963308024912288, 231213474, 231213477, 3, 640x360 
0x12CB3460, 36963308025234104, 231213504, 231213507, 3, 640x360 
0x12CB3460, 36963308025554000, 231213534, 231213537, 3, 640x360 
0x12CB3460, 36963308025875432, 231213565, 231213568, 3, 640x360 
0x12CB3460, 36963308026191576, 231213594, 231213597, 3, 640x360 
0x12CB3460, 36963308026511728, 231213633, 231213636, 3, 640x360 
0x12CB3460, 36963308026831480, 231213663, 231213666, 3, 640x360 
0x12CB3460, 36963308027314048, 231213715, 231213718, 3, 640x360 
0x12CB3460, 36963308027630296, 231213743, 231213746, 3, 640x360 
0x12CB3460, 36963308027952408, 231213773, 231213777, 4, 640x360 
0x12CB3460, 36963308028270464, 231213803, 231213806, 3, 640x360 
0x12CB3460, 36963308028591928, 231213833, 231213836, 3, 640x360 
0x12CB3460, 36963308029076992, 231213884, 231213886, 2, 640x360 
0x12CB3460, 36963308029232240, 231213904, 231213906, 2, 640x360 
0x12CB3460, 36963308029551400, 231213933, 231213936, 3, 640x360 
0x12CB3460, 36963308029870488, 231213964, 231213967, 3, 640x360 
0x12CB3460, 36963308030190576, 231213993, 231213997, 4, 640x360 
0x12CB3460, 36963308030510584, 231214024, 231214028, 4, 640x360 
0x12CB3460, 36963308030831976, 231214063, 231214066, 3, 640x360 
0x12CB3460, 36963308031311320, 231214114, 231214116, 2, 640x360 
0x12CB3460, 36963308031632552, 231214143, 231214145, 2, 640x360 
0x12CB3460, 36963308031950800, 231214173, 231214176, 3, 640x360 
0x12CB3460, 36963308032271200, 231214205, 231214208, 3, 640x360 
0x12CB3460, 36963308032591200, 231214234, 231214237, 3, 640x360 
0x12CB3460, 36963308032910576, 231214273, 231214276, 3, 640x360 
0x12CB3460, 36963308033232416, 231214304, 231214307, 3, 640x360 
0x12CB3460, 36963308033553128, 231214334, 231214337, 3, 640x360 
0x12CB3460, 36963308034043520, 231214384, 231214386, 2, 640x360 
0x12CB3460, 36963308034193360, 231214393, 231214397, 4, 640x360 
0x12CB3460, 36963308034511928, 231214434, 231214437, 3, 640x360 
0x12CB3460, 36963308034832960, 231214464, 231214467, 3, 640x360 
0x12CB3460, 36963308035313904, 231214514, 231214518, 4, 640x360 
0x12CB3460, 36963308035635304, 231214545, 231214548, 3, 640x360 
0x12CB3460, 36963308035951896, 231214573, 231214576, 3, 640x360 
0x12CB3460, 36963308036271960, 231214604, 231214622, 18, 640x360 
0x12CB3460, 36963308036592352, 231214634, 231214652, 18, 640x360 
0x12CB3460, 36963308036913304, 231214666, 231214670, 4, 640x360 
0x12CB3460, 36963308037232720, 231214704, 231214709, 5, 640x360 
0x12CB3460, 36963308037550720, 231214734, 231214738, 4, 640x360 
0x12CB3460, 36963308037871144, 231214763, 231214766, 3, 640x360 
0x12CB3460, 36963308038191600, 231214794, 231214797, 3, 640x360 
0x12CB3460, 36963308038511280, 231214833, 231214836, 3, 640x360 
0x12CB3460, 36963308038990328, 231214874, 231214877, 3, 640x360 
0x12CB3460, 36963308039311128, 231214904, 231214907, 3, 640x360 
0x12CB3460, 36963308039630416, 231214945, 231214948, 3, 640x360 
0x12CB3460, 36963308039953168, 231214974, 231214977, 3, 640x360 
0x12CB3460, 36963308040272224, 231215004, 231215007, 3, 640x360 
0x12CB3460, 36963308040593040, 231215033, 231215037, 4, 640x360 
0x12CB3460, 36963308040910680, 231215074, 231215076, 2, 640x360 
0x12CB3460, 36963308041233792, 231215103, 231215105, 2, 640x360 
0x12CB3460, 36963308041551552, 231215133, 231215136, 3, 640x360 
0x12CB3460, 36963308041872248, 231215164, 231215167, 3, 640x360 
0x12CB3460, 36963308042192232, 231215194, 231215198, 4, 640x360 
0x12CB3460, 36963308042511416, 231215233, 231215236, 3, 640x360 
0x12CB3460, 36963308042992488, 231215274, 231215277, 3, 640x360 
0x12CB3460, 36963308043312744, 231215305, 231215308, 3, 640x360 
0x12CB3460, 36963308043632688, 231215344, 231215347, 3, 640x360 
0x12CB3460, 36963308044089144, 231215384, 231215388, 4, 640x360 
0x12CB3460, 36963308044274000, 231215403, 231215406, 3, 640x360 
0x12CB3460, 36963308044591888, 231215434, 231215437, 3, 640x360 
0x12CB3460, 36963308044912088, 231215474, 231215492, 18, 640x360 
0x12CB3460, 36963308045232632, 231215504, 231215507, 3, 640x360 
0x12CB3460, 36963308045551768, 231215534, 231215537, 3, 640x360 
0x12CB3460, 36963308045870440, 231215563, 231215571, 8, 640x360 
0x12CB3460, 36963308046190424, 231215594, 231215597, 3, 640x360 
0x12CB3460, 36963308046671336, 231215643, 231215646, 3, 640x360 
0x12CB3460, 36963308046992464, 231215674, 231215677, 3, 640x360 
0x12CB3460, 36963308047312480, 231215713, 231215716, 3, 640x360 
0x12CB3460, 36963308047630888, 231215744, 231215747, 3, 640x360 
0x12CB3460, 36963308047950440, 231215773, 231215776, 3, 640x360 
0x12CB3460, 36963308048271584, 231215803, 231215821, 18, 640x360 
0x12CB3460, 36963308048592192, 231215834, 231215837, 3, 640x360 
0x12CB3460, 36963308048978768, 231215884, 231215887, 3, 640x360 
0x12CB3460, 36963308049230352, 231215904, 231215907, 3, 640x360 
0x12CB3460, 36963308049551424, 231215933, 231215936, 3, 640x360 
0x12CB3460, 36963308049870320, 231215964, 231215967, 3, 640x360 
0x12CB3460, 36963308050191376, 231215994, 231215997, 3, 640x360 
0x12CB3460, 36963308050670720, 231216044, 231216047, 3, 640x360 
0x12CB3460, 36963308050991968, 231216074, 231216077, 3, 640x360 
0x12CB3460, 36963308051311168, 231216104, 231216108, 4, 640x360 
0x12CB3460, 36963308051632032, 231216144, 231216147, 3, 640x360 
0x12CB3460, 36963308051953720, 231216174, 231216176, 2, 640x360 
0x12CB3460, 36963308052271760, 231216203, 231216206, 3, 640x360 
0x12CB3460, 36963308052590432, 231216234, 231216237, 3, 640x360 
0x12CB3460, 36963308052911688, 231216264, 231216283, 19, 640x360 
0x12CB3460, 36963308053232128, 231216304, 231216307, 3, 640x360 
0x12CB3460, 36963308053552784, 231216333, 231216336, 3, 640x360 
0x12CB3460, 36963308053972544, 231216375, 231216378, 3, 640x360 
0x12CB3460, 36963308054191304, 231216394, 231216397, 3, 640x360 
0x12CB3460, 36963308054672488, 231216443, 231216446, 3, 640x360 
0x12CB3460, 36963308054990040, 231216474, 231216477, 3, 640x360 
0x12CB3460, 36963308055310256, 231216514, 231216517, 3, 640x360 
0x12CB3460, 36963308055632784, 231216544, 231216548, 4, 640x360 
0x12CB3460, 36963308055950392, 231216574, 231216592, 18, 640x360 
0x12CB3460, 36963308056270952, 231216604, 231216607, 3, 640x360 
0x12CB3460, 36963308056593800, 231216633, 231216637, 4, 640x360 
0x12CB3460, 36963308056912200, 231216674, 231216677, 3, 640x360 
0x12CB3460, 36963308057231944, 231216703, 231216706, 3, 640x360 
0x12CB3460, 36963308057552592, 231216734, 231216737, 3, 640x360 
0x12CB3460, 36963308057870376, 231216763, 231216766, 3, 640x360 
0x12CB3460, 36963308058352240, 231216814, 231216817, 3, 640x360 
0x12CB3460, 36963308058670456, 231216843, 231216846, 3, 640x360 
0x12CB3460, 36963308059047496, 231216883, 231216886, 3, 640x360 
0x12CB3460, 36963308059311256, 231216914, 231216917, 3, 640x360 
0x12CB3460, 36963308059630776, 231216943, 231216946, 3, 640x360 
0x12CB3460, 36963308059950688, 231216974, 231216977, 3, 640x360 
0x12CB3460, 36963308060270952, 231217004, 231217007, 3, 640x360 
0x12CB3460, 36963308060592568, 231217033, 231217037, 4, 640x360 
0x12CB3460, 36963308060912496, 231217075, 231217077, 2, 640x360 
0x12CB3460, 36963308061230344, 231217103, 231217105, 2, 640x360 
0x12CB3460, 36963308061552096, 231217134, 231217136, 2, 640x360 
0x12CB3460, 36963308061871728, 231217164, 231217167, 3, 640x360 
0x12CB3460, 36963308062353664, 231217214, 231217218, 4, 640x360 
0x12CB3460, 36963308062671632, 231217244, 231217247, 3, 640x360 
0x12CB3460, 36963308062990200, 231217274, 231217277, 3, 640x360 
0x12CB3460, 36963308063312008, 231217314, 231217317, 3, 640x360 
0x12CB3460, 36963308063632784, 231217344, 231217373, 29, 640x360 
0x12CB3460, 36963308064012352, 231217384, 231217387, 3, 640x360 
0x12CB3460, 36963308064271160, 231217404, 231217407, 3, 640x360 
0x12CB3460, 36963308064591312, 231217434, 231217449, 15, 640x360 
0x12CB3460, 36963308064912088, 231217474, 231217477, 3, 640x360 
0x12CB3460, 36963308065231944, 231217503, 231217506, 3, 640x360 
0x12CB3460, 36963308065553112, 231217534, 231217537, 3, 640x360 
0x12CB3460, 36963308065874496, 231217566, 231217571, 5, 640x360 
0x12CB3460, 36963308066353352, 231217614, 231217617, 3, 640x360 
0x12CB3460, 36963308066675376, 231217644, 231217647, 3, 640x360 
0x12CB3460, 36963308066996016, 231217676, 231217680, 4, 640x360 
0x12CB3460, 36963308067313864, 231217713, 231217716, 3, 640x360 
0x12CB3460, 36963308067635096, 231217744, 231217746, 2, 640x360 
0x12CB3460, 36963308067951440, 231217773, 231217776, 3, 640x360 
0x12CB3460, 36963308068270936, 231217804, 231217822, 18, 640x360 
0x12CB3460, 36963308068591776, 231217833, 231217836, 3, 640x360 
0x12CB3460, 36963308069018496, 231217884, 231217887, 3, 640x360 
0x12CB3460, 36963308069230816, 231217904, 231217910, 6, 640x360 
0x12CB3460, 36963308069550696, 231217933, 231217935, 2, 640x360 
0x12CB3460, 36963308070031184, 231217984, 231217986, 2, 640x360 
0x12CB3460, 36963308070350648, 231218014, 231218017, 3, 640x360 
0x12CB3460, 36963308070671448, 231218044, 231218047, 3, 640x360 
0x12CB3460, 36963308070992768, 231218074, 231218077, 3, 640x360 
0x12CB3460, 36963308071311512, 231218114, 231218117, 3, 640x360 
0x12CB3460, 36963308071632472, 231218143, 231218146, 3, 640x360 
0x12CB3460, 36963308071951432, 231218174, 231218177, 3, 640x360 
0x12CB3460, 36963308072272504, 231218204, 231218206, 2, 640x360 
0x12CB3460, 36963308072592368, 231218234, 231218237, 3, 640x360 
0x12CB3460, 36963308072911624, 231218274, 231218277, 3, 640x360 
0x12CB3460, 36963308073230376, 231218304, 231218322, 18, 640x360 
0x12CB3460, 36963308073552080, 231218334, 231218337, 3, 640x360 
0x12CB3460, 36963308074065096, 231218384, 231218387, 3, 640x360 
0x12CB3460, 36963308074351040, 231218413, 231218416, 3, 640x360 
0x12CB3460, 36963308074671696, 231218444, 231218449, 5, 640x360 
0x12CB3460, 36963308074992512, 231218473, 231218477, 4, 640x360 
0x12CB3460, 36963308075313776, 231218514, 231218517, 3, 640x360 
0x12CB3460, 36963308075633992, 231218544, 231218548, 4, 640x360 
0x12CB3460, 36963308075952408, 231218573, 231218576, 3, 640x360 
0x12CB3460, 36963308076271968, 231218604, 231218607, 3, 640x360 
0x12CB3460, 36963308076593440, 231218635, 231218638, 3, 640x360 
0x12CB3460, 36963308076913272, 231218674, 231218677, 3, 640x360 
0x12CB3460, 36963308077233768, 231218704, 231218708, 4, 640x360 
0x12CB3460, 36963308077711880, 231218745, 231218748, 3, 640x360 
0x12CB3460, 36963308078030128, 231218784, 231218786, 2, 640x360 
0x12CB3460, 36963308078351792, 231218813, 231218816, 3, 640x360 
0x12CB3460, 36963308078672336, 231218844, 231218847, 3, 640x360 
0x12CB3460, 36963308079084928, 231218884, 231218887, 3, 640x360 
0x12CB3460, 36963308079310848, 231218914, 231218917, 3, 640x360 
0x12CB3460, 36963308079630568, 231218943, 231218946, 3, 640x360 
0x12CB3460, 36963308079951576, 231218974, 231218977, 3, 640x360 
0x12CB3460, 36963308080270224, 231219004, 231219006, 2, 640x360 
0x12CB3460, 36963308080592488, 231219034, 231219037, 3, 640x360 
0x12CB3460, 36963308080910872, 231219064, 231219068, 4, 640x360 
0x12CB3460, 36963308081231592, 231219104, 231219122, 18, 640x360 
0x12CB3460, 36963308081710424, 231219153, 231219156, 3, 640x360 
0x12CB3460, 36963308082031672, 231219184, 231219187, 3, 640x360 
0x12CB3460, 36963308082352656, 231219214, 231219217, 3, 640x360 
0x12CB3460, 36963308082669896, 231219244, 231219247, 3, 640x360 
0x12CB3460, 36963308082991872, 231219274, 231219277, 3, 640x360 
0x12CB3460, 36963308083312696, 231219313, 231219317, 4, 640x360 
0x12CB3460, 36963308083633280, 231219343, 231219378, 35, 640x360 
0x12CB3460, 36963308084068040, 231219383, 231219386, 3, 640x360 
0x12CB3460, 36963308084271528, 231219404, 231219407, 3, 640x360 
0x12CB3460, 36963308084590408, 231219434, 231219437, 3, 640x360 
0x12CB3460, 36963308084912040, 231219474, 231219477, 3, 640x360 
0x12CB3460, 36963308085231992, 231219504, 231219507, 3, 640x360 
0x12CB3460, 36963308085711408, 231219554, 231219557, 3, 640x360 
0x12CB3460, 36963308086031136, 231219585, 231219588, 3, 640x360 
0x12CB3460, 36963308086350184, 231219613, 231219616, 3, 640x360 
0x12CB3460, 36963308086671064, 231219644, 231219646, 2, 640x360 
0x12CB3460, 36963308086991776, 231219674, 231219677, 3, 640x360 
0x12CB3460, 36963308087311856, 231219714, 231219717, 3, 640x360 
0x12CB3460, 36963308087631192, 231219744, 231219747, 3, 640x360 
0x12CB3460, 36963308087952168, 231219774, 231219777, 3, 640x360 
0x12CB3460, 36963308088271320, 231219803, 231219806, 3, 640x360 
0x12CB3460, 36963308088590768, 231219834, 231219837, 3, 640x360 
0x12CB3460, 36963308089091928, 231219885, 231219887, 2, 640x360 
0x12CB3460, 36963308089390928, 231219914, 231219917, 3, 640x360 
0x12CB3460, 36963308089710688, 231219953, 231219956, 3, 640x360 
0x12CB3460, 36963308090031456, 231219983, 231219986, 3, 640x360 
0x12CB3460, 36963308090351104, 231220014, 231220016, 2, 640x360 
0x12CB3460, 36963308090670984, 231220043, 231220046, 3, 640x360 
0x12CB3460, 36963308090991440, 231220074, 231220077, 3, 640x360 
0x12CB3460, 36963308091311368, 231220104, 231220108, 4, 640x360 
0x12CB3460, 36963308091629888, 231220143, 231220146, 3, 640x360 
0x12CB3460, 36963308091951848, 231220174, 231220177, 3, 640x360 
0x12CB3460, 36963308092272240, 231220204, 231220207, 3, 640x360 
0x12CB3460, 36963308092596136, 231220233, 231220237, 4, 640x360 
0x12CB3460, 36963308092911696, 231220273, 231220276, 3, 640x360 
0x12CB3460, 36963308093391520, 231220314, 231220317, 3, 640x360 
0x12CB3460, 36963308093711408, 231220345, 231220348, 3, 640x360 
0x12CB3460, 36963308094064752, 231220384, 231220387, 3, 640x360 
0x12CB3460, 36963308094350160, 231220414, 231220417, 3, 640x360 
0x12CB3460, 36963308094670776, 231220444, 231220462, 18, 640x360 
0x12CB3460, 36963308094990552, 231220474, 231220477, 3, 640x360 
0x12CB3460, 36963308095312584, 231220514, 231220517, 3, 640x360 
0x12CB3460, 36963308095633584, 231220544, 231220547, 3, 640x360 
0x12CB3460, 36963308095951600, 231220573, 231220576, 3, 640x360 
0x12CB3460, 36963308096272048, 231220604, 231220607, 3, 640x360 
0x12CB3460, 36963308096593336, 231220634, 231220637, 3, 640x360 
0x12CB3460, 36963308096912464, 231220674, 231220676, 2, 640x360 
0x12CB3460, 36963308097391840, 231220715, 231220719, 4, 640x360 
0x12CB3460, 36963308097711080, 231220744, 231220748, 4, 640x360 
0x12CB3460, 36963308098030080, 231220784, 231220786, 2, 640x360 
0x12CB3460, 36963308098351280, 231220814, 231220817, 3, 640x360 
0x12CB3460, 36963308098670424, 231220844, 231220872, 28, 640x360 
0x12CB3460, 36963308099009504, 231220884, 231220887, 3, 640x360 
0x12CB3460, 36963308099310968, 231220904, 231220923, 19, 640x360 
0x12CB3460, 36963308099629904, 231220944, 231220946, 2, 640x360 
0x12CB3460, 36963308099953320, 231220974, 231220993, 19, 640x360 
0x12CB3460, 36963308100272768, 231221004, 231221006, 2, 640x360 
0x12CB3460, 36963308100591328, 231221034, 231221036, 2, 640x360 
0x12CB3460, 36963308101071632, 231221084, 231221087, 3, 640x360 
0x12CB3460, 36963308101390168, 231221114, 231221117, 3, 640x360 
0x12CB3460, 36963308101710176, 231221154, 231221157, 3, 640x360 
0x12CB3460, 36963308102030936, 231221187, 231221191, 4, 640x360 
0x12CB3460, 36963308102350984, 231221214, 231221218, 4, 640x360 
0x12CB3460, 36963308102671344, 231221243, 231221246, 3, 640x360 
0x12CB3460, 36963308102992096, 231221274, 231221277, 3, 640x360 
0x12CB3460, 36963308103311776, 231221314, 231221317, 3, 640x360 
0x12CB3460, 36963308103633072, 231221343, 231221346, 3, 640x360 
0x12CB3460, 36963308104106904, 231221393, 231221402, 9, 640x360 
0x12CB3460, 36963308104270824, 231221404, 231221407, 3, 640x360 
0x12CB3460, 36963308104590816, 231221433, 231221436, 3, 640x360 
0x12CB3460, 36963308105072224, 231221484, 231221486, 2, 640x360 
0x12CB3460, 36963308105392064, 231221513, 231221516, 3, 640x360 
0x12CB3460, 36963308105710504, 231221555, 231221558, 3, 640x360 
0x12CB3460, 36963308106032920, 231221584, 231221587, 3, 640x360 
0x12CB3460, 36963308106350048, 231221614, 231221617, 3, 640x360 
0x12CB3460, 36963308106670336, 231221644, 231221646, 2, 640x360 
0x12CB3460, 36963308106993088, 231221675, 231221692, 17, 640x360 
0x12CB3460, 36963308107313664, 231221715, 231221719, 4, 640x360 
0x12CB3460, 36963308107635784, 231221743, 231221746, 3, 640x360 
0x12CB3460, 36963308107952152, 231221773, 231221777, 4, 640x360 
0x12CB3460, 36963308108271832, 231221803, 231221807, 4, 640x360 
0x12CB3460, 36963308108593056, 231221833, 231221837, 4, 640x360 
0x12CB3460, 36963308109069992, 231221883, 231221887, 4, 640x360 
0x12CB3460, 36963308109390800, 231221914, 231221916, 2, 640x360 
0x12CB3460, 36963308109710264, 231221953, 231221956, 3, 640x360 
0x12CB3460, 36963308110030312, 231221983, 231221998, 15, 640x360 
0x12CB3460, 36963308110350912, 231222013, 231222016, 3, 640x360 
0x12CB3460, 36963308110670736, 231222043, 231222047, 4, 640x360 
0x12CB3460, 36963308110989536, 231222074, 231222077, 3, 640x360 
0x12CB3460, 36963308111310480, 231222114, 231222117, 3, 640x360 
0x12CB3460, 36963308111632704, 231222144, 231222147, 3, 640x360 
0x12CB3460, 36963308111950024, 231222174, 231222177, 3, 640x360 
0x12CB3460, 36963308112271896, 231222203, 231222207, 4, 640x360 
0x12CB3460, 36963308112751312, 231222254, 231222257, 3, 640x360 
0x12CB3460, 36963308113069632, 231222283, 231222286, 3, 640x360 
0x12CB3460, 36963308113391784, 231222314, 231222317, 3, 640x360 
0x12CB3460, 36963308113710680, 231222374, 231222378, 4, 640x360 
0x12CB3460, 36963308114050360, 231222384, 231222387, 3, 640x360 
0x12CB3460, 36963308114351344, 231222414, 231222418, 4, 640x360 
0x12CB3460, 36963308114671336, 231222444, 231222446, 2, 640x360 
0x12CB3460, 36963308114991656, 231222474, 231222493, 19, 640x360 
0x12CB3460, 36963308115311032, 231222514, 231222517, 3, 640x360 
0x12CB3460, 36963308115630776, 231222543, 231222547, 4, 640x360 
0x12CB3460, 36963308115953192, 231222573, 231222576, 3, 640x360 
0x12CB3460, 36963308116271184, 231222603, 231222606, 3, 640x360 
0x12CB3460, 36963308116753880, 231222654, 231222657, 3, 640x360 
0x12CB3460, 36963308117073120, 231222684, 231222687, 3, 640x360 
0x12CB3460, 36963308117394488, 231222716, 231222720, 4, 640x360 
0x12CB3460, 36963308117710304, 231222753, 231222756, 3, 640x360 
0x12CB3460, 36963308118032976, 231222784, 231222786, 2, 640x360 
0x12CB3460, 36963308118350184, 231222813, 231222816, 3, 640x360 
0x12CB3460, 36963308118672032, 231222844, 231222867, 23, 640x360 
0x12CB3460, 36963308118994808, 231222873, 231222877, 4, 640x360 
0x12CB3460, 36963308119310592, 231222914, 231222917, 3, 640x360 
0x12CB3460, 36963308119632504, 231222943, 231222946, 3, 640x360 
0x12CB3460, 36963308119952280, 231222974, 231222977, 3, 640x360 
0x12CB3460, 36963308120431736, 231223024, 231223042, 18, 640x360 
0x12CB3460, 36963308120752672, 231223053, 231223056, 3, 640x360 
0x12CB3460, 36963308121069512, 231223083, 231223086, 3, 640x360 
0x12CB3460, 36963308121389848, 231223113, 231223116, 3, 640x360 
0x12CB3460, 36963308121710320, 231223153, 231223156, 3, 640x360 
0x12CB3460, 36963308122032496, 231223184, 231223187, 3, 640x360 
0x12CB3460, 36963308122352360, 231223214, 231223217, 3, 640x360 
0x12CB3460, 36963308122669568, 231223245, 231223248, 3, 640x360 
0x12CB3460, 36963308122990816, 231223275, 231223293, 18, 640x360 
0x12CB3460, 36963308123311608, 231223313, 231223316, 3, 640x360 
0x12CB3460, 36963308123632896, 231223344, 231223347, 3, 640x360 
0x12CB3460, 36963308124085032, 231223385, 231223388, 3, 640x360 
0x12CB3460, 36963308124431272, 231223424, 231223427, 3, 640x360 
0x12CB3460, 36963308124749808, 231223454, 231223457, 3, 640x360 
0x12CB3460, 36963308125071352, 231223483, 231223486, 3, 640x360 
0x12CB3460, 36963308125392104, 231223515, 231223518, 3, 640x360 
0x12CB3460, 36963308125711008, 231223554, 231223557, 3, 640x360 
0x12CB3460, 36963308126033376, 231223584, 231223588, 4, 640x360 
0x12CB3460, 36963308126351192, 231223613, 231223616, 3, 640x360 
0x12CB3460, 36963308126671224, 231223644, 231223647, 3, 640x360 
0x12CB3460, 36963308126992408, 231223674, 231223677, 3, 640x360 
0x12CB3460, 36963308127315008, 231223714, 231223717, 3, 640x360 
0x12CB3460, 36963308127630472, 231223744, 231223746, 2, 640x360 
0x12CB3460, 36963308127953664, 231223773, 231223776, 3, 640x360 
0x12CB3460, 36963308128429640, 231223824, 231223826, 2, 640x360 
0x12CB3460, 36963308128751160, 231223883, 231223886, 3, 640x360 
0x12CB3460, 36963308129391232, 231223913, 231223916, 3, 640x360 
0x12CB3460, 36963308129712760, 231223954, 231223964, 10, 640x360 
0x12CB3460, 36963308130031112, 231223984, 231223987, 3, 640x360 
0x12CB3460, 36963308130350160, 231224014, 231224017, 3, 640x360 
0x12CB3460, 36963308130669696, 231224043, 231224046, 3, 640x360 
0x12CB3460, 36963308130991176, 231224073, 231224077, 4, 640x360 
0x12CB3460, 36963308131311048, 231224104, 231224108, 4, 640x360 
0x12CB3460, 36963308131630648, 231224144, 231224147, 3, 640x360 
0x12CB3460, 36963308132110624, 231224184, 231224188, 4, 640x360 
0x12CB3460, 36963308132429376, 231224224, 231224227, 3, 640x360 
0x12CB3460, 36963308132750728, 231224253, 231224256, 3, 640x360 
0x12CB3460, 36963308133071992, 231224283, 231224286, 3, 640x360 
0x12CB3460, 36963308133391208, 231224313, 231224316, 3, 640x360 
0x12CB3460, 36963308133710144, 231224344, 231224348, 4, 640x360 
0x12CB3460, 36963308134043112, 231224383, 231224386, 3, 640x360 
0x12CB3460, 36963308134349904, 231224414, 231224417, 3, 640x360 
0x12CB3460, 36963308134670648, 231224444, 231224446, 2, 640x360 
0x12CB3460, 36963308134991640, 231224474, 231224477, 3, 640x360 
0x12CB3460, 36963308135312216, 231224514, 231224517, 3, 640x360 
0x12CB3460, 36963308135635520, 231224544, 231224547, 3, 640x360 
0x12CB3460, 36963308136111824, 231224594, 231224597, 3, 640x360 
0x12CB3460, 36963308136429864, 231224624, 231224626, 2, 640x360 
0x12CB3460, 36963308136751928, 231224653, 231224671, 18, 640x360 
0x12CB3460, 36963308137071840, 231224685, 231224688, 3, 640x360 
0x12CB3460, 36963308137391520, 231224715, 231224718, 3, 640x360 
0x12CB3460, 36963308137711408, 231224754, 231224756, 2, 640x360 
0x12CB3460, 36963308138041672, 231224783, 231224786, 3, 640x360 
0x12CB3460, 36963308138351200, 231224814, 231224817, 3, 640x360 
0x12CB3460, 36963308138670760, 231224844, 231224876, 32, 640x360 
0x12CB3460, 36963308139053304, 231224883, 231224886, 3, 640x360 
0x12CB3460, 36963308139310832, 231224913, 231224916, 3, 640x360 
0x12CB3460, 36963308139630464, 231224943, 231224946, 3, 640x360 
0x12CB3460, 36963308140110688, 231224994, 231224997, 3, 640x360 
0x12CB3460, 36963308140430568, 231225025, 231225027, 2, 640x360 
0x12CB3460, 36963308140750136, 231225054, 231225057, 3, 640x360 
0x12CB3460, 36963308141070432, 231225083, 231225085, 2, 640x360 
0x12CB3460, 36963308141390904, 231225114, 231225116, 2, 640x360 
0x12CB3460, 36963308141710400, 231225154, 231225157, 3, 640x360 
0x12CB3460, 36963308142032440, 231225183, 231225186, 3, 640x360 
0x12CB3460, 36963308142352960, 231225214, 231225217, 3, 640x360 
0x12CB3460, 36963308142672112, 231225244, 231225247, 3, 640x360 
0x12CB3460, 36963308142990064, 231225274, 231225292, 18, 640x360 
0x12CB3460, 36963308143310912, 231225314, 231225317, 3, 640x360 
0x12CB3460, 36963308143814664, 231225374, 231225377, 3, 640x360 
0x12CB3460, 36963308144111016, 231225394, 231225401, 7, 640x360 
0x12CB3460, 36963308144429848, 231225424, 231225442, 18, 640x360 
0x12CB3460, 36963308144751552, 231225453, 231225456, 3, 640x360 
0x12CB3460, 36963308145070456, 231225484, 231225487, 3, 640x360 
0x12CB3460, 36963308145393064, 231225514, 231225518, 4, 640x360 
0x12CB3460, 36963308145712864, 231225556, 231225560, 4, 640x360 
0x12CB3460, 36963308146031480, 231225585, 231225588, 3, 640x360 
0x12CB3460, 36963308146350544, 231225614, 231225617, 3, 640x360 
0x12CB3460, 36963308146672648, 231225643, 231225646, 3, 640x360 
0x12CB3460, 36963308146993000, 231225675, 231225678, 3, 640x360 
0x12CB3460, 36963308147313232, 231225715, 231225718, 3, 640x360 
0x12CB3460, 36963308147791720, 231225755, 231225757, 2, 640x360 
0x12CB3460, 36963308148110416, 231225784, 231225787, 3, 640x360 
0x12CB3460, 36963308148431608, 231225824, 231225826, 2, 640x360 
0x12CB3460, 36963308148751576, 231225853, 231225884, 31, 640x360 
0x12CB3460, 36963308149112960, 231225893, 231225896, 3, 640x360 
0x12CB3460, 36963308149391480, 231225913, 231225916, 3, 640x360 
0x12CB3460, 36963308149710144, 231225944, 231225947, 3, 640x360 
0x12CB3460, 36963308150031480, 231225983, 231225986, 3, 640x360 
0x12CB3460, 36963308150350536, 231226013, 231226015, 2, 640x360 
0x12CB3460, 36963308150670464, 231226044, 231226047, 3, 640x360 
0x12CB3460, 36963308150991496, 231226073, 231226076, 3, 640x360 
0x12CB3460, 36963308151310808, 231226104, 231226108, 4, 640x360 
0x12CB3460, 36963308151791424, 231226153, 231226156, 3, 640x360 
0x12CB3460, 36963308152109504, 231226184, 231226188, 4, 640x360 
0x12CB3460, 36963308152433376, 231226223, 231226226, 3, 640x360 
0x12CB3460, 36963308152749400, 231226253, 231226256, 3, 640x360 
0x12CB3460, 36963308153071832, 231226283, 231226286, 3, 640x360 
0x12CB3460, 36963308153391064, 231226314, 231226317, 3, 640x360 
0x12CB3460, 36963308153709976, 231226373, 231226377, 4, 640x360 
0x12CB3460, 36963308154055992, 231226384, 231226387, 3, 640x360 
0x12CB3460, 36963308154349480, 231226414, 231226416, 2, 640x360 
0x12CB3460, 36963308154670200, 231226444, 231226447, 3, 640x360 
0x12CB3460, 36963308154990296, 231226474, 231226491, 17, 640x360 
0x12CB3460, 36963308155472352, 231226524, 231226527, 3, 640x360 
0x12CB3460, 36963308155793800, 231226554, 231226558, 4, 640x360 
0x12CB3460, 36963308156110584, 231226594, 231226598, 4, 640x360 
0x12CB3460, 36963308156429560, 231226624, 231226626, 2, 640x360 
0x12CB3460, 36963308156751224, 231226653, 231226656, 3, 640x360 
0x12CB3460, 36963308157071816, 231226685, 231226688, 3, 640x360 
0x12CB3460, 36963308157391488, 231226714, 231226718, 4, 640x360 
0x12CB3460, 36963308157709400, 231226753, 231226756, 3, 640x360 
0x12CB3460, 36963308158030728, 231226784, 231226787, 3, 640x360 
0x12CB3460, 36963308158350880, 231226813, 231226816, 3, 640x360 
0x12CB3460, 36963308158671392, 231226844, 231226874, 30, 640x360 
0x12CB3460, 36963308159030624, 231226883, 231226886, 3, 640x360 
0x12CB3460, 36963308159470600, 231226923, 231226926, 3, 640x360 
0x12CB3460, 36963308159789128, 231226953, 231226956, 3, 640x360 
0x12CB3460, 36963308160111824, 231226984, 231226988, 4, 640x360 
0x12CB3460, 36963308160430960, 231227024, 231227027, 3, 640x360 
0x12CB3460, 36963308160753232, 231227054, 231227057, 3, 640x360 
0x12CB3460, 36963308161070688, 231227084, 231227090, 6, 640x360 
0x12CB3460, 36963308161389480, 231227114, 231227116, 2, 640x360 
0x12CB3460, 36963308161709912, 231227145, 231227148, 3, 640x360 
0x12CB3460, 36963308162032104, 231227183, 231227186, 3, 640x360 
0x12CB3460, 36963308162353352, 231227215, 231227218, 3, 640x360 
0x12CB3460, 36963308162671032, 231227243, 231227247, 4, 640x360 
0x12CB3460, 36963308163151288, 231227294, 231227297, 3, 640x360 
0x12CB3460, 36963308163471912, 231227324, 231227327, 3, 640x360 
0x12CB3460, 36963308163792840, 231227382, 231227389, 7, 640x360 
0x12CB3460, 36963308164175504, 231227394, 231227397, 3, 640x360 
0x12CB3460, 36963308164430192, 231227424, 231227427, 3, 640x360 
0x12CB3460, 36963308164750056, 231227453, 231227456, 3, 640x360 
0x12CB3460, 36963308165072088, 231227485, 231227488, 3, 640x360 
0x12CB3460, 36963308165392432, 231227514, 231227517, 3, 640x360 
0x12CB3460, 36963308165712272, 231227555, 231227558, 3, 640x360 
0x12CB3460, 36963308166029696, 231227583, 231227586, 3, 640x360 
0x12CB3460, 36963308166351176, 231227613, 231227631, 18, 640x360 
0x12CB3460, 36963308166672128, 231227643, 231227646, 3, 640x360 
0x12CB3460, 36963308167154680, 231227696, 231227699, 3, 640x360 
0x12CB3460, 36963308167472688, 231227734, 231227737, 3, 640x360 
0x12CB3460, 36963308167790528, 231227754, 231227757, 3, 640x360 
0x12CB3460, 36963308168111128, 231227794, 231227797, 3, 640x360 
0x12CB3460, 36963308168431400, 231227824, 231227827, 3, 640x360 
0x12CB3460, 36963308169020560, 231227885, 231227887, 2, 640x360 
0x12CB3460, 36963308169390472, 231227914, 231227917, 3, 640x360 
0x12CB3460, 36963308169710480, 231227945, 231227948, 3, 640x360 
0x12CB3460, 36963308170030312, 231227984, 231227987, 3, 640x360 
0x12CB3460, 36963308170350320, 231228013, 231228016, 3, 640x360 
0x12CB3460, 36963308170670224, 231228044, 231228048, 4, 640x360 
0x12CB3460, 36963308171153824, 231228093, 231228096, 3, 640x360 
0x12CB3460, 36963308171470880, 231228124, 231228127, 3, 640x360 
0x12CB3460, 36963308171791240, 231228153, 231228156, 3, 640x360 
0x12CB3460, 36963308172110656, 231228195, 231228198, 3, 640x360 
0x12CB3460, 36963308172435928, 231228224, 231228228, 4, 640x360 
0x12CB3460, 36963308172750784, 231228254, 231228256, 2, 640x360 
0x12CB3460, 36963308173070664, 231228284, 231228286, 2, 640x360 
0x12CB3460, 36963308173391024, 231228314, 231228317, 3, 640x360 
0x12CB3460, 36963308173711640, 231228384, 231228387, 3, 640x360 
0x12CB3460, 36963308174356680, 231228414, 231228417, 3, 640x360 
0x12CB3460, 36963308174831704, 231228463, 231228466, 3, 640x360 
0x12CB3460, 36963308175151160, 231228493, 231228496, 3, 640x360 
0x12CB3460, 36963308175469336, 231228524, 231228526, 2, 640x360 
0x12CB3460, 36963308175789296, 231228554, 231228557, 3, 640x360 
0x12CB3460, 36963308176110520, 231228584, 231228587, 3, 640x360 
0x12CB3460, 36963308176429784, 231228623, 231228626, 3, 640x360 
0x12CB3460, 36963308176751232, 231228653, 231228656, 3, 640x360 
0x12CB3460, 36963308177070424, 231228683, 231228686, 3, 640x360 
0x12CB3460, 36963308177391048, 231228713, 231228716, 3, 640x360 
0x12CB3460, 36963308177710376, 231228753, 231228756, 3, 640x360 
0x12CB3460, 36963308178030056, 231228783, 231228786, 3, 640x360 
0x12CB3460, 36963308178349872, 231228813, 231228815, 2, 640x360 
0x12CB3460, 36963308179035888, 231228884, 231228886, 2, 640x360 
0x12CB3460, 36963308179152960, 231228893, 231228896, 3, 640x360 
0x12CB3460, 36963308179469336, 231228923, 231228926, 3, 640x360 
0x12CB3460, 36963308179790752, 231228954, 231228957, 3, 640x360 
0x12CB3460, 36963308180111184, 231228993, 231228996, 3, 640x360 
0x12CB3460, 36963308180430672, 231229024, 231229026, 2, 640x360 
0x12CB3460, 36963308180754320, 231229054, 231229057, 3, 640x360 
0x12CB3460, 36963308181069952, 231229083, 231229086, 3, 640x360 
0x12CB3460, 36963308181390952, 231229113, 231229131, 18, 640x360 
0x12CB3460, 36963308181710304, 231229154, 231229157, 3, 640x360 
0x12CB3460, 36963308182351000, 231229214, 231229217, 3, 640x360 
0x12CB3460, 36963308182829200, 231229264, 231229267, 3, 640x360 
0x12CB3460, 36963308183149208, 231229294, 231229297, 3, 640x360 
0x12CB3460, 36963308183469488, 231229323, 231229325, 2, 640x360 
0x12CB3460, 36963308183966840, 231229374, 231229377, 3, 640x360 
0x12CB3460, 36963308184110392, 231229394, 231229398, 4, 640x360 
0x12CB3460, 36963308184429544, 231229423, 231229426, 3, 640x360 
0x12CB3460, 36963308184750280, 231229454, 231229457, 3, 640x360 
0x12CB3460, 36963308185069920, 231229483, 231229486, 3, 640x360 
0x12CB3460, 36963308185390744, 231229514, 231229518, 4, 640x360 
0x12CB3460, 36963308185710400, 231229554, 231229557, 3, 640x360 
0x12CB3460, 36963308186030064, 231229583, 231229586, 3, 640x360 
0x12CB3460, 36963308186509120, 231229634, 231229636, 2, 640x360 
0x12CB3460, 36963308186832336, 231229663, 231229666, 3, 640x360 
0x12CB3460, 36963308187152856, 231229695, 231229698, 3, 640x360 
0x12CB3460, 36963308187473648, 231229724, 231229727, 3, 640x360 
0x12CB3460, 36963308187791832, 231229754, 231229757, 3, 640x360 
0x12CB3460, 36963308188109664, 231229794, 231229797, 3, 640x360 
0x12CB3460, 36963308188430224, 231229824, 231229827, 3, 640x360 
0x12CB3460, 36963308188772344, 231229874, 231229879, 5, 640x360 
0x12CB3460, 36963308189072672, 231229884, 231229887, 3, 640x360 
0x12CB3460, 36963308189390720, 231229914, 231229916, 2, 640x360 
0x12CB3460, 36963308189709784, 231229953, 231229956, 3, 640x360 
0x12CB3460, 36963308190030000, 231229984, 231229986, 2, 640x360 
0x12CB3460, 36963308190509408, 231230024, 231230028, 4, 640x360 
0x12CB3460, 36963308190830304, 231230064, 231230067, 3, 640x360 
0x12CB3460, 36963308191150280, 231230093, 231230097, 4, 640x360 
0x12CB3460, 36963308191470360, 231230123, 231230126, 3, 640x360 
0x12CB3460, 36963308191790904, 231230154, 231230158, 4, 640x360 
0x12CB3460, 36963308192111024, 231230194, 231230212, 18, 640x360 
0x12CB3460, 36963308192431552, 231230223, 231230226, 3, 640x360 
0x12CB3460, 36963308192750128, 231230253, 231230256, 3, 640x360 
0x12CB3460, 36963308193070536, 231230283, 231230286, 3, 640x360 
0x12CB3460, 36963308193391512, 231230314, 231230317, 3, 640x360 
0x12CB3460, 36963308193711512, 231230380, 231230384, 4, 640x360 
0x12CB3460, 36963308194190240, 231230393, 231230396, 3, 640x360 
0x12CB3460, 36963308194510168, 231230424, 231230427, 3, 640x360 
0x12CB3460, 36963308194831056, 231230463, 231230466, 3, 640x360 
0x12CB3460, 36963308195150312, 231230493, 231230496, 3, 640x360 
0x12CB3460, 36963308195471288, 231230524, 231230527, 3, 640x360 
0x12CB3460, 36963308195792472, 231230555, 231230558, 3, 640x360 
0x12CB3460, 36963308196110528, 231230594, 231230596, 2, 640x360 
0x12CB3460, 36963308196431048, 231230624, 231230626, 2, 640x360 
0x12CB3460, 36963308196750224, 231230654, 231230657, 3, 640x360 
0x12CB3460, 36963308197071072, 231230683, 231230686, 3, 640x360 
0x12CB3460, 36963308197391880, 231230714, 231230718, 4, 640x360 
0x12CB3460, 36963308197710480, 231230754, 231230758, 4, 640x360 
0x12CB3460, 36963308198190488, 231230794, 231230797, 3, 640x360 
0x12CB3460, 36963308198510232, 231230834, 231230836, 2, 640x360 
0x12CB3460, 36963308198982880, 231230874, 231230878, 4, 640x360 
0x12CB3460, 36963308199150304, 231230894, 231230912, 18, 640x360 
0x12CB3460, 36963308199469672, 231230923, 231230926, 3, 640x360 
0x12CB3460, 36963308199791152, 231230954, 231230957, 3, 640x360 
0x12CB3460, 36963308200111808, 231230994, 231230997, 3, 640x360 
0x12CB3460, 36963308200431120, 231231023, 231231026, 3, 640x360 
0x12CB3460, 36963308200750856, 231231053, 231231056, 3, 640x360 
0x12CB3460, 36963308201071288, 231231085, 231231089, 4, 640x360 
0x12CB3460, 36963308201389288, 231231113, 231231116, 3, 640x360 
0x12CB3460, 36963308201711536, 231231153, 231231156, 3, 640x360 
0x12CB3460, 36963308202192072, 231231194, 231231198, 4, 640x360 
0x12CB3460, 36963308202510016, 231231234, 231231236, 2, 640x360 
0x12CB3460, 36963308202831048, 231231264, 231231267, 3, 640x360 
0x12CB3460, 36963308203149680, 231231294, 231231296, 2, 640x360 
0x12CB3460, 36963308203471000, 231231323, 231231326, 3, 640x360 
0x12CB3460, 36963308204003152, 231231385, 231231388, 3, 640x360 
0x12CB3460, 36963308204429576, 231231424, 231231426, 2, 640x360 
0x12CB3460, 36963308204751000, 231231453, 231231456, 3, 640x360 
0x12CB3460, 36963308205071272, 231231484, 231231487, 3, 640x360 
0x12CB3460, 36963308205393400, 231231514, 231231518, 4, 640x360 
0x12CB3460, 36963308205875888, 231231565, 231231569, 4, 640x360 
0x12CB3460, 36963308206194312, 231231604, 231231608, 4, 640x360 
0x12CB3460, 36963308206511208, 231231634, 231231637, 3, 640x360 
0x12CB3460, 36963308206830392, 231231664, 231231667, 3, 640x360 
0x12CB3460, 36963308207151056, 231231695, 231231698, 3, 640x360 
0x12CB3460, 36963308207480600, 231231725, 231231729, 4, 640x360 
0x12CB3460, 36963308207790680, 231231753, 231231756, 3, 640x360 
0x12CB3460, 36963308208110368, 231231784, 231231788, 4, 640x360 
0x12CB3460, 36963308208431400, 231231824, 231231827, 3, 640x360 
0x12CB3460, 36963308208750264, 231231853, 231231884, 31, 640x360 
0x12CB3460, 36963308209130368, 231231894, 231231897, 3, 640x360 
0x12CB3460, 36963308209390232, 231231915, 231231917, 2, 640x360 
0x12CB3460, 36963308209871120, 231231963, 231231965, 2, 640x360 
0x12CB3460, 36963308210190800, 231231994, 231231997, 3, 640x360 
0x12CB3460, 36963308210508672, 231232024, 231232028, 4, 640x360 
0x12CB3460, 36963308210829528, 231232063, 231232066, 3, 640x360 
0x12CB3460, 36963308211152440, 231232094, 231232097, 3, 640x360 
0x12CB3460, 36963308211469144, 231232123, 231232125, 2, 640x360 
0x12CB3460, 36963308211790408, 231232154, 231232157, 3, 640x360 
0x12CB3460, 36963308212110648, 231232193, 231232196, 3, 640x360 
0x12CB3460, 36963308212432496, 231232223, 231232226, 3, 640x360 
0x12CB3460, 36963308212750520, 231232254, 231232256, 2, 640x360 
0x12CB3460, 36963308213070968, 231232283, 231232286, 3, 640x360 
0x12CB3460, 36963308213391768, 231232314, 231232317, 3, 640x360 
0x12CB3460, 36963308214041936, 231232383, 231232386, 3, 640x360 
0x12CB3460, 36963308214190008, 231232393, 231232396, 3, 640x360 
0x12CB3460, 36963308214510944, 231232433, 231232450, 17, 640x360 
0x12CB3460, 36963308214840264, 231232464, 231232466, 2, 640x360 
0x12CB3460, 36963308215149368, 231232493, 231232496, 3, 640x360 
0x12CB3460, 36963308215469904, 231232524, 231232527, 3, 640x360 
0x12CB3460, 36963308215792480, 231232554, 231232572, 18, 640x360 
0x12CB3460, 36963308216111856, 231232595, 231232598, 3, 640x360 
0x12CB3460, 36963308216430296, 231232624, 231232627, 3, 640x360 
0x12CB3460, 36963308216751568, 231232653, 231232656, 3, 640x360 
0x12CB3460, 36963308217076496, 231232686, 231232691, 5, 640x360 
0x12CB3460, 36963308217549008, 231232734, 231232740, 6, 640x360 
0x12CB3460, 36963308217870192, 231232763, 231232766, 3, 640x360 
0x12CB3460, 36963308218189992, 231232794, 231232796, 2, 640x360 
0x12CB3460, 36963308218510800, 231232833, 231232836, 3, 640x360 
0x12CB3460, 36963308218998168, 231232874, 231232878, 4, 640x360 
0x12CB3460, 36963308219150264, 231232893, 231232897, 4, 640x360 
0x12CB3460, 36963308219470584, 231232923, 231232926, 3, 640x360 
0x12CB3460, 36963308219790272, 231232954, 231232957, 3, 640x360 
0x12CB3460, 36963308220111960, 231232994, 231232997, 3, 640x360 
0x12CB3460, 36963308220429704, 231233024, 231233026, 2, 640x360 
0x12CB3460, 36963308220749976, 231233054, 231233057, 3, 640x360 
0x12CB3460, 36963308221069488, 231233083, 231233087, 4, 640x360 
0x12CB3460, 36963308221548544, 231233133, 231233136, 3, 640x360 
0x12CB3460, 36963308221868696, 231233164, 231233167, 3, 640x360 
0x12CB3460, 36963308222189976, 231233194, 231233196, 2, 640x360 
0x12CB3460, 36963308222508816, 231233233, 231233236, 3, 640x360 
0x12CB3460, 36963308222830448, 231233263, 231233266, 3, 640x360 
0x12CB3460, 36963308223151664, 231233293, 231233296, 3, 640x360 
0x12CB3460, 36963308223471104, 231233324, 231233327, 3, 640x360 
0x12CB3460, 36963308223791616, 231233378, 231233386, 8, 640x360 
0x12CB3460, 36963308224111496, 231233394, 231233396, 2, 640x360 
0x12CB3460, 36963308224430536, 231233424, 231233427, 3, 640x360 
0x12CB3460, 36963308224749408, 231233453, 231233456, 3, 640x360 
0x12CB3460, 36963308225070776, 231233484, 231233486, 2, 640x360 
0x12CB3460, 36963308225551176, 231233534, 231233537, 3, 640x360 
0x12CB3460, 36963308225872384, 231233564, 231233568, 4, 640x360 
0x12CB3460, 36963308226192048, 231233594, 231233597, 3, 640x360 
0x12CB3460, 36963308226509240, 231233633, 231233636, 3, 640x360 
0x12CB3460, 36963308226832096, 231233663, 231233666, 3, 640x360 
0x12CB3460, 36963308227152000, 231233694, 231233697, 3, 640x360 
0x12CB3460, 36963308227470008, 231233725, 231233727, 2, 640x360 
0x12CB3460, 36963308227790080, 231233753, 231233756, 3, 640x360 
0x12CB3460, 36963308228111632, 231233793, 231233796, 3, 640x360 
0x12CB3460, 36963308228430408, 231233823, 231233826, 3, 640x360 
0x12CB3460, 36963308228751248, 231233877, 231233880, 3, 640x360 
0x12CB3460, 36963308229230072, 231233903, 231233906, 3, 640x360 
0x12CB3460, 36963308229549448, 231233933, 231233936, 3, 640x360 
0x12CB3460, 36963308229871752, 231233964, 231233967, 3, 640x360 
0x12CB3460, 36963308230188896, 231233995, 231233997, 2, 640x360 
0x12CB3460, 36963308230510104, 231234035, 231234038, 3, 640x360 
0x12CB3460, 36963308230830656, 231234063, 231234066, 3, 640x360 
0x12CB3460, 36963308231150184, 231234094, 231234097, 3, 640x360 
0x12CB3460, 36963308231469680, 231234123, 231234126, 3, 640x360 
0x12CB3460, 36963308231789664, 231234154, 231234156, 2, 640x360 
0x12CB3460, 36963308232110536, 231234194, 231234197, 3, 640x360 
0x12CB3460, 36963308232431528, 231234224, 231234227, 3, 640x360 
0x12CB3460, 36963308232750600, 231234253, 231234256, 3, 640x360 
0x12CB3460, 36963308233231280, 231234304, 231234306, 2, 640x360 
0x12CB3460, 36963308233549704, 231234333, 231234336, 3, 640x360 
0x12CB3460, 36963308234035136, 231234384, 231234386, 2, 640x360 
0x12CB3460, 36963308234190504, 231234403, 231234406, 3, 640x360 
0x12CB3460, 36963308234509264, 231234424, 231234427, 3, 640x360 
0x12CB3460, 36963308234831032, 231234463, 231234467, 4, 640x360 
0x12CB3460, 36963308235149544, 231234493, 231234496, 3, 640x360 
0x12CB3460, 36963308235471248, 231234524, 231234527, 3, 640x360 
0x12CB3460, 36963308235792280, 231234554, 231234572, 18, 640x360 
0x12CB3460, 36963308236112184, 231234594, 231234598, 4, 640x360 
0x12CB3460, 36963308236429664, 231234623, 231234626, 3, 640x360 
0x12CB3460, 36963308236912696, 231234674, 231234677, 3, 640x360 
0x12CB3460, 36963308237229664, 231234703, 231234707, 4, 640x360 
0x12CB3460, 36963308237550488, 231234734, 231234737, 3, 640x360 
0x12CB3460, 36963308237870584, 231234763, 231234766, 3, 640x360 
0x12CB3460, 36963308238189824, 231234794, 231234796, 2, 640x360 
0x12CB3460, 36963308238510704, 231234834, 231234836, 2, 640x360 
0x12CB3460, 36963308238829192, 231234883, 231234887, 4, 640x360 
0x12CB3460, 36963308239151240, 231234894, 231234897, 3, 640x360 
0x12CB3460, 36963308239471960, 231234924, 231234926, 2, 640x360 
0x12CB3460, 36963308239790160, 231234954, 231234957, 3, 640x360 
0x12CB3460, 36963308240110912, 231234993, 231234995, 2, 640x360 
0x12CB3460, 36963308240431736, 231235024, 231235027, 3, 640x360 
0x12CB3460, 36963308240909480, 231235064, 231235068, 4, 640x360 
0x12CB3460, 36963308241229080, 231235104, 231235106, 2, 640x360 
0x12CB3460, 36963308241550520, 231235133, 231235135, 2, 640x360 
0x12CB3460, 36963308241871312, 231235164, 231235167, 3, 640x360 
0x12CB3460, 36963308242192584, 231235194, 231235197, 3, 640x360 
0x12CB3460, 36963308242511416, 231235234, 231235237, 3, 640x360 
0x12CB3460, 36963308242830568, 231235263, 231235266, 3, 640x360 
0x12CB3460, 36963308243150872, 231235293, 231235297, 4, 640x360 
0x12CB3460, 36963308243470472, 231235324, 231235328, 4, 640x360 
0x12CB3460, 36963308244041176, 231235383, 231235387, 4, 640x360 
0x12CB3460, 36963308244109896, 231235394, 231235397, 3, 640x360 
0x12CB3460, 36963308244429272, 231235423, 231235425, 2, 640x360 
0x12CB3460, 36963308244909736, 231235474, 231235477, 3, 640x360 
0x12CB3460, 36963308245229608, 231235503, 231235507, 4, 640x360 
0x12CB3460, 36963308245552992, 231235534, 231235537, 3, 640x360 
0x12CB3460, 36963308245871624, 231235564, 231235568, 4, 640x360 
0x12CB3460, 36963308246191488, 231235593, 231235597, 4, 640x360 
0x12CB3460, 36963308246510344, 231235633, 231235636, 3, 640x360 
0x12CB3460, 36963308246829744, 231235663, 231235666, 3, 640x360 
0x12CB3460, 36963308247151240, 231235694, 231235697, 3, 640x360 
0x12CB3460, 36963308247470304, 231235724, 231235727, 3, 640x360 
0x12CB3460, 36963308247790312, 231235755, 231235757, 2, 640x360 
0x12CB3460, 36963308248109968, 231235784, 231235787, 3, 640x360 
0x12CB3460, 36963308248591168, 231235834, 231235837, 3, 640x360 
0x12CB3460, 36963308248954440, 231235874, 231235877, 3, 640x360 
0x12CB3460, 36963308249228808, 231235903, 231235906, 3, 640x360 
0x12CB3460, 36963308249549816, 231235934, 231235936, 2, 640x360 
0x12CB3460, 36963308249869392, 231235963, 231235966, 3, 640x360 
0x12CB3460, 36963308250190464, 231235994, 231235997, 3, 640x360 
0x12CB3460, 36963308250510472, 231236033, 231236036, 3, 640x360 
0x12CB3460, 36963308250831280, 231236063, 231236066, 3, 640x360 
0x12CB3460, 36963308251149816, 231236093, 231236096, 3, 640x360 
0x12CB3460, 36963308251471624, 231236123, 231236126, 3, 640x360 
0x12CB3460, 36963308251790248, 231236154, 231236157, 3, 640x360 
0x12CB3460, 36963308252110832, 231236194, 231236197, 3, 640x360 
0x12CB3460, 36963308252589808, 231236235, 231236237, 2, 640x360 
0x12CB3460, 36963308252910504, 231236273, 231236275, 2, 640x360 
0x12CB3460, 36963308253230568, 231236303, 231236306, 3, 640x360 
0x12CB3460, 36963308253551216, 231236334, 231236337, 3, 640x360 
0x12CB3460, 36963308254139624, 231236394, 231236396, 2, 640x360 
0x12CB3460, 36963308254511584, 231236433, 231236435, 2, 640x360 
0x12CB3460, 36963308254829112, 231236463, 231236466, 3, 640x360 
0x12CB3460, 36963308255150352, 231236493, 231236495, 2, 640x360 
0x12CB3460, 36963308255792480, 231236554, 231236557, 3, 640x360 
0x12CB3460, 36963308256111936, 231236594, 231236597, 3, 640x360 
0x12CB3460, 36963308256590744, 231236634, 231236636, 2, 640x360 
0x12CB3460, 36963308256909288, 231236674, 231236677, 3, 640x360 
0x12CB3460, 36963308257233016, 231236703, 231236714, 11, 640x360 
0x12CB3460, 36963308257550784, 231236734, 231236736, 2, 640x360 
0x12CB3460, 36963308257869704, 231236763, 231236766, 3, 640x360 
0x12CB3460, 36963308258189560, 231236794, 231236798, 4, 640x360 
0x12CB3460, 36963308258509584, 231236833, 231236836, 3, 640x360 
0x12CB3460, 36963308259046824, 231236884, 231236887, 3, 640x360 
0x12CB3460, 36963308259149000, 231236894, 231236896, 2, 640x360 
0x12CB3460, 36963308259468856, 231236923, 231236926, 3, 640x360 
0x12CB3460, 36963308259790784, 231236953, 231236956, 3, 640x360 
0x12CB3460, 36963308260271320, 231237004, 231237007, 3, 640x360 
0x12CB3460, 36963308260591728, 231237045, 231237048, 3, 640x360 
0x12CB3460, 36963308260908800, 231237074, 231237079, 5, 640x360 
0x12CB3460, 36963308261228848, 231237103, 231237106, 3, 640x360 
0x12CB3460, 36963308261550536, 231237134, 231237136, 2, 640x360 
0x12CB3460, 36963308261869672, 231237163, 231237166, 3, 640x360 
0x12CB3460, 36963308262192336, 231237193, 231237203, 10, 640x360 
0x12CB3460, 36963308262509176, 231237233, 231237236, 3, 640x360 
0x12CB3460, 36963308262828992, 231237263, 231237266, 3, 640x360 
0x12CB3460, 36963308263150224, 231237293, 231237297, 4, 640x360 
0x12CB3460, 36963308263469704, 231237324, 231237327, 3, 640x360 
0x12CB3460, 36963308264023416, 231237384, 231237387, 3, 640x360 
0x12CB3460, 36963308264269632, 231237404, 231237406, 2, 640x360 
0x12CB3460, 36963308264590872, 231237433, 231237436, 3, 640x360 
0x12CB3460, 36963308264908984, 231237465, 231237469, 4, 640x360 
0x12CB3460, 36963308265231880, 231237503, 231237505, 2, 640x360 
0x12CB3460, 36963308265551520, 231237534, 231237537, 3, 640x360 
0x12CB3460, 36963308265872432, 231237564, 231237567, 3, 640x360 
0x12CB3460, 36963308266192232, 231237604, 231237611, 7, 640x360 
0x12CB3460, 36963308266509384, 231237624, 231237627, 3, 640x360 
0x12CB3460, 36963308266830104, 231237663, 231237667, 4, 640x360 
0x12CB3460, 36963308267150880, 231237694, 231237697, 3, 640x360 
0x12CB3460, 36963308267470696, 231237723, 231237725, 2, 640x360 
0x12CB3460, 36963308267791304, 231237753, 231237757, 4, 640x360 
0x12CB3460, 36963308268270464, 231237803, 231237805, 2, 640x360 
0x12CB3460, 36963308268591136, 231237834, 231237837, 3, 640x360 
0x12CB3460, 36963308269108448, 231237893, 231237897, 4, 640x360 
0x12CB3460, 36963308269231040, 231237904, 231237908, 4, 640x360 
0x12CB3460, 36963308269550192, 231237933, 231237935, 2, 640x360 
0x12CB3460, 36963308269869368, 231237963, 231237966, 3, 640x360 
0x12CB3460, 36963308270189400, 231237993, 231237996, 3, 640x360 
0x12CB3460, 36963308270509096, 231238024, 231238027, 3, 640x360 
0x12CB3460, 36963308270829400, 231238064, 231238067, 3, 640x360 
0x12CB3460, 36963308271152944, 231238094, 231238098, 4, 640x360 
0x12CB3460, 36963308271468856, 231238123, 231238125, 2, 640x360 
0x12CB3460, 36963308271948744, 231238173, 231238176, 3, 640x360 
0x12CB3460, 36963308272271728, 231238205, 231238208, 3, 640x360 
0x12CB3460, 36963308272591032, 231238234, 231238237, 3, 640x360 
0x12CB3460, 36963308272912976, 231238273, 231238276, 3, 640x360 
0x12CB3460, 36963308273229208, 231238303, 231238306, 3, 640x360 
0x12CB3460, 36963308273549440, 231238333, 231238336, 3, 640x360 
0x12CB3460, 36963308273992744, 231238384, 231238387, 3, 640x360 
0x12CB3460, 36963308274189248, 231238394, 231238412, 18, 640x360 
0x12CB3460, 36963308274510088, 231238424, 231238428, 4, 640x360 
0x12CB3460, 36963308274831208, 231238465, 231238468, 3, 640x360 
0x12CB3460, 36963308275150232, 231238494, 231238497, 3, 640x360 
0x12CB3460, 36963308275469720, 231238523, 231238526, 3, 640x360 
0x12CB3460, 36963308275951784, 231238574, 231238578, 4, 640x360 
0x12CB3460, 36963308276269864, 231238603, 231238605, 2, 640x360 
0x12CB3460, 36963308276590488, 231238634, 231238636, 2, 640x360 
0x12CB3460, 36963308276911096, 231238674, 231238677, 3, 640x360 
0x12CB3460, 36963308277230392, 231238704, 231238707, 3, 640x360 
0x12CB3460, 36963308277550952, 231238733, 231238735, 2, 640x360 
0x12CB3460, 36963308277869472, 231238763, 231238766, 3, 640x360 
0x12CB3460, 36963308278189352, 231238794, 231238797, 3, 640x360 
0x12CB3460, 36963308278510832, 231238832, 231238835, 3, 640x360 
0x12CB3460, 36963308278937032, 231238873, 231238876, 3, 640x360 
0x12CB3460, 36963308279149696, 231238893, 231238896, 3, 640x360 
0x12CB3460, 36963308279630128, 231238943, 231238946, 3, 640x360 
0x12CB3460, 36963308279951200, 231238973, 231238975, 2, 640x360 
0x12CB3460, 36963308280269360, 231239003, 231239006, 3, 640x360 
0x12CB3460, 36963308280592096, 231239034, 231239038, 4, 640x360 
0x12CB3460, 36963308280909736, 231239064, 231239073, 9, 640x360 
0x12CB3460, 36963308281229968, 231239104, 231239107, 3, 640x360 
0x12CB3460, 36963308281548752, 231239133, 231239135, 2, 640x360 
0x12CB3460, 36963308281869888, 231239164, 231239166, 2, 640x360 
0x12CB3460, 36963308282190968, 231239193, 231239196, 3, 640x360 
0x12CB3460, 36963308282509520, 231239233, 231239236, 3, 640x360 
0x12CB3460, 36963308282829680, 231239264, 231239267, 3, 640x360 
0x12CB3460, 36963308283150408, 231239293, 231239296, 3, 640x360 
0x12CB3460, 36963308283631120, 231239343, 231239346, 3, 640x360 
0x12CB3460, 36963308284065272, 231239384, 231239386, 2, 640x360 
0x12CB3460, 36963308284269648, 231239403, 231239406, 3, 640x360 
0x12CB3460, 36963308284589400, 231239434, 231239438, 4, 640x360 
0x12CB3460, 36963308284910104, 231239474, 231239477, 3, 640x360 
0x12CB3460, 36963308285230728, 231239503, 231239506, 3, 640x360 
0x12CB3460, 36963308285551320, 231239534, 231239537, 3, 640x360 
0x12CB3460, 36963308285870808, 231239565, 231239568, 3, 640x360 
0x12CB3460, 36963308286190368, 231239593, 231239597, 4, 640x360 
0x12CB3460, 36963308286509592, 231239624, 231239628, 4, 640x360 
0x12CB3460, 36963308286831256, 231239663, 231239666, 3, 640x360 
0x12CB3460, 36963308287153008, 231239695, 231239698, 3, 640x360 
0x12CB3460, 36963308287631360, 231239743, 231239746, 3, 640x360 
0x12CB3460, 36963308287949024, 231239774, 231239778, 4, 640x360 
0x12CB3460, 36963308288269672, 231239803, 231239806, 3, 640x360 
0x12CB3460, 36963308288590272, 231239834, 231239837, 3, 640x360 
0x12CB3460, 36963308289016296, 231239874, 231239878, 4, 640x360 
0x12CB3460, 36963308289229008, 231239904, 231239907, 3, 640x360 
0x12CB3460, 36963308289549688, 231239935, 231239949, 14, 640x360 
0x12CB3460, 36963308289869936, 231239963, 231239966, 3, 640x360 
0x12CB3460, 36963308290189352, 231239994, 231239997, 3, 640x360 
0x12CB3460, 36963308290509880, 231240034, 231240036, 2, 640x360 
0x12CB3460, 36963308290828976, 231240064, 231240067, 3, 640x360 
0x12CB3460, 36963308291308280, 231240104, 231240108, 4, 640x360 
0x12CB3460, 36963308291628304, 231240143, 231240146, 3, 640x360 
0x12CB3460, 36963308291949560, 231240173, 231240176, 3, 640x360 
0x12CB3460, 36963308292271544, 231240204, 231240207, 3, 640x360 
0x12CB3460, 36963308292589840, 231240233, 231240237, 4, 640x360 
0x12CB3460, 36963308292909464, 231240274, 231240278, 4, 640x360 
0x12CB3460, 36963308293230816, 231240303, 231240321, 18, 640x360 
0x12CB3460, 36963308293548784, 231240333, 231240335, 2, 640x360 
0x12CB3460, 36963308293989960, 231240384, 231240387, 3, 640x360 
0x12CB3460, 36963308294189744, 231240393, 231240396, 3, 640x360 
0x12CB3460, 36963308294513008, 231240425, 231240428, 3, 640x360 
0x12CB3460, 36963308294830024, 231240463, 231240466, 3, 640x360 
0x12CB3460, 36963308295309280, 231240513, 231240516, 3, 640x360 
0x12CB3460, 36963308295629792, 231240543, 231240546, 3, 640x360 
0x12CB3460, 36963308295950928, 231240572, 231240576, 4, 640x360 
0x12CB3460, 36963308296269568, 231240604, 231240607, 3, 640x360 
0x12CB3460, 36963308296588432, 231240634, 231240637, 3, 640x360 
0x12CB3460, 36963308296910064, 231240664, 231240668, 4, 640x360 
0x12CB3460, 36963308297230728, 231240703, 231240706, 3, 640x360 
0x12CB3460, 36963308297549144, 231240732, 231240735, 3, 640x360 
0x12CB3460, 36963308297868984, 231240763, 231240766, 3, 640x360 
0x12CB3460, 36963308298192352, 231240795, 231240799, 4, 640x360 
0x12CB3460, 36963308298509032, 231240834, 231240837, 3, 640x360 
0x12CB3460, 36963308298955360, 231240873, 231240876, 3, 640x360 
0x12CB3460, 36963308299310480, 231240904, 231240911, 7, 640x360 
0x12CB3460, 36963308299629944, 231240944, 231240946, 2, 640x360 
0x12CB3460, 36963308299950592, 231240973, 231240976, 3, 640x360 
0x12CB3460, 36963308300270856, 231241004, 231241023, 19, 640x360 
0x12CB3460, 36963308300589464, 231241034, 231241037, 3, 640x360 
0x12CB3460, 36963308300910120, 231241074, 231241077, 3, 640x360 
0x12CB3460, 36963308301230592, 231241106, 231241111, 5, 640x360 
0x12CB3460, 36963308301549336, 231241132, 231241135, 3, 640x360 
0x12CB3460, 36963308301869000, 231241164, 231241166, 2, 640x360 
0x12CB3460, 36963308302189696, 231241193, 231241196, 3, 640x360 
0x12CB3460, 36963308302509736, 231241233, 231241236, 3, 640x360 
0x12CB3460, 36963308302990304, 231241273, 231241277, 4, 640x360 
0x12CB3460, 36963308303310272, 231241304, 231241308, 4, 640x360 
0x12CB3460, 36963308303629592, 231241344, 231241347, 3, 640x360 
0x12CB3460, 36963308304106928, 231241394, 231241396, 2, 640x360 
0x12CB3460, 36963308304269504, 231241403, 231241406, 3, 640x360 
0x12CB3460, 36963308304590096, 231241434, 231241437, 3, 640x360 
0x12CB3460, 36963308304909400, 231241474, 231241476, 2, 640x360 
0x12CB3460, 36963308305229088, 231241504, 231241507, 3, 640x360 
0x12CB3460, 36963308305550512, 231241533, 231241536, 3, 640x360 
0x12CB3460, 36963308305871216, 231241563, 231241566, 3, 640x360 
0x12CB3460, 36963308306193264, 231241605, 231241608, 3, 640x360 
0x12CB3460, 36963308306510968, 231241634, 231241639, 5, 640x360 
0x12CB3460, 36963308306990608, 231241674, 231241676, 2, 640x360 
0x12CB3460, 36963308307311288, 231241713, 231241717, 4, 640x360 
0x12CB3460, 36963308307629864, 231241743, 231241750, 7, 640x360 
0x12CB3460, 36963308307949536, 231241773, 231241776, 3, 640x360 
0x12CB3460, 36963308308268240, 231241803, 231241806, 3, 640x360 
0x12CB3460, 36963308308590536, 231241833, 231241836, 3, 640x360 
0x12CB3460, 36963308308973704, 231241873, 231241891, 18, 640x360 
0x12CB3460, 36963308309230048, 231241904, 231241907, 3, 640x360 
0x12CB3460, 36963308309551408, 231241933, 231241936, 3, 640x360 
0x12CB3460, 36963308309869112, 231241964, 231241967, 3, 640x360 
0x12CB3460, 36963308310191832, 231241994, 231241997, 3, 640x360 
0x12CB3460, 36963308310669816, 231242043, 231242048, 5, 640x360 
0x12CB3460, 36963308310990464, 231242074, 231242077, 3, 640x360 
0x12CB3460, 36963308311309512, 231242104, 231242108, 4, 640x360 
0x12CB3460, 36963308311629920, 231242143, 231242163, 20, 640x360 
0x12CB3460, 36963308311950160, 231242174, 231242177, 3, 640x360 
0x12CB3460, 36963308312269112, 231242203, 231242206, 3, 640x360 
0x12CB3460, 36963308312588552, 231242234, 231242236, 2, 640x360 
0x12CB3460, 36963308312909688, 231242273, 231242277, 4, 640x360 
0x12CB3460, 36963308313231944, 231242303, 231242306, 3, 640x360 
0x12CB3460, 36963308313550048, 231242333, 231242369, 36, 640x360 
0x12CB3460, 36963308313986184, 231242374, 231242377, 3, 640x360 
0x12CB3460, 36963308314189288, 231242394, 231242396, 2, 640x360 
0x12CB3460, 36963308314670512, 231242443, 231242447, 4, 640x360 
0x12CB3460, 36963308314989488, 231242475, 231242479, 4, 640x360 
0x12CB3460, 36963308315308424, 231242514, 231242532, 18, 640x360 
0x12CB3460, 36963308315631360, 231242544, 231242546, 2, 640x360 
0x12CB3460, 36963308315949912, 231242574, 231242577, 3, 640x360 
0x12CB3460, 36963308316270568, 231242603, 231242607, 4, 640x360 
0x12CB3460, 36963308316590288, 231242635, 231242638, 3, 640x360 
0x12CB3460, 36963308316908440, 231242664, 231242668, 4, 640x360 
0x12CB3460, 36963308317229320, 231242703, 231242706, 3, 640x360 
0x12CB3460, 36963308317551112, 231242733, 231242735, 2, 640x360 
0x12CB3460, 36963308317870456, 231242763, 231242766, 3, 640x360 
0x12CB3460, 36963308318195224, 231242793, 231242798, 5, 640x360 
0x12CB3460, 36963308318669864, 231242844, 231242847, 3, 640x360 
0x12CB3460, 36963308319013752, 231242883, 231242885, 2, 640x360 
0x12CB3460, 36963308319309848, 231242905, 231242923, 18, 640x360 
0x12CB3460, 36963308319629608, 231242944, 231242947, 3, 640x360 
0x12CB3460, 36963308319949352, 231242973, 231242991, 18, 640x360 
0x12CB3460, 36963308320269816, 231243003, 231243006, 3, 640x360 
0x12CB3460, 36963308320590216, 231243033, 231243036, 3, 640x360 
0x12CB3460, 36963308320909096, 231243065, 231243068, 3, 640x360 
0x12CB3460, 36963308321230448, 231243103, 231243107, 4, 640x360 
0x12CB3460, 36963308321549832, 231243133, 231243151, 18, 640x360 
0x12CB3460, 36963308321870592, 231243163, 231243166, 3, 640x360 
0x12CB3460, 36963308322352680, 231243215, 231243219, 4, 640x360 
0x12CB3460, 36963308322668912, 231243243, 231243246, 3, 640x360 
0x12CB3460, 36963308322991344, 231243273, 231243276, 3, 640x360 
0x12CB3460, 36963308323308696, 231243304, 231243308, 4, 640x360 
0x12CB3460, 36963308323630712, 231243344, 231243378, 34, 640x360 
0x12CB3460, 36963308324067136, 231243383, 231243386, 3, 640x360 
0x12CB3460, 36963308324268400, 231243404, 231243407, 3, 640x360 
0x12CB3460, 36963308324589768, 231243434, 231243437, 3, 640x360 
0x12CB3460, 36963308324909048, 231243474, 231243477, 3, 640x360 
0x12CB3460, 36963308325229840, 231243503, 231243506, 3, 640x360 
0x12CB3460, 36963308325550200, 231243534, 231243536, 2, 640x360 
0x12CB3460, 36963308325869840, 231243563, 231243567, 4, 640x360 
0x12CB3460, 36963308326348672, 231243614, 231243617, 3, 640x360 
0x12CB3460, 36963308326668248, 231243643, 231243647, 4, 640x360 
0x12CB3460, 36963308326990096, 231243674, 231243692, 18, 640x360 
0x12CB3460, 36963308327310736, 231243714, 231243717, 3, 640x360 
0x12CB3460, 36963308327628536, 231243743, 231243746, 3, 640x360 
0x12CB3460, 36963308327950600, 231243774, 231243776, 2, 640x360 
0x12CB3460, 36963308328270016, 231243803, 231243806, 3, 640x360 
0x12CB3460, 36963308328589960, 231243834, 231243837, 3, 640x360 
0x12CB3460, 36963308329077288, 231243884, 231243887, 3, 640x360 
0x12CB3460, 36963308329229224, 231243904, 231243907, 3, 640x360 
0x12CB3460, 36963308329548896, 231243934, 231243937, 3, 640x360 
0x12CB3460, 36963308329869520, 231243964, 231243967, 3, 640x360 
0x12CB3460, 36963308330348504, 231244013, 231244017, 4, 640x360 
0x12CB3460, 36963308330668080, 231244044, 231244047, 3, 640x360 
0x12CB3460, 36963308330988424, 231244074, 231244077, 3, 640x360 
0x12CB3460, 36963308331309064, 231244104, 231244108, 4, 640x360 
0x12CB3460, 36963308331629272, 231244144, 231244147, 3, 640x360 
0x12CB3460, 36963308331950184, 231244174, 231244177, 3, 640x360 
0x12CB3460, 36963308332271080, 231244204, 231244206, 2, 640x360 
0x12CB3460, 36963308332590312, 231244234, 231244237, 3, 640x360 
0x12CB3460, 36963308332909480, 231244273, 231244276, 3, 640x360 
0x12CB3460, 36963308333233112, 231244303, 231244306, 3, 640x360 
0x12CB3460, 36963308333550280, 231244334, 231244336, 2, 640x360 
0x12CB3460, 36963308334053376, 231244384, 231244387, 3, 640x360 
0x12CB3460, 36963308334350664, 231244414, 231244417, 3, 640x360 
0x12CB3460, 36963308334668000, 231244445, 231244448, 3, 640x360 
0x12CB3460, 36963308334989928, 231244475, 231244478, 3, 640x360 
0x12CB3460, 36963308335310840, 231244513, 231244516, 3, 640x360 
0x12CB3460, 36963308335630464, 231244544, 231244547, 3, 640x360 
0x12CB3460, 36963308335951168, 231244574, 231244579, 5, 640x360 
0x12CB3460, 36963308336270512, 231244604, 231244607, 3, 640x360 
0x12CB3460, 36963308336589768, 231244633, 231244637, 4, 640x360 
0x12CB3460, 36963308336909136, 231244674, 231244677, 3, 640x360 
0x12CB3460, 36963308337231696, 231244704, 231244707, 3, 640x360 
0x12CB3460, 36963308337549440, 231244734, 231244737, 3, 640x360 
0x12CB3460, 36963308338031608, 231244783, 231244786, 3, 640x360 
0x12CB3460, 36963308338349472, 231244814, 231244817, 3, 640x360 
0x12CB3460, 36963308338670416, 231244843, 231244870, 27, 640x360 
0x12CB3460, 36963308338996160, 231244874, 231244877, 3, 640x360 
0x12CB3460, 36963308339310120, 231244914, 231244931, 17, 640x360 
0x12CB3460, 36963308339629240, 231244943, 231244946, 3, 640x360 
0x12CB3460, 36963308339949976, 231244974, 231244977, 3, 640x360 
0x12CB3460, 36963308340269440, 231245003, 231245006, 3, 640x360 
0x12CB3460, 36963308340589848, 231245035, 231245037, 2, 640x360 
0x12CB3460, 36963308340908208, 231245064, 231245068, 4, 640x360 
0x12CB3460, 36963308341230616, 231245103, 231245106, 3, 640x360 
0x12CB3460, 36963308341549184, 231245133, 231245136, 3, 640x360 
0x12CB3460, 36963308342031136, 231245184, 231245187, 3, 640x360 
0x12CB3460, 36963308342350824, 231245213, 231245216, 3, 640x360 
0x12CB3460, 36963308342669928, 231245244, 231245246, 2, 640x360 
0x12CB3460, 36963308342988760, 231245275, 231245279, 4, 640x360 
0x12CB3460, 36963308343309608, 231245304, 231245308, 4, 640x360 
0x12CB3460, 36963308343631192, 231245344, 231245346, 2, 640x360 
0x12CB3460, 36963308344085296, 231245385, 231245388, 3, 640x360 
0x12CB3460, 36963308344269672, 231245404, 231245407, 3, 640x360 
0x12CB3460, 36963308344589952, 231245433, 231245436, 3, 640x360 
0x12CB3460, 36963308344913280, 231245465, 231245469, 4, 640x360 
0x12CB3460, 36963308345229584, 231245504, 231245507, 3, 640x360 
0x12CB3460, 36963308345710496, 231245554, 231245556, 2, 640x360 
0x12CB3460, 36963308346033568, 231245584, 231245591, 7, 640x360 
0x12CB3460, 36963308346349704, 231245613, 231245631, 18, 640x360 
0x12CB3460, 36963308346670544, 231245643, 231245661, 18, 640x360 
0x12CB3460, 36963308346990112, 231245674, 231245677, 3, 640x360 
0x12CB3460, 36963308347312424, 231245715, 231245719, 4, 640x360 
0x12CB3460, 36963308347630200, 231245744, 231245746, 2, 640x360 
0x12CB3460, 36963308347949712, 231245774, 231245778, 4, 640x360 
0x12CB3460, 36963308348272920, 231245804, 231245810, 6, 640x360 
0x12CB3460, 36963308348588808, 231245834, 231245836, 2, 640x360 
0x12CB3460, 36963308349090352, 231245885, 231245889, 4, 640x360 
0x12CB3460, 36963308349228888, 231245904, 231245907, 3, 640x360 
0x12CB3460, 36963308349709824, 231245944, 231245947, 3, 640x360 
0x12CB3460, 36963308350028688, 231245984, 231245987, 3, 640x360 
0x12CB3460, 36963308350348088, 231246013, 231246016, 3, 640x360 
0x12CB3460, 36963308350669216, 231246044, 231246047, 3, 640x360 
0x12CB3460, 36963308350989144, 231246073, 231246076, 3, 640x360 
0x12CB3460, 36963308351310480, 231246104, 231246111, 7, 640x360 
0x12CB3460, 36963308351633568, 231246144, 231246146, 2, 640x360 
0x12CB3460, 36963308351949352, 231246173, 231246176, 3, 640x360 
0x12CB3460, 36963308352271272, 231246203, 231246206, 3, 640x360 
0x12CB3460, 36963308352590824, 231246233, 231246236, 3, 640x360 
0x12CB3460, 36963308352910312, 231246274, 231246278, 4, 640x360 
0x12CB3460, 36963308353389968, 231246313, 231246316, 3, 640x360 
0x12CB3460, 36963308353710024, 231246372, 231246375, 3, 640x360 
0x12CB3460, 36963308354041016, 231246383, 231246386, 3, 640x360 
0x12CB3460, 36963308354349640, 231246414, 231246416, 2, 640x360 
0x12CB3460, 36963308354670288, 231246443, 231246446, 3, 640x360 
0x12CB3460, 36963308354991496, 231246474, 231246478, 4, 640x360 
0x12CB3460, 36963308355309904, 231246514, 231246516, 2, 640x360 
0x12CB3460, 36963308355629584, 231246543, 231246561, 18, 640x360 
0x12CB3460, 36963308355949864, 231246574, 231246577, 3, 640x360 
0x12CB3460, 36963308356270512, 231246603, 231246606, 3, 640x360 
0x12CB3460, 36963308356589536, 231246633, 231246638, 5, 640x360 
0x12CB3460, 36963308356909968, 231246674, 231246677, 3, 640x360 
0x12CB3460, 36963308357393728, 231246724, 231246727, 3, 640x360 
0x12CB3460, 36963308357710064, 231246754, 231246757, 3, 640x360 
0x12CB3460, 36963308358028128, 231246783, 231246786, 3, 640x360 
0x12CB3460, 36963308358348088, 231246814, 231246816, 2, 640x360 
0x12CB3460, 36963308358669184, 231246844, 231246848, 4, 640x360 
0x12CB3460, 36963308359040392, 231246884, 231246887, 3, 640x360 
0x12CB3460, 36963308359309560, 231246905, 231246908, 3, 640x360 
0x12CB3460, 36963308359628720, 231246944, 231246947, 3, 640x360 
0x12CB3460, 36963308359948632, 231246973, 231246976, 3, 640x360 
0x12CB3460, 36963308360268400, 231247003, 231247005, 2, 640x360 
0x12CB3460, 36963308360588952, 231247033, 231247036, 3, 640x360 
0x12CB3460, 36963308360909152, 231247065, 231247068, 3, 640x360 
0x12CB3460, 36963308361388976, 231247113, 231247116, 3, 640x360 
0x12CB3460, 36963308361708560, 231247153, 231247156, 3, 640x360 
0x12CB3460, 36963308362028872, 231247184, 231247187, 3, 640x360 
0x12CB3460, 36963308362350392, 231247213, 231247216, 3, 640x360 
0x12CB3460, 36963308362669632, 231247243, 231247246, 3, 640x360 
0x12CB3460, 36963308362989816, 231247274, 231247277, 3, 640x360 
0x12CB3460, 36963308363308544, 231247313, 231247316, 3, 640x360 
0x12CB3460, 36963308363629736, 231247346, 231247370, 24, 640x360 
0x12CB3460, 36963308363995560, 231247374, 231247377, 3, 640x360 
0x12CB3460, 36963308364269624, 231247403, 231247406, 3, 640x360 
0x12CB3460, 36963308364589728, 231247434, 231247436, 2, 640x360 
0x12CB3460, 36963308365069624, 231247483, 231247486, 3, 640x360 
0x12CB3460, 36963308365389904, 231247514, 231247517, 3, 640x360 
0x12CB3460, 36963308365710560, 231247554, 231247557, 3, 640x360 
0x12CB3460, 36963308366030296, 231247583, 231247587, 4, 640x360 
0x12CB3460, 36963308366350720, 231247614, 231247618, 4, 640x360 
0x12CB3460, 36963308366669968, 231247644, 231247648, 4, 640x360 
0x12CB3460, 36963308366990800, 231247673, 231247676, 3, 640x360 
0x12CB3460, 36963308367311832, 231247713, 231247716, 3, 640x360 
0x12CB3460, 36963308367628592, 231247744, 231247746, 2, 640x360 
0x12CB3460, 36963308367949816, 231247774, 231247777, 3, 640x360 
0x12CB3460, 36963308368268216, 231247802, 231247805, 3, 640x360 
0x12CB3460, 36963308368589496, 231247833, 231247836, 3, 640x360 
0x12CB3460, 36963308369067672, 231247884, 231247887, 3, 640x360 
0x12CB3460, 36963308369389992, 231247913, 231247916, 3, 640x360 
0x12CB3460, 36963308369708696, 231247953, 231247957, 4, 640x360 
0x12CB3460, 36963308370028440, 231247983, 231247986, 3, 640x360 
0x12CB3460, 36963308370349416, 231248013, 231248016, 3, 640x360 
0x12CB3460, 36963308370669520, 231248044, 231248047, 3, 640x360 
0x12CB3460, 36963308370988616, 231248073, 231248076, 3, 640x360 
0x12CB3460, 36963308371309368, 231248114, 231248117, 3, 640x360 
0x12CB3460, 36963308371628736, 231248144, 231248147, 3, 640x360 
0x12CB3460, 36963308371949408, 231248173, 231248176, 3, 640x360 
0x12CB3460, 36963308372269608, 231248203, 231248206, 3, 640x360 
0x12CB3460, 36963308372589208, 231248233, 231248236, 3, 640x360 
0x12CB3460, 36963308373070640, 231248284, 231248286, 2, 640x360 
0x12CB3460, 36963308373387712, 231248313, 231248316, 3, 640x360 
0x12CB3460, 36963308373710576, 231248369, 231248372, 3, 640x360 
0x12CB3460, 36963308374028648, 231248383, 231248385, 2, 640x360 
0x12CB3460, 36963308374349600, 231248414, 231248417, 3, 640x360 
0x12CB3460, 36963308374668920, 231248443, 231248448, 5, 640x360 
0x12CB3460, 36963308374988752, 231248474, 231248477, 3, 640x360 
0x12CB3460, 36963308375308608, 231248514, 231248517, 3, 640x360 
0x12CB3460, 36963308375631408, 231248545, 231248548, 3, 640x360 
0x12CB3460, 36963308375952416, 231248574, 231248578, 4, 640x360 
0x12CB3460, 36963308376269544, 231248603, 231248606, 3, 640x360 
0x12CB3460, 36963308376749728, 231248653, 231248656, 3, 640x360 
0x12CB3460, 36963308377068968, 231248683, 231248686, 3, 640x360 
0x12CB3460, 36963308377389184, 231248714, 231248717, 3, 640x360 
0x12CB3460, 36963308377708944, 231248754, 231248771, 17, 640x360 
0x12CB3460, 36963308378035168, 231248784, 231248788, 4, 640x360 
0x12CB3460, 36963308378349480, 231248813, 231248816, 3, 640x360 
0x12CB3460, 36963308378670136, 231248843, 231248846, 3, 640x360 
0x12CB3460, 36963308379043368, 231248883, 231248886, 3, 640x360 
0x12CB3460, 36963308379308616, 231248914, 231248916, 2, 640x360 
0x12CB3460, 36963308379628904, 231248943, 231248947, 4, 640x360 
0x12CB3460, 36963308379951016, 231248974, 231248978, 4, 640x360 
0x12CB3460, 36963308380268272, 231249003, 231249006, 3, 640x360 
0x12CB3460, 36963308380750688, 231249053, 231249056, 3, 640x360 
0x12CB3460, 36963308381069032, 231249084, 231249086, 2, 640x360 
0x12CB3460, 36963308381388144, 231249114, 231249117, 3, 640x360 
0x12CB3460, 36963308381709800, 231249144, 231249147, 3, 640x360 
0x12CB3460, 36963308382028768, 231249183, 231249187, 4, 640x360 
0x12CB3460, 36963308382349184, 231249213, 231249216, 3, 640x360 
0x12CB3460, 36963308382668760, 231249243, 231249246, 3, 640x360 
0x12CB3460, 36963308382988368, 231249273, 231249277, 4, 640x360 
0x12CB3460, 36963308383309320, 231249313, 231249316, 3, 640x360 
0x12CB3460, 36963308383630864, 231249343, 231249371, 28, 640x360 
0x12CB3460, 36963308383999192, 231249384, 231249386, 2, 640x360 
0x12CB3460, 36963308384269128, 231249404, 231249407, 3, 640x360 
0x12CB3460, 36963308384750032, 231249453, 231249471, 18, 640x360 
0x12CB3460, 36963308385069368, 231249484, 231249487, 3, 640x360 
0x12CB3460, 36963308385388800, 231249513, 231249516, 3, 640x360 
0x12CB3460, 36963308385709560, 231249553, 231249556, 3, 640x360 
0x12CB3460, 36963308386028864, 231249584, 231249587, 3, 640x360 
0x12CB3460, 36963308386351824, 231249614, 231249617, 3, 640x360 
0x12CB3460, 36963308386670128, 231249643, 231249648, 5, 640x360 
0x12CB3460, 36963308386991032, 231249674, 231249677, 3, 640x360 
0x12CB3460, 36963308387310936, 231249713, 231249717, 4, 640x360 
0x12CB3460, 36963308387628880, 231249744, 231249747, 3, 640x360 
0x12CB3460, 36963308387949896, 231249773, 231249776, 3, 640x360 
0x12CB3460, 36963308388429480, 231249824, 231249827, 3, 640x360 
0x12CB3460, 36963308388750584, 231249877, 231249880, 3, 640x360 
0x12CB3460, 36963308389087440, 231249884, 231249887, 3, 640x360 
0x12CB3460, 36963308389389272, 231249913, 231249916, 3, 640x360 
0x12CB3460, 36963308389708544, 231249945, 231249948, 3, 640x360 
0x12CB3460, 36963308390028784, 231249984, 231249987, 3, 640x360 
0x12CB3460, 36963308390350016, 231250013, 231250031, 18, 640x360 
0x12CB3460, 36963308390668936, 231250044, 231250047, 3, 640x360 
0x12CB3460, 36963308390988904, 231250073, 231250076, 3, 640x360 
0x12CB3460, 36963308391307984, 231250104, 231250108, 4, 640x360 
0x12CB3460, 36963308391629216, 231250143, 231250147, 4, 640x360 
0x12CB3460, 36963308391949544, 231250174, 231250177, 3, 640x360 
0x12CB3460, 36963308392432816, 231250223, 231250226, 3, 640x360 
0x12CB3460, 36963308392748816, 231250254, 231250256, 2, 640x360 
0x12CB3460, 36963308393069640, 231250283, 231250286, 3, 640x360 
0x12CB3460, 36963308393390016, 231250314, 231250318, 4, 640x360 
0x12CB3460, 36963308393711200, 231250380, 231250385, 5, 640x360 
0x12CB3460, 36963308394097504, 231250386, 231250389, 3, 640x360 
0x12CB3460, 36963308394347832, 231250414, 231250417, 3, 640x360 
0x12CB3460, 36963308394669360, 231250444, 231250447, 3, 640x360 
0x12CB3460, 36963308394993984, 231250473, 231250477, 4, 640x360 
0x12CB3460, 36963308395310224, 231250513, 231250516, 3, 640x360 
0x12CB3460, 36963308395629760, 231250544, 231250548, 4, 640x360 
0x12CB3460, 36963308396115352, 231250594, 231250599, 5, 640x360 
0x12CB3460, 36963308396431032, 231250627, 231250630, 3, 640x360 
0x12CB3460, 36963308396751896, 231250653, 231250656, 3, 640x360 
0x12CB3460, 36963308397069072, 231250683, 231250686, 3, 640x360 
0x12CB3460, 36963308397389320, 231250713, 231250716, 3, 640x360 
0x12CB3460, 36963308397708592, 231250753, 231250756, 3, 640x360 
0x12CB3460, 36963308398027944, 231250785, 231250789, 4, 640x360 
0x12CB3460, 36963308398348240, 231250813, 231250815, 2, 640x360 
0x12CB3460, 36963308398668408, 231250844, 231250872, 28, 640x360 
0x12CB3460, 36963308399002112, 231250884, 231250887, 3, 640x360 
0x12CB3460, 36963308399309512, 231250904, 231250908, 4, 640x360 
0x12CB3460, 36963308399628672, 231250944, 231250947, 3, 640x360 
0x12CB3460, 36963308400108832, 231250984, 231250988, 4, 640x360 
0x12CB3460, 36963308400429528, 231251024, 231251027, 3, 640x360 
0x12CB3460, 36963308400751328, 231251054, 231251057, 3, 640x360 
0x12CB3460, 36963308401068776, 231251083, 231251086, 3, 640x360 
0x12CB3460, 36963308401389616, 231251115, 231251118, 3, 640x360 
0x12CB3460, 36963308401709024, 231251154, 231251156, 2, 640x360 
0x12CB3460, 36963308402029192, 231251183, 231251185, 2, 640x360 
0x12CB3460, 36963308402349856, 231251213, 231251216, 3, 640x360 
0x12CB3460, 36963308402669760, 231251244, 231251247, 3, 640x360 
0x12CB3460, 36963308402992640, 231251273, 231251276, 3, 640x360 
0x12CB3460, 36963308403309008, 231251304, 231251308, 4, 640x360 
0x12CB3460, 36963308403629648, 231251344, 231251347, 3, 640x360 
0x12CB3460, 36963308404107736, 231251384, 231251388, 4, 640x360 
0x12CB3460, 36963308404429352, 231251424, 231251427, 3, 640x360 
0x12CB3460, 36963308404750864, 231251454, 231251457, 3, 640x360 
0x12CB3460, 36963308405069160, 231251484, 231251487, 3, 640x360 
0x12CB3460, 36963308405389560, 231251513, 231251516, 3, 640x360 
0x12CB3460, 36963308405710688, 231251554, 231251557, 3, 640x360 
0x12CB3460, 36963308406031200, 231251583, 231251586, 3, 640x360 
0x12CB3460, 36963308406350312, 231251613, 231251616, 3, 640x360 
0x12CB3460, 36963308406667848, 231251643, 231251647, 4, 640x360 
0x12CB3460, 36963308406988640, 231251673, 231251676, 3, 640x360 
0x12CB3460, 36963308407310544, 231251713, 231251716, 3, 640x360 
0x12CB3460, 36963308407787992, 231251754, 231251757, 3, 640x360 
0x12CB3460, 36963308408113400, 231251785, 231251788, 3, 640x360 
0x12CB3460, 36963308408429512, 231251824, 231251827, 3, 640x360 
0x12CB3460, 36963308408748128, 231251884, 231251887, 3, 640x360 
0x12CB3460, 36963308409116864, 231251894, 231251897, 3, 640x360 
0x12CB3460, 36963308409387800, 231251914, 231251932, 18, 640x360 
0x12CB3460, 36963308409708648, 231251953, 231251957, 4, 640x360 
0x12CB3460, 36963308410030112, 231251983, 231251986, 3, 640x360 
0x12CB3460, 36963308410348792, 231252014, 231252016, 2, 640x360 
0x12CB3460, 36963308410669152, 231252044, 231252047, 3, 640x360 
0x12CB3460, 36963308410991888, 231252074, 231252078, 4, 640x360 
0x12CB3460, 36963308411309432, 231252115, 231252118, 3, 640x360 
0x12CB3460, 36963308411789808, 231252154, 231252157, 3, 640x360 
0x12CB3460, 36963308412108080, 231252184, 231252188, 4, 640x360 
0x12CB3460, 36963308412428432, 231252224, 231252227, 3, 640x360 
0x12CB3460, 36963308412748032, 231252253, 231252256, 3, 640x360 
0x12CB3460, 36963308413069464, 231252284, 231252286, 2, 640x360 
0x12CB3460, 36963308413387848, 231252313, 231252316, 3, 640x360 
0x12CB3460, 36963308413708760, 231252344, 231252371, 27, 640x360 
0x12CB3460, 36963308414029328, 231252383, 231252386, 3, 640x360 
0x12CB3460, 36963308414349840, 231252414, 231252416, 2, 640x360 
0x12CB3460, 36963308414669936, 231252443, 231252446, 3, 640x360 
0x12CB3460, 36963308414988288, 231252473, 231252478, 5, 640x360 
0x12CB3460, 36963308415308512, 231252504, 231252507, 3, 640x360 
0x12CB3460, 36963308415790288, 231252554, 231252557, 3, 640x360 
0x12CB3460, 36963308416109032, 231252593, 231252596, 3, 640x360 
0x12CB3460, 36963308416432992, 231252625, 231252628, 3, 640x360 
0x12CB3460, 36963308416748512, 231252653, 231252656, 3, 640x360 
0x12CB3460, 36963308417069648, 231252683, 231252685, 2, 640x360 
0x12CB3460, 36963308417391152, 231252714, 231252718, 4, 640x360 
0x12CB3460, 36963308417708792, 231252753, 231252756, 3, 640x360 
0x12CB3460, 36963308418028912, 231252783, 231252790, 7, 640x360 
0x12CB3460, 36963308418347896, 231252813, 231252823, 10, 640x360 
0x12CB3460, 36963308418667872, 231252843, 231252846, 3, 640x360 
0x12CB3460, 36963308419048224, 231252883, 231252886, 3, 640x360 
0x12CB3460, 36963308419470128, 231252923, 231252926, 3, 640x360 
0x12CB3460, 36963308419788088, 231252954, 231252957, 3, 640x360 
0x12CB3460, 36963308420109232, 231252994, 231252997, 3, 640x360 
0x12CB3460, 36963308420427776, 231253023, 231253026, 3, 640x360 
0x12CB3460, 36963308420749768, 231253054, 231253057, 3, 640x360 
0x12CB3460, 36963308421068672, 231253083, 231253086, 3, 640x360 
0x12CB3460, 36963308421390440, 231253114, 231253123, 9, 640x360 
0x12CB3460, 36963308421708888, 231253153, 231253155, 2, 640x360 
0x12CB3460, 36963308422029408, 231253183, 231253186, 3, 640x360 
0x12CB3460, 36963308422349712, 231253213, 231253216, 3, 640x360 
0x12CB3460, 36963308422668664, 231253243, 231253246, 3, 640x360 
0x12CB3460, 36963308422988504, 231253273, 231253277, 4, 640x360 
0x12CB3460, 36963308423469872, 231253324, 231253327, 3, 640x360 
0x12CB3460, 36963308423790040, 231253377, 231253381, 4, 640x360 
0x12CB3460, 36963308424108888, 231253385, 231253388, 3, 640x360 
0x12CB3460, 36963308424428064, 231253424, 231253426, 2, 640x360 
0x12CB3460, 36963308424749288, 231253453, 231253456, 3, 640x360 
0x12CB3460, 36963308425068624, 231253482, 231253485, 3, 640x360 
0x12CB3460, 36963308425389440, 231253513, 231253516, 3, 640x360 
0x12CB3460, 36963308425709664, 231253554, 231253557, 3, 640x360 
0x12CB3460, 36963308426030160, 231253583, 231253586, 3, 640x360 
0x12CB3460, 36963308426350664, 231253613, 231253620, 7, 640x360 
0x12CB3460, 36963308426670112, 231253643, 231253646, 3, 640x360 
0x12CB3460, 36963308427151640, 231253694, 231253697, 3, 640x360 
0x12CB3460, 36963308427469080, 231253723, 231253726, 3, 640x360 
0x12CB3460, 36963308427789240, 231253754, 231253756, 2, 640x360 
0x12CB3460, 36963308428108760, 231253794, 231253798, 4, 640x360 
0x12CB3460, 36963308428428216, 231253823, 231253826, 3, 640x360 
0x12CB3460, 36963308428749872, 231253874, 231253878, 4, 640x360 
0x12CB3460, 36963308429067536, 231253883, 231253886, 3, 640x360 
0x12CB3460, 36963308429388736, 231253914, 231253916, 2, 640x360 
0x12CB3460, 36963308429709720, 231253953, 231253961, 8, 640x360 
0x12CB3460, 36963308430028648, 231253983, 231253985, 2, 640x360 
0x12CB3460, 36963308430347696, 231254013, 231254016, 3, 640x360 
0x12CB3460, 36963308430668768, 231254044, 231254047, 3, 640x360 
0x12CB3460, 36963308431148584, 231254093, 231254100, 7, 640x360 
0x12CB3460, 36963308431474736, 231254124, 231254127, 3, 640x360 
0x12CB3460, 36963308431787648, 231254155, 231254157, 2, 640x360 
0x12CB3460, 36963308432109200, 231254184, 231254187, 3, 640x360 
0x12CB3460, 36963308432428016, 231254223, 231254226, 3, 640x360 
0x12CB3460, 36963308432750176, 231254253, 231254256, 3, 640x360 
0x12CB3460, 36963308433068512, 231254284, 231254287, 3, 640x360 
0x12CB3460, 36963308433388920, 231254313, 231254316, 3, 640x360 
0x12CB3460, 36963308433709328, 231254376, 231254381, 5, 640x360 
0x12CB3460, 36963308434050024, 231254384, 231254386, 2, 640x360 
0x12CB3460, 36963308434349024, 231254413, 231254416, 3, 640x360 
0x12CB3460, 36963308434668472, 231254444, 231254446, 2, 640x360 
0x12CB3460, 36963308435148832, 231254494, 231254513, 19, 640x360 
0x12CB3460, 36963308435468944, 231254524, 231254527, 3, 640x360 
0x12CB3460, 36963308435791512, 231254564, 231254568, 4, 640x360 
0x12CB3460, 36963308436111096, 231254593, 231254596, 3, 640x360 
0x12CB3460, 36963308436430488, 231254624, 231254628, 4, 640x360 
0x12CB3460, 36963308436748856, 231254653, 231254655, 2, 640x360 
0x12CB3460, 36963308437069280, 231254683, 231254686, 3, 640x360 
0x12CB3460, 36963308437389504, 231254714, 231254717, 3, 640x360 
0x12CB3460, 36963308437708984, 231254754, 231254756, 2, 640x360 
0x12CB3460, 36963308438029040, 231254783, 231254786, 3, 640x360 
0x12CB3460, 36963308438348256, 231254813, 231254816, 3, 640x360 
0x12CB3460, 36963308439037296, 231254883, 231254886, 3, 640x360 
0x12CB3460, 36963308439147280, 231254893, 231254896, 3, 640x360 
0x12CB3460, 36963308439469976, 231254923, 231254926, 3, 640x360 
0x12CB3460, 36963308439788016, 231254954, 231254957, 3, 640x360 
0x12CB3460, 36963308440108096, 231254994, 231254996, 2, 640x360 
0x12CB3460, 36963308440429840, 231255023, 231255026, 3, 640x360 
0x12CB3460, 36963308440749600, 231255053, 231255056, 3, 640x360 
0x12CB3460, 36963308441068672, 231255083, 231255086, 3, 640x360 
0x12CB3460, 36963308441388800, 231255114, 231255117, 3, 640x360 
0x12CB3460, 36963308441708000, 231255154, 231255156, 2, 640x360 
0x12CB3460, 36963308442350488, 231255214, 231255217, 3, 640x360 
0x12CB3460, 36963308442829920, 231255263, 231255266, 3, 640x360 
0x12CB3460, 36963308443148400, 231255294, 231255296, 2, 640x360 
0x12CB3460, 36963308443470848, 231255324, 231255327, 3, 640x360 
0x12CB3460, 36963308444040488, 231255384, 231255387, 3, 640x360 
0x12CB3460, 36963308444429120, 231255423, 231255426, 3, 640x360 
0x12CB3460, 36963308444748352, 231255453, 231255456, 3, 640x360 
0x12CB3460, 36963308445067304, 231255484, 231255486, 2, 640x360 
0x12CB3460, 36963308445389760, 231255513, 231255516, 3, 640x360 
0x12CB3460, 36963308445708736, 231255553, 231255556, 3, 640x360 
0x12CB3460, 36963308446353360, 231255614, 231255618, 4, 640x360 
0x12CB3460, 36963308446831296, 231255664, 231255667, 3, 640x360 
0x12CB3460, 36963308447152808, 231255694, 231255697, 3, 640x360 
0x12CB3460, 36963308447469424, 231255723, 231255726, 3, 640x360 
0x12CB3460, 36963308447789488, 231255753, 231255756, 3, 640x360 
0x12CB3460, 36963308448107904, 231255784, 231255787, 3, 640x360 
0x12CB3460, 36963308448428472, 231255823, 231255826, 3, 640x360 
0x12CB3460, 36963308448951928, 231255873, 231255876, 3, 640x360 
0x12CB3460, 36963308449068528, 231255884, 231255887, 3, 640x360 
0x12CB3460, 36963308449387336, 231255913, 231255916, 3, 640x360 
0x12CB3460, 36963308449707592, 231255953, 231255956, 3, 640x360 
0x12CB3460, 36963308450030360, 231255983, 231255986, 3, 640x360 
0x12CB3460, 36963308450507376, 231256024, 231256027, 3, 640x360 
0x12CB3460, 36963308450827608, 231256064, 231256067, 3, 640x360 
0x12CB3460, 36963308451149112, 231256094, 231256097, 3, 640x360 
0x12CB3460, 36963308451467472, 231256124, 231256127, 3, 640x360 
0x12CB3460, 36963308451788960, 231256153, 231256172, 19, 640x360 
0x12CB3460, 36963308452107744, 231256184, 231256188, 4, 640x360 
0x12CB3460, 36963308452428728, 231256225, 231256228, 3, 640x360 
0x12CB3460, 36963308452748488, 231256254, 231256256, 2, 640x360 
0x12CB3460, 36963308453069136, 231256284, 231256287, 3, 640x360 
0x12CB3460, 36963308453387840, 231256313, 231256316, 3, 640x360 
0x12CB3460, 36963308453708272, 231256344, 231256371, 27, 640x360 
0x12CB3460, 36963308454032448, 231256383, 231256386, 3, 640x360 
0x12CB3460, 36963308454508088, 231256424, 231256428, 4, 640x360 
0x12CB3460, 36963308454828264, 231256464, 231256467, 3, 640x360 
0x12CB3460, 36963308455149200, 231256493, 231256496, 3, 640x360 
0x12CB3460, 36963308455467672, 231256523, 231256526, 3, 640x360 
0x12CB3460, 36963308455789368, 231256553, 231256556, 3, 640x360 
0x12CB3460, 36963308456108568, 231256585, 231256589, 4, 640x360 
0x12CB3460, 36963308456429808, 231256623, 231256626, 3, 640x360 
0x12CB3460, 36963308456751336, 231256653, 231256656, 3, 640x360 
0x12CB3460, 36963308457069608, 231256683, 231256686, 3, 640x360 
0x12CB3460, 36963308457389648, 231256714, 231256719, 5, 640x360 
0x12CB3460, 36963308457707968, 231256754, 231256757, 3, 640x360 
0x12CB3460, 36963308458030416, 231256783, 231256791, 8, 640x360 
0x12CB3460, 36963308458507008, 231256825, 231256828, 3, 640x360 
0x12CB3460, 36963308458866136, 231256873, 231256876, 3, 640x360 
0x12CB3460, 36963308459148280, 231256893, 231256896, 3, 640x360 
0x12CB3460, 36963308459469416, 231256924, 231256942, 18, 640x360 
0x12CB3460, 36963308459791280, 231256954, 231256957, 3, 640x360 
0x12CB3460, 36963308460107840, 231256984, 231256987, 3, 640x360 
0x12CB3460, 36963308460428088, 231257024, 231257027, 3, 640x360 
0x12CB3460, 36963308460750432, 231257053, 231257057, 4, 640x360 
0x12CB3460, 36963308461068112, 231257084, 231257086, 2, 640x360 
0x12CB3460, 36963308461391872, 231257113, 231257116, 3, 640x360 
0x12CB3460, 36963308461707824, 231257144, 231257148, 4, 640x360 
0x12CB3460, 36963308462190592, 231257193, 231257197, 4, 640x360 
0x12CB3460, 36963308462506952, 231257224, 231257228, 4, 640x360 
0x12CB3460, 36963308462829920, 231257264, 231257266, 2, 640x360 
0x12CB3460, 36963308463148960, 231257293, 231257296, 3, 640x360 
0x12CB3460, 36963308463467736, 231257324, 231257326, 2, 640x360 
0x12CB3460, 36963308463789664, 231257384, 231257387, 3, 640x360 
0x12CB3460, 36963308464428936, 231257423, 231257440, 17, 640x360 
0x12CB3460, 36963308464752672, 231257454, 231257457, 3, 640x360 
0x12CB3460, 36963308465070464, 231257483, 231257487, 4, 640x360 
0x12CB3460, 36963308465388200, 231257513, 231257516, 3, 640x360 
0x12CB3460, 36963308465708008, 231257554, 231257556, 2, 640x360 
0x12CB3460, 36963308466188320, 231257594, 231257597, 3, 640x360 
0x12CB3460, 36963308466509904, 231257634, 231257637, 3, 640x360 
0x12CB3460, 36963308466828496, 231257664, 231257666, 2, 640x360 
0x12CB3460, 36963308467149392, 231257694, 231257696, 2, 640x360 
0x12CB3460, 36963308467471648, 231257724, 231257728, 4, 640x360 
0x12CB3460, 36963308467788368, 231257754, 231257757, 3, 640x360 
0x12CB3460, 36963308468107592, 231257784, 231257787, 3, 640x360 
0x12CB3460, 36963308468428384, 231257823, 231257826, 3, 640x360 
0x12CB3460, 36963308468748648, 231257874, 231257878, 4, 640x360 
0x12CB3460, 36963308469067480, 231257884, 231257886, 2, 640x360 
0x12CB3460, 36963308469388192, 231257914, 231257916, 2, 640x360 
0x12CB3460, 36963308469868504, 231257963, 231257967, 4, 640x360 
0x12CB3460, 36963308470189056, 231257994, 231257997, 3, 640x360 
0x12CB3460, 36963308470507328, 231258024, 231258027, 3, 640x360 
0x12CB3460, 36963308470827520, 231258063, 231258066, 3, 640x360 
0x12CB3460, 36963308471148408, 231258094, 231258097, 3, 640x360 
0x12CB3460, 36963308471470632, 231258123, 231258128, 5, 640x360 
0x12CB3460, 36963308471787544, 231258154, 231258156, 2, 640x360 
0x12CB3460, 36963308472109096, 231258194, 231258196, 2, 640x360 
0x12CB3460, 36963308472429584, 231258223, 231258226, 3, 640x360 
0x12CB3460, 36963308472748688, 231258254, 231258257, 3, 640x360 
0x12CB3460, 36963308473068200, 231258284, 231258287, 3, 640x360 
0x12CB3460, 36963308473387912, 231258315, 231258317, 2, 640x360 
0x12CB3460, 36963308473989928, 231258383, 231258385, 2, 640x360 
0x12CB3460, 36963308474188864, 231258394, 231258397, 3, 640x360 
0x12CB3460, 36963308474507328, 231258433, 231258436, 3, 640x360 
0x12CB3460, 36963308474830928, 231258464, 231258467, 3, 640x360 
0x12CB3460, 36963308475149744, 231258493, 231258498, 5, 640x360 
0x12CB3460, 36963308475468936, 231258523, 231258525, 2, 640x360 
0x12CB3460, 36963308475789192, 231258554, 231258557, 3, 640x360 
0x12CB3460, 36963308476109584, 231258594, 231258597, 3, 640x360 
0x12CB3460, 36963308476430232, 231258624, 231258639, 15, 640x360 
0x12CB3460, 36963308476751536, 231258652, 231258655, 3, 640x360 
0x12CB3460, 36963308477068016, 231258683, 231258686, 3, 640x360 
0x12CB3460, 36963308477390000, 231258713, 231258716, 3, 640x360 
0x12CB3460, 36963308477867248, 231258763, 231258773, 10, 640x360 
0x12CB3460, 36963308478188248, 231258793, 231258797, 4, 640x360 
0x12CB3460, 36963308478507448, 231258824, 231258827, 3, 640x360 
0x12CB3460, 36963308478986552, 231258883, 231258886, 3, 640x360 
0x12CB3460, 36963308479148616, 231258893, 231258895, 2, 640x360 
0x12CB3460, 36963308479467600, 231258923, 231258926, 3, 640x360 
0x12CB3460, 36963308479789288, 231258953, 231258956, 3, 640x360 
0x12CB3460, 36963308480107840, 231258984, 231258988, 4, 640x360 
0x12CB3460, 36963308480429032, 231259024, 231259027, 3, 640x360 
0x12CB3460, 36963308480752256, 231259053, 231259056, 3, 640x360 
0x12CB3460, 36963308481067448, 231259084, 231259086, 2, 640x360 
0x12CB3460, 36963308481547864, 231259133, 231259136, 3, 640x360 
0x12CB3460, 36963308481867080, 231259164, 231259166, 2, 640x360 
0x12CB3460, 36963308482189136, 231259193, 231259196, 3, 640x360 
0x12CB3460, 36963308482508360, 231259233, 231259235, 2, 640x360 
0x12CB3460, 36963308482830232, 231259263, 231259282, 19, 640x360 
0x12CB3460, 36963308483148112, 231259294, 231259297, 3, 640x360 
0x12CB3460, 36963308483468736, 231259324, 231259327, 3, 640x360 
0x12CB3460, 36963308484020408, 231259383, 231259402, 19, 640x360 
0x12CB3460, 36963308484427840, 231259424, 231259441, 17, 640x360 
0x12CB3460, 36963308484748728, 231259453, 231259456, 3, 640x360 
0x12CB3460, 36963308485068416, 231259483, 231259486, 3, 640x360 
0x12CB3460, 36963308485549168, 231259533, 231259536, 3, 640x360 
0x12CB3460, 36963308485870120, 231259563, 231259566, 3, 640x360 
0x12CB3460, 36963308486187544, 231259594, 231259597, 3, 640x360 
0x12CB3460, 36963308486510664, 231259634, 231259640, 6, 640x360 
0x12CB3460, 36963308486827328, 231259663, 231259666, 3, 640x360 
0x12CB3460, 36963308487149080, 231259694, 231259697, 3, 640x360 
0x12CB3460, 36963308487469280, 231259724, 231259727, 3, 640x360 
0x12CB3460, 36963308487788384, 231259754, 231259772, 18, 640x360 
0x12CB3460, 36963308488107832, 231259794, 231259799, 5, 640x360 
0x12CB3460, 36963308488428968, 231259823, 231259826, 3, 640x360 
0x12CB3460, 36963308488748272, 231259873, 231259876, 3, 640x360 
0x12CB3460, 36963308489067664, 231259883, 231259886, 3, 640x360 
0x12CB3460, 36963308489547240, 231259934, 231259937, 3, 640x360 
0x12CB3460, 36963308489867944, 231259963, 231259966, 3, 640x360 
0x12CB3460, 36963308490188168, 231259994, 231259997, 3, 640x360 
0x12CB3460, 36963308490507336, 231260024, 231260027, 3, 640x360 
0x12CB3460, 36963308490828336, 231260063, 231260066, 3, 640x360 
0x12CB3460, 36963308491148544, 231260094, 231260098, 4, 640x360 
0x12CB3460, 36963308491467496, 231260124, 231260126, 2, 640x360 
0x12CB3460, 36963308491788376, 231260152, 231260156, 4, 640x360 
0x12CB3460, 36963308492109096, 231260193, 231260196, 3, 640x360 
0x12CB3460, 36963308492429576, 231260223, 231260226, 3, 640x360 
0x12CB3460, 36963308492749216, 231260254, 231260256, 2, 640x360 
0x12CB3460, 36963308493229864, 231260304, 231260307, 3, 640x360 
0x12CB3460, 36963308493548248, 231260333, 231260335, 2, 640x360 
0x12CB3460, 36963308493997112, 231260374, 231260378, 4, 640x360 
0x12CB3460, 36963308494188664, 231260393, 231260396, 3, 640x360 
0x12CB3460, 36963308494507144, 231260424, 231260428, 4, 640x360 
0x12CB3460, 36963308494827936, 231260463, 231260466, 3, 640x360 
0x12CB3460, 36963308495148096, 231260493, 231260496, 3, 640x360 
0x12CB3460, 36963308495467520, 231260524, 231260526, 2, 640x360 
0x12CB3460, 36963308495789528, 231260554, 231260557, 3, 640x360 
0x12CB3460, 36963308496108840, 231260595, 231260598, 3, 640x360 
0x12CB3460, 36963308496429272, 231260623, 231260626, 3, 640x360 
0x12CB3460, 36963308496751760, 231260654, 231260656, 2, 640x360 
0x12CB3460, 36963308497228968, 231260703, 231260706, 3, 640x360 
0x12CB3460, 36963308497550768, 231260733, 231260735, 2, 640x360 
0x12CB3460, 36963308497867704, 231260764, 231260767, 3, 640x360 
0x12CB3460, 36963308498188872, 231260796, 231260799, 3, 640x360 
0x12CB3460, 36963308498507624, 231260833, 231260836, 3, 640x360 
0x12CB3460, 36963308499046552, 231260884, 231260888, 4, 640x360 
0x12CB3460, 36963308499467896, 231260923, 231260926, 3, 640x360 
0x12CB3460, 36963308499788368, 231260954, 231260956, 2, 640x360 
0x12CB3460, 36963308500107512, 231260984, 231260988, 4, 640x360 
0x12CB3460, 36963308500427920, 231261023, 231261025, 2, 640x360 
0x12CB3460, 36963308500749408, 231261054, 231261057, 3, 640x360 
0x12CB3460, 36963308501227016, 231261103, 231261106, 3, 640x360 
0x12CB3460, 36963308501547088, 231261133, 231261140, 7, 640x360 
0x12CB3460, 36963308501867304, 231261163, 231261165, 2, 640x360 
0x12CB3460, 36963308502188432, 231261194, 231261197, 3, 640x360 
0x12CB3460, 36963308502507664, 231261233, 231261236, 3, 640x360 
0x12CB3460, 36963308502828000, 231261264, 231261266, 2, 640x360 
0x12CB3460, 36963308503147736, 231261293, 231261296, 3, 640x360 
0x12CB3460, 36963308503467280, 231261324, 231261327, 3, 640x360 
0x12CB3460, 36963308503982568, 231261373, 231261377, 4, 640x360 
0x12CB3460, 36963308504107136, 231261384, 231261387, 3, 640x360 
0x12CB3460, 36963308504429208, 231261423, 231261426, 3, 640x360 
0x12CB3460, 36963308504907864, 231261473, 231261476, 3, 640x360 
0x12CB3460, 36963308505226952, 231261503, 231261506, 3, 640x360 
0x12CB3460, 36963308505549312, 231261533, 231261535, 2, 640x360 
0x12CB3460, 36963308505867200, 231261563, 231261566, 3, 640x360 
0x12CB3460, 36963308506187088, 231261594, 231261596, 2, 640x360 
0x12CB3460, 36963308506508064, 231261624, 231261631, 7, 640x360 
0x12CB3460, 36963308506827400, 231261663, 231261666, 3, 640x360 
0x12CB3460, 36963308507148264, 231261692, 231261696, 4, 640x360 
0x12CB3460, 36963308507467184, 231261723, 231261726, 3, 640x360 
0x12CB3460, 36963308507787104, 231261753, 231261756, 3, 640x360 
0x12CB3460, 36963308508107352, 231261784, 231261787, 3, 640x360 
0x12CB3460, 36963308508430816, 231261824, 231261827, 3, 640x360 
0x12CB3460, 36963308509045328, 231261884, 231261887, 3, 640x360 
0x12CB3460, 36963308509228224, 231261903, 231261906, 3, 640x360 
0x12CB3460, 36963308509548144, 231261933, 231261935, 2, 640x360 
0x12CB3460, 36963308509867672, 231261963, 231261966, 3, 640x360 
0x12CB3460, 36963308510187400, 231261993, 231261996, 3, 640x360 
0x12CB3460, 36963308510507304, 231262033, 231262036, 3, 640x360 
0x12CB3460, 36963308510827592, 231262063, 231262066, 3, 640x360 
0x12CB3460, 36963308511148384, 231262094, 231262097, 3, 640x360 
0x12CB3460, 36963308511467824, 231262124, 231262128, 4, 640x360 
0x12CB3460, 36963308511788992, 231262154, 231262157, 3, 640x360 
0x12CB3460, 36963308512108144, 231262194, 231262197, 3, 640x360 
0x12CB3460, 36963308512588664, 231262234, 231262237, 3, 640x360 
0x12CB3460, 36963308512908856, 231262274, 231262277, 3, 640x360 
0x12CB3460, 36963308513227232, 231262303, 231262306, 3, 640x360 
0x12CB3460, 36963308513547112, 231262333, 231262336, 3, 640x360 
0x12CB3460, 36963308513958128, 231262373, 231262376, 3, 640x360 
0x12CB3460, 36963308514187248, 231262394, 231262397, 3, 640x360 
0x12CB3460, 36963308514507816, 231262434, 231262437, 3, 640x360 
0x12CB3460, 36963308514829952, 231262464, 231262467, 3, 640x360 
0x12CB3460, 36963308515148248, 231262493, 231262495, 2, 640x360 
0x12CB3460, 36963308515467144, 231262523, 231262526, 3, 640x360 
0x12CB3460, 36963308515787672, 231262554, 231262556, 2, 640x360 
0x12CB3460, 36963308516107456, 231262594, 231262596, 2, 640x360 
0x12CB3460, 36963308516586784, 231262633, 231262636, 3, 640x360 
0x12CB3460, 36963308516907160, 231262673, 231262676, 3, 640x360 
0x12CB3460, 36963308517230968, 231262702, 231262705, 3, 640x360 
0x12CB3460, 36963308517546992, 231262733, 231262736, 3, 640x360 
0x12CB3460, 36963308517867320, 231262764, 231262767, 3, 640x360 
0x12CB3460, 36963308518187616, 231262793, 231262799, 6, 640x360 
0x12CB3460, 36963308518507704, 231262824, 231262827, 3, 640x360 
0x12CB3460, 36963308518968136, 231262873, 231262876, 3, 640x360 
0x12CB3460, 36963308519147752, 231262893, 231262896, 3, 640x360 
0x12CB3460, 36963308519467976, 231262923, 231262926, 3, 640x360 
0x12CB3460, 36963308519787520, 231262954, 231262957, 3, 640x360 
0x12CB3460, 36963308520109616, 231262994, 231262997, 3, 640x360 
0x12CB3460, 36963308520586608, 231263034, 231263051, 17, 640x360 
0x12CB3460, 36963308520906616, 231263063, 231263068, 5, 640x360 
0x12CB3460, 36963308521228256, 231263104, 231263107, 3, 640x360 
0x12CB3460, 36963308521547200, 231263133, 231263136, 3, 640x360 
0x12CB3460, 36963308521868584, 231263163, 231263166, 3, 640x360 
0x12CB3460, 36963308522188600, 231263193, 231263196, 3, 640x360 
0x12CB3460, 36963308522507968, 231263233, 231263236, 3, 640x360 
0x12CB3460, 36963308522828464, 231263263, 231263266, 3, 640x360 
0x12CB3460, 36963308523148752, 231263293, 231263297, 4, 640x360 
0x12CB3460, 36963308523467480, 231263324, 231263327, 3, 640x360 
0x12CB3460, 36963308523789160, 231263377, 231263381, 4, 640x360 
0x12CB3460, 36963308524267816, 231263404, 231263406, 2, 640x360 
0x12CB3460, 36963308524589528, 231263433, 231263436, 3, 640x360 
0x12CB3460, 36963308524907672, 231263465, 231263469, 4, 640x360 
0x12CB3460, 36963308525227640, 231263504, 231263507, 3, 640x360 
0x12CB3460, 36963308525549168, 231263534, 231263537, 3, 640x360 
0x12CB3460, 36963308525869608, 231263564, 231263567, 3, 640x360 
0x12CB3460, 36963308526191176, 231263593, 231263598, 5, 640x360 
0x12CB3460, 36963308526511304, 231263633, 231263637, 4, 640x360 
0x12CB3460, 36963308526828272, 231263663, 231263665, 2, 640x360 
0x12CB3460, 36963308527149528, 231263694, 231263697, 3, 640x360 
0x12CB3460, 36963308527470416, 231263723, 231263726, 3, 640x360 
0x12CB3460, 36963308527788632, 231263754, 231263757, 3, 640x360 
0x12CB3460, 36963308528269248, 231263804, 231263807, 3, 640x360 
0x12CB3460, 36963308528586720, 231263833, 231263836, 3, 640x360 
0x12CB3460, 36963308528985904, 231263873, 231263876, 3, 640x360 
0x12CB3460, 36963308529228544, 231263903, 231263906, 3, 640x360 
0x12CB3460, 36963308529548872, 231263933, 231263936, 3, 640x360 
0x12CB3460, 36963308529867856, 231263964, 231263967, 3, 640x360 
0x12CB3460, 36963308530188032, 231263993, 231263997, 4, 640x360 
0x12CB3460, 36963308530507192, 231264024, 231264027, 3, 640x360 
0x12CB3460, 36963308530827784, 231264063, 231264066, 3, 640x360 
0x12CB3460, 36963308531148632, 231264093, 231264095, 2, 640x360 
0x12CB3460, 36963308531468712, 231264124, 231264127, 3, 640x360 
0x12CB3460, 36963308531787336, 231264153, 231264156, 3, 640x360 
0x12CB3460, 36963308532267408, 231264203, 231264206, 3, 640x360 
0x12CB3460, 36963308532587984, 231264234, 231264236, 2, 640x360 
0x12CB3460, 36963308532908536, 231264264, 231264268, 4, 640x360 
0x12CB3460, 36963308533228056, 231264303, 231264306, 3, 640x360 
0x12CB3460, 36963308533548216, 231264334, 231264340, 6, 640x360 
0x12CB3460, 36963308533963912, 231264375, 231264378, 3, 640x360 
0x12CB3460, 36963308534187872, 231264393, 231264396, 3, 640x360 
0x12CB3460, 36963308534507368, 231264433, 231264436, 3, 640x360 
0x12CB3460, 36963308534827928, 231264464, 231264467, 3, 640x360 
0x12CB3460, 36963308535147312, 231264493, 231264496, 3, 640x360 
0x12CB3460, 36963308535467928, 231264523, 231264526, 3, 640x360 
0x12CB3460, 36963308535948720, 231264573, 231264576, 3, 640x360 
0x12CB3460, 36963308536266688, 231264604, 231264606, 2, 640x360 
0x12CB3460, 36963308536589248, 231264634, 231264637, 3, 640x360 
0x12CB3460, 36963308536906864, 231264664, 231264667, 3, 640x360 
0x12CB3460, 36963308537227920, 231264704, 231264707, 3, 640x360 
0x12CB3460, 36963308537547768, 231264733, 231264735, 2, 640x360 
0x12CB3460, 36963308537868296, 231264764, 231264766, 2, 640x360 
0x12CB3460, 36963308538188504, 231264793, 231264798, 5, 640x360 
0x12CB3460, 36963308538507464, 231264824, 231264827, 3, 640x360 
0x12CB3460, 36963308538829664, 231264884, 231264888, 4, 640x360 
0x12CB3460, 36963308539148416, 231264893, 231264896, 3, 640x360 
0x12CB3460, 36963308539467528, 231264924, 231264927, 3, 640x360 
0x12CB3460, 36963308539946904, 231264974, 231264978, 4, 640x360 
0x12CB3460, 36963308540267904, 231265003, 231265006, 3, 640x360 
0x12CB3460, 36963308540587936, 231265034, 231265036, 2, 640x360 
0x12CB3460, 36963308540906952, 231265064, 231265067, 3, 640x360 
0x12CB3460, 36963308541228224, 231265103, 231265107, 4, 640x360 
0x12CB3460, 36963308541548984, 231265133, 231265136, 3, 640x360 
0x12CB3460, 36963308541868328, 231265164, 231265167, 3, 640x360 
0x12CB3460, 36963308542188496, 231265193, 231265197, 4, 640x360 
0x12CB3460, 36963308542507576, 231265233, 231265236, 3, 640x360 
0x12CB3460, 36963308542827344, 231265263, 231265280, 17, 640x360 
0x12CB3460, 36963308543149000, 231265294, 231265298, 4, 640x360 
0x12CB3460, 36963308543629240, 231265343, 231265346, 3, 640x360 
0x12CB3460, 36963308544032160, 231265383, 231265386, 3, 640x360 
0x12CB3460, 36963308544268344, 231265404, 231265407, 3, 640x360 
0x12CB3460, 36963308544588792, 231265434, 231265437, 3, 640x360 
0x12CB3460, 36963308544907448, 231265464, 231265467, 3, 640x360 
0x12CB3460, 36963308545249200, 231265503, 231265508, 5, 640x360 
0x12CB3460, 36963308545547536, 231265532, 231265535, 3, 640x360 
0x12CB3460, 36963308545868344, 231265563, 231265566, 3, 640x360 
0x12CB3460, 36963308546187640, 231265593, 231265596, 3, 640x360 
0x12CB3460, 36963308546507488, 231265633, 231265636, 3, 640x360 
0x12CB3460, 36963308546827392, 231265664, 231265667, 3, 640x360 
0x12CB3460, 36963308547149472, 231265693, 231265696, 3, 640x360 
0x12CB3460, 36963308547627736, 231265744, 231265747, 3, 640x360 
0x12CB3460, 36963308547948440, 231265774, 231265778, 4, 640x360 
0x12CB3460, 36963308548268632, 231265803, 231265806, 3, 640x360 
0x12CB3460, 36963308548590272, 231265833, 231265836, 3, 640x360 
0x12CB3460, 36963308549027952, 231265884, 231265887, 3, 640x360 
0x12CB3460, 36963308549228880, 231265904, 231265906, 2, 640x360 
0x12CB3460, 36963308549548640, 231265933, 231265936, 3, 640x360 
0x12CB3460, 36963308549868432, 231265964, 231265967, 3, 640x360 
0x12CB3460, 36963308550187440, 231265994, 231265997, 3, 640x360 
0x12CB3460, 36963308550507144, 231266033, 231266036, 3, 640x360 
0x12CB3460, 36963308550829544, 231266063, 231266066, 3, 640x360 
0x12CB3460, 36963308551149064, 231266094, 231266096, 2, 640x360 
0x12CB3460, 36963308551629168, 231266143, 231266145, 2, 640x360 
0x12CB3460, 36963308551948168, 231266174, 231266180, 6, 640x360 
0x12CB3460, 36963308552267120, 231266203, 231266206, 3, 640x360 
0x12CB3460, 36963308552586760, 231266233, 231266236, 3, 640x360 
0x12CB3460, 36963308552907144, 231266274, 231266276, 2, 640x360 
0x12CB3460, 36963308553227456, 231266303, 231266305, 2, 640x360 
0x12CB3460, 36963308553547808, 231266333, 231266336, 3, 640x360 
0x12CB3460, 36963308553963048, 231266373, 231266376, 3, 640x360 
0x12CB3460, 36963308554187488, 231266394, 231266397, 3, 640x360 
0x12CB3460, 36963308554506880, 231266424, 231266428, 4, 640x360 
0x12CB3460, 36963308554827408, 231266463, 231266471, 8, 640x360 
0x12CB3460, 36963308555307960, 231266513, 231266516, 3, 640x360 
0x12CB3460, 36963308555626936, 231266544, 231266562, 18, 640x360 
0x12CB3460, 36963308555949184, 231266574, 231266577, 3, 640x360 
0x12CB3460, 36963308556268376, 231266603, 231266606, 3, 640x360 
0x12CB3460, 36963308556589368, 231266634, 231266637, 3, 640x360 
0x12CB3460, 36963308556908328, 231266673, 231266676, 3, 640x360 
0x12CB3460, 36963308557235288, 231266703, 231266706, 3, 640x360 
0x12CB3460, 36963308557548176, 231266733, 231266736, 3, 640x360 
0x12CB3460, 36963308557867944, 231266763, 231266766, 3, 640x360 
0x12CB3460, 36963308558187568, 231266794, 231266798, 4, 640x360 
0x12CB3460, 36963308558507992, 231266833, 231266836, 3, 640x360 
0x12CB3460, 36963308558995584, 231266874, 231266878, 4, 640x360 
0x12CB3460, 36963308559308488, 231266913, 231266916, 3, 640x360 
0x12CB3460, 36963308559629008, 231266944, 231266947, 3, 640x360 
0x12CB3460, 36963308559949288, 231266973, 231266976, 3, 640x360 
0x12CB3460, 36963308560269600, 231267004, 231267007, 3, 640x360 
0x12CB3460, 36963308560588864, 231267034, 231267037, 3, 640x360 
0x12CB3460, 36963308560907304, 231267074, 231267077, 3, 640x360 
0x12CB3460, 36963308561233640, 231267103, 231267106, 3, 640x360 
0x12CB3460, 36963308561547160, 231267133, 231267137, 4, 640x360 
0x12CB3460, 36963308561866728, 231267163, 231267165, 2, 640x360 
0x12CB3460, 36963308562186888, 231267193, 231267197, 4, 640x360 
0x12CB3460, 36963308562507448, 231267232, 231267235, 3, 640x360 
0x12CB3460, 36963308562827312, 231267263, 231267265, 2, 640x360 
0x12CB3460, 36963308563307144, 231267314, 231267317, 3, 640x360 
0x12CB3460, 36963308563628640, 231267343, 231267369, 26, 640x360 
0x12CB3460, 36963308563980488, 231267374, 231267392, 18, 640x360 
0x12CB3460, 36963308564266872, 231267403, 231267406, 3, 640x360 
0x12CB3460, 36963308564588808, 231267435, 231267437, 2, 640x360 
0x12CB3460, 36963308564908032, 231267465, 231267469, 4, 640x360 
0x12CB3460, 36963308565228000, 231267503, 231267506, 3, 640x360 
0x12CB3460, 36963308565547928, 231267532, 231267535, 3, 640x360 
0x12CB3460, 36963308565868872, 231267564, 231267566, 2, 640x360 
0x12CB3460, 36963308566191280, 231267593, 231267597, 4, 640x360 
0x12CB3460, 36963308566509408, 231267624, 231267628, 4, 640x360 
0x12CB3460, 36963308566987936, 231267674, 231267677, 3, 640x360 
0x12CB3460, 36963308567306744, 231267714, 231267716, 2, 640x360 
0x12CB3460, 36963308567626960, 231267743, 231267745, 2, 640x360 
0x12CB3460, 36963308567948984, 231267774, 231267778, 4, 640x360 
0x12CB3460, 36963308568266600, 231267803, 231267806, 3, 640x360 
0x12CB3460, 36963308568587088, 231267832, 231267836, 4, 640x360 
0x12CB3460, 36963308569070896, 231267883, 231267886, 3, 640x360 
0x12CB3460, 36963308569229720, 231267903, 231267906, 3, 640x360 
0x12CB3460, 36963308569548080, 231267932, 231267935, 3, 640x360 
0x12CB3460, 36963308569868992, 231267964, 231267967, 3, 640x360 
0x12CB3460, 36963308570187160, 231267993, 231267997, 4, 640x360 
0x12CB3460, 36963308570506968, 231268034, 231268037, 3, 640x360 
0x12CB3460, 36963308570986536, 231268074, 231268077, 3, 640x360 
0x12CB3460, 36963308571309816, 231268114, 231268117, 3, 640x360 
0x12CB3460, 36963308571627264, 231268145, 231268148, 3, 640x360 
0x12CB3460, 36963308571946992, 231268173, 231268176, 3, 640x360 
0x12CB3460, 36963308572267544, 231268203, 231268206, 3, 640x360 
0x12CB3460, 36963308572590136, 231268233, 231268236, 3, 640x360 
0x12CB3460, 36963308572907120, 231268273, 231268276, 3, 640x360 
0x12CB3460, 36963308573229520, 231268304, 231268306, 2, 640x360 
0x12CB3460, 36963308573547224, 231268333, 231268336, 3, 640x360 
0x12CB3460, 36963308573968536, 231268374, 231268377, 3, 640x360 
0x12CB3460, 36963308574187480, 231268393, 231268396, 3, 640x360 
0x12CB3460, 36963308574507592, 231268432, 231268435, 3, 640x360 
0x12CB3460, 36963308574987872, 231268473, 231268477, 4, 640x360 
0x12CB3460, 36963308575306904, 231268513, 231268531, 18, 640x360 
0x12CB3460, 36963308575627920, 231268544, 231268547, 3, 640x360 
0x12CB3460, 36963308575948816, 231268574, 231268577, 3, 640x360 
0x12CB3460, 36963308576266448, 231268603, 231268606, 3, 640x360 
0x12CB3460, 36963308576588352, 231268634, 231268637, 3, 640x360 
0x12CB3460, 36963308576907080, 231268673, 231268691, 18, 640x360 
0x12CB3460, 36963308577228184, 231268705, 231268708, 3, 640x360 
0x12CB3460, 36963308577546896, 231268733, 231268735, 2, 640x360 
0x12CB3460, 36963308577867560, 231268764, 231268766, 2, 640x360 
0x12CB3460, 36963308578188240, 231268794, 231268799, 5, 640x360 
0x12CB3460, 36963308578666480, 231268843, 231268870, 27, 640x360 
0x12CB3460, 36963308578995896, 231268875, 231268878, 3, 640x360 
0x12CB3460, 36963308579306520, 231268914, 231268916, 2, 640x360 
0x12CB3460, 36963308579628512, 231268943, 231268946, 3, 640x360 
0x12CB3460, 36963308579948856, 231268974, 231268977, 3, 640x360 
0x12CB3460, 36963308580267024, 231269004, 231269006, 2, 640x360 
0x12CB3460, 36963308580588296, 231269034, 231269037, 3, 640x360 
0x12CB3460, 36963308580906440, 231269064, 231269067, 3, 640x360 
0x12CB3460, 36963308581227752, 231269103, 231269106, 3, 640x360 
0x12CB3460, 36963308581548128, 231269133, 231269136, 3, 640x360 
0x12CB3460, 36963308581867560, 231269163, 231269166, 3, 640x360 
0x12CB3460, 36963308582188056, 231269193, 231269196, 3, 640x360 
0x12CB3460, 36963308582668224, 231269244, 231269246, 2, 640x360 
0x12CB3460, 36963308582986784, 231269273, 231269276, 3, 640x360 
0x12CB3460, 36963308583310088, 231269314, 231269318, 4, 640x360 
0x12CB3460, 36963308583626536, 231269343, 231269345, 2, 640x360 
0x12CB3460, 36963308584056200, 231269383, 231269386, 3, 640x360 
0x12CB3460, 36963308584267304, 231269403, 231269405, 2, 640x360 
0x12CB3460, 36963308584587200, 231269433, 231269436, 3, 640x360 
0x12CB3460, 36963308584907456, 231269473, 231269476, 3, 640x360 
0x12CB3460, 36963308585227704, 231269503, 231269505, 2, 640x360 
0x12CB3460, 36963308585548648, 231269533, 231269536, 3, 640x360 
0x12CB3460, 36963308585869392, 231269563, 231269566, 3, 640x360 
0x12CB3460, 36963308586348136, 231269613, 231269617, 4, 640x360 
0x12CB3460, 36963308586668080, 231269644, 231269647, 3, 640x360 
0x12CB3460, 36963308586988888, 231269673, 231269676, 3, 640x360 
0x12CB3460, 36963308587307040, 231269704, 231269723, 19, 640x360 
0x12CB3460, 36963308587629016, 231269743, 231269746, 3, 640x360 
0x12CB3460, 36963308587950096, 231269773, 231269776, 3, 640x360 
0x12CB3460, 36963308588269392, 231269803, 231269806, 3, 640x360 
0x12CB3460, 36963308588590280, 231269834, 231269838, 4, 640x360 
0x12CB3460, 36963308588985504, 231269873, 231269877, 4, 640x360 
0x12CB3460, 36963308589227056, 231269903, 231269905, 2, 640x360 
0x12CB3460, 36963308589548544, 231269934, 231269949, 15, 640x360 
0x12CB3460, 36963308589869408, 231269964, 231269967, 3, 640x360 
0x12CB3460, 36963308590348280, 231270014, 231270016, 2, 640x360 
0x12CB3460, 36963308590668384, 231270043, 231270046, 3, 640x360 
0x12CB3460, 36963308590986456, 231270074, 231270077, 3, 640x360 
0x12CB3460, 36963308591307560, 231270105, 231270108, 3, 640x360 
0x12CB3460, 36963308591626816, 231270143, 231270147, 4, 640x360 
0x12CB3460, 36963308591947016, 231270173, 231270176, 3, 640x360 
0x12CB3460, 36963308592267088, 231270204, 231270206, 2, 640x360 
0x12CB3460, 36963308592587680, 231270233, 231270236, 3, 640x360 
0x12CB3460, 36963308592907784, 231270264, 231270268, 4, 640x360 
0x12CB3460, 36963308593226832, 231270303, 231270306, 3, 640x360 
0x12CB3460, 36963308593546752, 231270332, 231270335, 3, 640x360 
0x12CB3460, 36963308593974560, 231270373, 231270376, 3, 640x360 
0x12CB3460, 36963308594347312, 231270413, 231270415, 2, 640x360 
0x12CB3460, 36963308594667216, 231270443, 231270446, 3, 640x360 
0x12CB3460, 36963308594987440, 231270473, 231270476, 3, 640x360 
0x12CB3460, 36963308595308624, 231270504, 231270507, 3, 640x360 
0x12CB3460, 36963308595628528, 231270544, 231270546, 2, 640x360 
0x12CB3460, 36963308595950152, 231270573, 231270576, 3, 640x360 
0x12CB3460, 36963308596268288, 231270602, 231270605, 3, 640x360 
0x12CB3460, 36963308596587408, 231270634, 231270638, 4, 640x360 
0x12CB3460, 36963308596907584, 231270664, 231270667, 3, 640x360 
0x12CB3460, 36963308597227792, 231270703, 231270706, 3, 640x360 
0x12CB3460, 36963308597547576, 231270733, 231270736, 3, 640x360 
0x12CB3460, 36963308598028824, 231270783, 231270786, 3, 640x360 
0x12CB3460, 36963308598348888, 231270813, 231270816, 3, 640x360 
0x12CB3460, 36963308598667384, 231270843, 231270869, 26, 640x360 
0x12CB3460, 36963308598988592, 231270874, 231270877, 3, 640x360 
0x12CB3460, 36963308599307840, 231270913, 231270915, 2, 640x360 
0x12CB3460, 36963308599628520, 231270944, 231270947, 3, 640x360 
0x12CB3460, 36963308599948192, 231270973, 231270976, 3, 640x360 
0x12CB3460, 36963308600268048, 231271003, 231271006, 3, 640x360 
0x12CB3460, 36963308600586672, 231271033, 231271036, 3, 640x360 
0x12CB3460, 36963308600907840, 231271073, 231271076, 3, 640x360 
0x12CB3460, 36963308601227248, 231271103, 231271107, 4, 640x360 
0x12CB3460, 36963308601547656, 231271133, 231271135, 2, 640x360 
0x12CB3460, 36963308602026624, 231271183, 231271186, 3, 640x360 
0x12CB3460, 36963308602348208, 231271213, 231271231, 18, 640x360 
0x12CB3460, 36963308602667736, 231271243, 231271246, 3, 640x360 
0x12CB3460, 36963308602987200, 231271273, 231271277, 4, 640x360 
0x12CB3460, 36963308603309120, 231271313, 231271316, 3, 640x360 
0x12CB3460, 36963308603627344, 231271343, 231271348, 5, 640x360 
0x12CB3460, 36963308604055176, 231271382, 231271385, 3, 640x360 
0x12CB3460, 36963308604267640, 231271402, 231271421, 19, 640x360 
0x12CB3460, 36963308604587344, 231271434, 231271437, 3, 640x360 
0x12CB3460, 36963308604907440, 231271474, 231271477, 3, 640x360 
0x12CB3460, 36963308605237824, 231271503, 231271506, 3, 640x360 
0x12CB3460, 36963308605547032, 231271534, 231271537, 3, 640x360 
0x12CB3460, 36963308606027288, 231271584, 231271586, 2, 640x360 
0x12CB3460, 36963308606349752, 231271613, 231271616, 3, 640x360 
0x12CB3460, 36963308606668968, 231271643, 231271648, 5, 640x360 
0x12CB3460, 36963308606988656, 231271674, 231271677, 3, 640x360 
0x12CB3460, 36963308607309456, 231271714, 231271718, 4, 640x360 
0x12CB3460, 36963308607627632, 231271743, 231271746, 3, 640x360 
0x12CB3460, 36963308607947936, 231271774, 231271777, 3, 640x360 
0x12CB3460, 36963308608267024, 231271803, 231271806, 3, 640x360 
0x12CB3460, 36963308608588144, 231271833, 231271840, 7, 640x360 
0x12CB3460, 36963308608991000, 231271883, 231271886, 3, 640x360 
0x12CB3460, 36963308609231416, 231271903, 231271906, 3, 640x360 
0x12CB3460, 36963308609708136, 231271954, 231271957, 3, 640x360 
0x12CB3460, 36963308610028824, 231271983, 231271987, 4, 640x360 
0x12CB3460, 36963308610346040, 231272013, 231272015, 2, 640x360 
0x12CB3460, 36963308610666584, 231272044, 231272047, 3, 640x360 
0x12CB3460, 36963308610986688, 231272073, 231272077, 4, 640x360 
0x12CB3460, 36963308611307504, 231272104, 231272119, 15, 640x360 
0x12CB3460, 36963308611627392, 231272143, 231272146, 3, 640x360 
0x12CB3460, 36963308611947728, 231272173, 231272175, 2, 640x360 
0x12CB3460, 36963308612266896, 231272203, 231272207, 4, 640x360 
0x12CB3460, 36963308612586264, 231272233, 231272235, 2, 640x360 
0x12CB3460, 36963308612908272, 231272273, 231272276, 3, 640x360 
0x12CB3460, 36963308613231752, 231272304, 231272307, 3, 640x360 
0x12CB3460, 36963308613708552, 231272353, 231272381, 28, 640x360 
0x12CB3460, 36963308614102168, 231272385, 231272388, 3, 640x360 
0x12CB3460, 36963308614347736, 231272413, 231272416, 3, 640x360 
0x12CB3460, 36963308614666888, 231272444, 231272447, 3, 640x360 
0x12CB3460, 36963308614987440, 231272474, 231272477, 3, 640x360 
0x12CB3460, 36963308615307880, 231272513, 231272517, 4, 640x360 
0x12CB3460, 36963308615630576, 231272544, 231272549, 5, 640x360 
0x12CB3460, 36963308615947800, 231272573, 231272575, 2, 640x360 
0x12CB3460, 36963308616266912, 231272604, 231272606, 2, 640x360 
0x12CB3460, 36963308616589080, 231272633, 231272636, 3, 640x360 
0x12CB3460, 36963308616908888, 231272674, 231272677, 3, 640x360 
0x12CB3460, 36963308617228200, 231272703, 231272706, 3, 640x360 
0x12CB3460, 36963308617706040, 231272744, 231272748, 4, 640x360 
0x12CB3460, 36963308618026904, 231272783, 231272786, 3, 640x360 
0x12CB3460, 36963308618346680, 231272814, 231272817, 3, 640x360 
0x12CB3460, 36963308618667880, 231272843, 231272846, 3, 640x360 
0x12CB3460, 36963308619092024, 231272883, 231272887, 4, 640x360 
0x12CB3460, 36963308619307136, 231272903, 231272907, 4, 640x360 
0x12CB3460, 36963308619627840, 231272943, 231272946, 3, 640x360 
0x12CB3460, 36963308619949168, 231272973, 231272979, 6, 640x360 
0x12CB3460, 36963308620267952, 231273003, 231273006, 3, 640x360 
0x12CB3460, 36963308620588984, 231273034, 231273037, 3, 640x360 
0x12CB3460, 36963308620906536, 231273063, 231273067, 4, 640x360 
0x12CB3460, 36963308621387808, 231273114, 231273123, 9, 640x360 
0x12CB3460, 36963308621706592, 231273154, 231273156, 2, 640x360 
0x12CB3460, 36963308622028688, 231273183, 231273186, 3, 640x360 
0x12CB3460, 36963308622349272, 231273214, 231273217, 3, 640x360 
0x12CB3460, 36963308622667120, 231273243, 231273245, 2, 640x360 
0x12CB3460, 36963308622987208, 231273274, 231273276, 2, 640x360 
0x12CB3460, 36963308623308504, 231273313, 231273316, 3, 640x360 
0x12CB3460, 36963308623627440, 231273344, 231273372, 28, 640x360 
0x12CB3460, 36963308624006424, 231273383, 231273386, 3, 640x360 
0x12CB3460, 36963308624267624, 231273404, 231273407, 3, 640x360 
0x12CB3460, 36963308624588184, 231273433, 231273436, 3, 640x360 
0x12CB3460, 36963308624908200, 231273474, 231273477, 3, 640x360 
0x12CB3460, 36963308625387960, 231273513, 231273515, 2, 640x360 
0x12CB3460, 36963308625708368, 231273553, 231273556, 3, 640x360 
0x12CB3460, 36963308626029400, 231273583, 231273586, 3, 640x360 
0x12CB3460, 36963308626349624, 231273614, 231273617, 3, 640x360 
0x12CB3460, 36963308626668896, 231273643, 231273647, 4, 640x360 
0x12CB3460, 36963308626986680, 231273674, 231273677, 3, 640x360 
0x12CB3460, 36963308627308384, 231273714, 231273731, 17, 640x360 
0x12CB3460, 36963308627627608, 231273744, 231273747, 3, 640x360 
0x12CB3460, 36963308627948464, 231273774, 231273777, 3, 640x360 
0x12CB3460, 36963308628266672, 231273803, 231273806, 3, 640x360 
0x12CB3460, 36963308628588144, 231273833, 231273836, 3, 640x360 
0x12CB3460, 36963308629067200, 231273884, 231273901, 17, 640x360 
0x12CB3460, 36963308629387648, 231273913, 231273916, 3, 640x360 
0x12CB3460, 36963308629708240, 231273953, 231273956, 3, 640x360 
0x12CB3460, 36963308630036632, 231273983, 231273989, 6, 640x360 
0x12CB3460, 36963308630347936, 231274013, 231274016, 3, 640x360 
0x12CB3460, 36963308630667256, 231274043, 231274046, 3, 640x360 
0x12CB3460, 36963308630986584, 231274074, 231274077, 3, 640x360 
0x12CB3460, 36963308631307944, 231274113, 231274116, 3, 640x360 
0x12CB3460, 36963308631628456, 231274143, 231274146, 3, 640x360 
0x12CB3460, 36963308631948504, 231274173, 231274176, 3, 640x360 
0x12CB3460, 36963308632268864, 231274203, 231274207, 4, 640x360 
0x12CB3460, 36963308632588288, 231274232, 231274236, 4, 640x360 
0x12CB3460, 36963308633068168, 231274283, 231274286, 3, 640x360 
0x12CB3460, 36963308633386448, 231274314, 231274319, 5, 640x360 
0x12CB3460, 36963308633706568, 231274371, 231274374, 3, 640x360 
0x12CB3460, 36963308634038504, 231274383, 231274386, 3, 640x360 
0x12CB3460, 36963308634348000, 231274413, 231274416, 3, 640x360 
0x12CB3460, 36963308634668152, 231274443, 231274447, 4, 640x360 
0x12CB3460, 36963308634987632, 231274474, 231274476, 2, 640x360 
0x12CB3460, 36963308635307560, 231274514, 231274517, 3, 640x360 
0x12CB3460, 36963308635626520, 231274543, 231274546, 3, 640x360 
0x12CB3460, 36963308635947104, 231274573, 231274576, 3, 640x360 
0x12CB3460, 36963308636269056, 231274603, 231274606, 3, 640x360 
0x12CB3460, 36963308636590352, 231274644, 231274648, 4, 640x360 
0x12CB3460, 36963308637068432, 231274684, 231274687, 3, 640x360 
0x12CB3460, 36963308637386208, 231274713, 231274716, 3, 640x360 
0x12CB3460, 36963308637708064, 231274744, 231274747, 3, 640x360 
0x12CB3460, 36963308638027456, 231274784, 231274786, 2, 640x360 
0x12CB3460, 36963308638347568, 231274813, 231274815, 2, 640x360 
0x12CB3460, 36963308638667360, 231274844, 231274874, 30, 640x360 
0x12CB3460, 36963308639028504, 231274883, 231274886, 3, 640x360 
0x12CB3460, 36963308639306536, 231274903, 231274907, 4, 640x360 
0x12CB3460, 36963308639627144, 231274943, 231274946, 3, 640x360 
0x12CB3460, 36963308639947368, 231274974, 231274978, 4, 640x360 
0x12CB3460, 36963308640267672, 231275003, 231275005, 2, 640x360 
0x12CB3460, 36963308640748904, 231275052, 231275056, 4, 640x360 
0x12CB3460, 36963308641067256, 231275083, 231275086, 3, 640x360 
0x12CB3460, 36963308641387832, 231275113, 231275116, 3, 640x360 
0x12CB3460, 36963308641706712, 231275153, 231275170, 17, 640x360 
0x12CB3460, 36963308642028232, 231275183, 231275187, 4, 640x360 
0x12CB3460, 36963308642347608, 231275213, 231275216, 3, 640x360 
0x12CB3460, 36963308642667600, 231275243, 231275246, 3, 640x360 
0x12CB3460, 36963308642986848, 231275274, 231275277, 3, 640x360 
0x12CB3460, 36963308643307248, 231275313, 231275316, 3, 640x360 
0x12CB3460, 36963308643628136, 231275343, 231275346, 3, 640x360 
0x12CB3460, 36963308644094000, 231275384, 231275388, 4, 640x360 
0x12CB3460, 36963308644267144, 231275403, 231275406, 3, 640x360 
0x12CB3460, 36963308644746448, 231275454, 231275456, 2, 640x360 
0x12CB3460, 36963308645067720, 231275483, 231275486, 3, 640x360 
0x12CB3460, 36963308645386488, 231275514, 231275517, 3, 640x360 
0x12CB3460, 36963308645708344, 231275553, 231275556, 3, 640x360 
0x12CB3460, 36963308646027912, 231275584, 231275587, 3, 640x360 
0x12CB3460, 36963308646348584, 231275613, 231275616, 3, 640x360 
0x12CB3460, 36963308646667856, 231275643, 231275646, 3, 640x360 
0x12CB3460, 36963308646986336, 231275673, 231275676, 3, 640x360 
0x12CB3460, 36963308647308192, 231275704, 231275707, 3, 640x360 
0x12CB3460, 36963308647626104, 231275744, 231275746, 2, 640x360 
0x12CB3460, 36963308647947704, 231275773, 231275776, 3, 640x360 
0x12CB3460, 36963308648268520, 231275803, 231275806, 3, 640x360 
0x12CB3460, 36963308648746824, 231275878, 231275881, 3, 640x360 
0x12CB3460, 36963308649077440, 231275884, 231275886, 2, 640x360 
0x12CB3460, 36963308649386296, 231275914, 231275917, 3, 640x360 
0x12CB3460, 36963308649708320, 231275955, 231275959, 4, 640x360 
0x12CB3460, 36963308650027080, 231275985, 231275988, 3, 640x360 
0x12CB3460, 36963308650347432, 231276013, 231276016, 3, 640x360 
0x12CB3460, 36963308650666728, 231276044, 231276047, 3, 640x360 
0x12CB3460, 36963308650987880, 231276073, 231276076, 3, 640x360 
0x12CB3460, 36963308651307200, 231276104, 231276108, 4, 640x360 
0x12CB3460, 36963308651626936, 231276143, 231276146, 3, 640x360 
0x12CB3460, 36963308651948480, 231276173, 231276176, 3, 640x360 
0x12CB3460, 36963308652426600, 231276223, 231276226, 3, 640x360 
0x12CB3460, 36963308652746288, 231276253, 231276256, 3, 640x360 
0x12CB3460, 36963308653067080, 231276283, 231276285, 2, 640x360 
0x12CB3460, 36963308653389232, 231276313, 231276318, 5, 640x360 
0x12CB3460, 36963308653706264, 231276370, 231276374, 4, 640x360 
0x12CB3460, 36963308654028056, 231276383, 231276385, 2, 640x360 
0x12CB3460, 36963308654348256, 231276413, 231276416, 3, 640x360 
0x12CB3460, 36963308654667984, 231276444, 231276448, 4, 640x360 
0x12CB3460, 36963308654986544, 231276473, 231276476, 3, 640x360 
0x12CB3460, 36963308655306976, 231276514, 231276518, 4, 640x360 
0x12CB3460, 36963308655628128, 231276544, 231276546, 2, 640x360 
0x12CB3460, 36963308655948712, 231276573, 231276576, 3, 640x360 
0x12CB3460, 36963308656428104, 231276624, 231276626, 2, 640x360 
0x12CB3460, 36963308656746264, 231276653, 231276658, 5, 640x360 
0x12CB3460, 36963308657068144, 231276683, 231276686, 3, 640x360 
0x12CB3460, 36963308657389544, 231276713, 231276716, 3, 640x360 
0x12CB3460, 36963308657707592, 231276744, 231276747, 3, 640x360 
0x12CB3460, 36963308658027864, 231276783, 231276786, 3, 640x360 
0x12CB3460, 36963308658347504, 231276813, 231276816, 3, 640x360 
0x12CB3460, 36963308658665800, 231276843, 231276846, 3, 640x360 
0x12CB3460, 36963308659074528, 231276884, 231276887, 3, 640x360 
0x12CB3460, 36963308659306832, 231276904, 231276907, 3, 640x360 
0x12CB3460, 36963308659626560, 231276944, 231276947, 3, 640x360 
0x12CB3460, 36963308660107424, 231276984, 231276987, 3, 640x360 
0x12CB3460, 36963308660426088, 231277023, 231277026, 3, 640x360 
0x12CB3460, 36963308660747808, 231277053, 231277056, 3, 640x360 
0x12CB3460, 36963308661067208, 231277083, 231277086, 3, 640x360 
0x12CB3460, 36963308661387792, 231277113, 231277116, 3, 640x360 
0x12CB3460, 36963308661706864, 231277144, 231277148, 4, 640x360 
0x12CB3460, 36963308662030904, 231277183, 231277186, 3, 640x360 
0x12CB3460, 36963308662345992, 231277213, 231277216, 3, 640x360 
0x12CB3460, 36963308662666600, 231277244, 231277246, 2, 640x360 
0x12CB3460, 36963308662986528, 231277273, 231277276, 3, 640x360 
0x12CB3460, 36963308663306832, 231277304, 231277308, 4, 640x360 
0x12CB3460, 36963308663627888, 231277343, 231277346, 3, 640x360 
0x12CB3460, 36963308664106848, 231277384, 231277387, 3, 640x360 
0x12CB3460, 36963308664427840, 231277422, 231277425, 3, 640x360 
0x12CB3460, 36963308664748416, 231277454, 231277457, 3, 640x360 
0x12CB3460, 36963308665069096, 231277483, 231277486, 3, 640x360 
0x12CB3460, 36963308665387976, 231277514, 231277517, 3, 640x360 
0x12CB3460, 36963308665708384, 231277553, 231277555, 2, 640x360 
0x12CB3460, 36963308666028432, 231277585, 231277603, 18, 640x360 
0x12CB3460, 36963308666352848, 231277615, 231277619, 4, 640x360 
0x12CB3460, 36963308666671056, 231277643, 231277647, 4, 640x360 
0x12CB3460, 36963308666987792, 231277674, 231277678, 4, 640x360 
0x12CB3460, 36963308667307344, 231277714, 231277717, 3, 640x360 
0x12CB3460, 36963308667627496, 231277743, 231277746, 3, 640x360 
0x12CB3460, 36963308668107928, 231277793, 231277796, 3, 640x360 
0x12CB3460, 36963308668428320, 231277824, 231277827, 3, 640x360 
0x12CB3460, 36963308668970352, 231277883, 231277886, 3, 640x360 
0x12CB3460, 36963308669387280, 231277913, 231277916, 3, 640x360 
0x12CB3460, 36963308669708024, 231277954, 231277956, 2, 640x360 
0x12CB3460, 36963308670027992, 231277983, 231277990, 7, 640x360 
0x12CB3460, 36963308670347136, 231278014, 231278016, 2, 640x360 
0x12CB3460, 36963308670666712, 231278043, 231278046, 3, 640x360 
0x12CB3460, 36963308670987640, 231278072, 231278076, 4, 640x360 
0x12CB3460, 36963308671306408, 231278104, 231278107, 3, 640x360 
0x12CB3460, 36963308671785632, 231278153, 231278156, 3, 640x360 
0x12CB3460, 36963308672107648, 231278184, 231278188, 4, 640x360 
0x12CB3460, 36963308672425784, 231278223, 231278226, 3, 640x360 
0x12CB3460, 36963308672748520, 231278253, 231278256, 3, 640x360 
0x12CB3460, 36963308673067984, 231278284, 231278286, 2, 640x360 
0x12CB3460, 36963308673388072, 231278313, 231278318, 5, 640x360 
0x12CB3460, 36963308673707456, 231278344, 231278368, 24, 640x360 
0x12CB3460, 36963308674034008, 231278382, 231278385, 3, 640x360 
0x12CB3460, 36963308674347288, 231278413, 231278416, 3, 640x360 
0x12CB3460, 36963308674666632, 231278443, 231278447, 4, 640x360 
0x12CB3460, 36963308674987296, 231278474, 231278477, 3, 640x360 
0x12CB3460, 36963308675306976, 231278513, 231278516, 3, 640x360 
0x12CB3460, 36963308675788208, 231278553, 231278556, 3, 640x360 
0x12CB3460, 36963308676109408, 231278594, 231278612, 18, 640x360 
0x12CB3460, 36963308676431400, 231278624, 231278627, 3, 640x360 
0x12CB3460, 36963308676750032, 231278654, 231278657, 3, 640x360 
0x12CB3460, 36963308677068664, 231278684, 231278687, 3, 640x360 
0x12CB3460, 36963308677388200, 231278713, 231278717, 4, 640x360 
0x12CB3460, 36963308677706632, 231278744, 231278747, 3, 640x360 
0x12CB3460, 36963308678026272, 231278785, 231278788, 3, 640x360 
0x12CB3460, 36963308678347032, 231278813, 231278816, 3, 640x360 
0x12CB3460, 36963308678667752, 231278843, 231278874, 31, 640x360 
0x12CB3460, 36963308679034072, 231278883, 231278886, 3, 640x360 
0x12CB3460, 36963308679307720, 231278904, 231278907, 3, 640x360 
0x12CB3460, 36963308679787120, 231278953, 231278956, 3, 640x360 
0x12CB3460, 36963308680107432, 231278984, 231278988, 4, 640x360 
0x12CB3460, 36963308680427200, 231279023, 231279027, 4, 640x360 
0x12CB3460, 36963308680747880, 231279053, 231279056, 3, 640x360 
0x12CB3460, 36963308681065816, 231279082, 231279085, 3, 640x360 
0x12CB3460, 36963308681386544, 231279113, 231279116, 3, 640x360 
0x12CB3460, 36963308681707816, 231279154, 231279156, 2, 640x360 
0x12CB3460, 36963308682026360, 231279183, 231279186, 3, 640x360 
0x12CB3460, 36963308682347960, 231279214, 231279217, 3, 640x360 
0x12CB3460, 36963308682668456, 231279243, 231279246, 3, 640x360 
0x12CB3460, 36963308682987712, 231279273, 231279276, 3, 640x360 
0x12CB3460, 36963308683465928, 231279322, 231279325, 3, 640x360 
0x12CB3460, 36963308683971112, 231279373, 231279376, 3, 640x360 
0x12CB3460, 36963308684106832, 231279393, 231279396, 3, 640x360 
0x12CB3460, 36963308684426400, 231279423, 231279426, 3, 640x360 
0x12CB3460, 36963308684746888, 231279453, 231279456, 3, 640x360 
0x12CB3460, 36963308685068440, 231279484, 231279486, 2, 640x360 
0x12CB3460, 36963308685388480, 231279513, 231279517, 4, 640x360 
0x12CB3460, 36963308685706376, 231279553, 231279556, 3, 640x360 
0x12CB3460, 36963308686028120, 231279583, 231279586, 3, 640x360 
0x12CB3460, 36963308686350184, 231279614, 231279617, 3, 640x360 
0x12CB3460, 36963308686671264, 231279644, 231279647, 3, 640x360 
0x12CB3460, 36963308686995640, 231279683, 231279689, 6, 640x360 
0x12CB3460, 36963308687466248, 231279724, 231279726, 2, 640x360 
0x12CB3460, 36963308687785760, 231279753, 231279756, 3, 640x360 
0x12CB3460, 36963308688107504, 231279784, 231279788, 4, 640x360 
0x12CB3460, 36963308688434864, 231279824, 231279826, 2, 640x360 
0x12CB3460, 36963308688746136, 231279875, 231279878, 3, 640x360 
0x12CB3460, 36963308689067288, 231279882, 231279885, 3, 640x360 
0x12CB3460, 36963308689387544, 231279913, 231279916, 3, 640x360 
0x12CB3460, 36963308689707720, 231279954, 231279959, 5, 640x360 
0x12CB3460, 36963308690027600, 231279983, 231279986, 3, 640x360 
0x12CB3460, 36963308690345800, 231280014, 231280016, 2, 640x360 
0x12CB3460, 36963308690666856, 231280043, 231280046, 3, 640x360 
0x12CB3460, 36963308690987512, 231280074, 231280077, 3, 640x360 
0x12CB3460, 36963308691466288, 231280123, 231280126, 3, 640x360 
0x12CB3460, 36963308691787760, 231280154, 231280157, 3, 640x360 
0x12CB3460, 36963308692106808, 231280193, 231280196, 3, 640x360 
0x12CB3460, 36963308692428432, 231280222, 231280225, 3, 640x360 
0x12CB3460, 36963308692746208, 231280253, 231280256, 3, 640x360 
0x12CB3460, 36963308693066000, 231280283, 231280286, 3, 640x360 
0x12CB3460, 36963308693386240, 231280314, 231280317, 3, 640x360 
0x12CB3460, 36963308693706480, 231280375, 231280379, 4, 640x360 
0x12CB3460, 36963308694068792, 231280383, 231280386, 3, 640x360 
0x12CB3460, 36963308694346336, 231280412, 231280415, 3, 640x360 
0x12CB3460, 36963308694667872, 231280443, 231280446, 3, 640x360 
0x12CB3460, 36963308695145520, 231280494, 231280498, 4, 640x360 
0x12CB3460, 36963308695467544, 231280523, 231280526, 3, 640x360 
0x12CB3460, 36963308695787768, 231280554, 231280557, 3, 640x360 
0x12CB3460, 36963308696106424, 231280584, 231280587, 3, 640x360 
0x12CB3460, 36963308696430096, 231280624, 231280627, 3, 640x360 
0x12CB3460, 36963308696752184, 231280654, 231280657, 3, 640x360 
0x12CB3460, 36963308697069232, 231280684, 231280687, 3, 640x360 
0x12CB3460, 36963308697391344, 231280714, 231280717, 3, 640x360 
0x12CB3460, 36963308697706992, 231280753, 231280756, 3, 640x360 
0x12CB3460, 36963308698033272, 231280783, 231280786, 3, 640x360 
0x12CB3460, 36963308698346712, 231280813, 231280816, 3, 640x360 
0x12CB3460, 36963308698666496, 231280842, 231280870, 28, 640x360 
0x12CB3460, 36963308699147216, 231280893, 231280896, 3, 640x360 
0x12CB3460, 36963308699465800, 231280924, 231280927, 3, 640x360 
0x12CB3460, 36963308699785760, 231280954, 231280956, 2, 640x360 
0x12CB3460, 36963308700107008, 231280993, 231281001, 8, 640x360 
0x12CB3460, 36963308700426272, 231281023, 231281026, 3, 640x360 
0x12CB3460, 36963308700746896, 231281054, 231281057, 3, 640x360 
0x12CB3460, 36963308701066504, 231281083, 231281086, 3, 640x360 
0x12CB3460, 36963308701387320, 231281114, 231281116, 2, 640x360 
0x12CB3460, 36963308701707224, 231281153, 231281156, 3, 640x360 
0x12CB3460, 36963308702026672, 231281183, 231281186, 3, 640x360 
0x12CB3460, 36963308702348424, 231281214, 231281217, 3, 640x360 
0x12CB3460, 36963308702825736, 231281263, 231281280, 17, 640x360 
0x12CB3460, 36963308703147984, 231281293, 231281296, 3, 640x360 
0x12CB3460, 36963308703468904, 231281323, 231281326, 3, 640x360 
0x12CB3460, 36963308703786976, 231281384, 231281390, 6, 640x360 
0x12CB3460, 36963308704110864, 231281393, 231281397, 4, 640x360 
0x12CB3460, 36963308704425904, 231281424, 231281426, 2, 640x360 
0x12CB3460, 36963308704747272, 231281453, 231281456, 3, 640x360 
0x12CB3460, 36963308705067048, 231281483, 231281486, 3, 640x360 
0x12CB3460, 36963308705387624, 231281513, 231281517, 4, 640x360 
0x12CB3460, 36963308705708784, 231281554, 231281557, 3, 640x360 
0x12CB3460, 36963308706028360, 231281583, 231281586, 3, 640x360 
0x12CB3460, 36963308706347960, 231281614, 231281617, 3, 640x360 
0x12CB3460, 36963308706825456, 231281664, 231281667, 3, 640x360 
0x12CB3460, 36963308707147232, 231281693, 231281698, 5, 640x360 
0x12CB3460, 36963308707465408, 231281722, 231281725, 3, 640x360 
0x12CB3460, 36963308707786904, 231281753, 231281756, 3, 640x360 
0x12CB3460, 36963308708106880, 231281784, 231281788, 4, 640x360 
0x12CB3460, 36963308708425968, 231281825, 231281828, 3, 640x360 
0x12CB3460, 36963308709004376, 231281883, 231281885, 2, 640x360 
0x12CB3460, 36963308709386880, 231281913, 231281916, 3, 640x360 
0x12CB3460, 36963308709707320, 231281954, 231281957, 3, 640x360 
0x12CB3460, 36963308710025912, 231281983, 231281987, 4, 640x360 
0x12CB3460, 36963308710346824, 231282013, 231282016, 3, 640x360 
0x12CB3460, 36963308710825080, 231282063, 231282065, 2, 640x360 
0x12CB3460, 36963308711146304, 231282093, 231282096, 3, 640x360 
0x12CB3460, 36963308711464912, 231282124, 231282127, 3, 640x360 
0x12CB3460, 36963308711787192, 231282154, 231282157, 3, 640x360 
0x12CB3460, 36963308712106880, 231282193, 231282196, 3, 640x360 
0x12CB3460, 36963308712426432, 231282223, 231282226, 3, 640x360 
0x12CB3460, 36963308712746464, 231282253, 231282255, 2, 640x360 
0x12CB3460, 36963308713065248, 231282283, 231282286, 3, 640x360 
0x12CB3460, 36963308713385808, 231282314, 231282317, 3, 640x360 
0x12CB3460, 36963308713706752, 231282343, 231282369, 26, 640x360 
0x12CB3460, 36963308714028408, 231282383, 231282385, 2, 640x360 
0x12CB3460, 36963308714510184, 231282433, 231282436, 3, 640x360 
0x12CB3460, 36963308714825264, 231282464, 231282467, 3, 640x360 
0x12CB3460, 36963308715148528, 231282493, 231282498, 5, 640x360 
0x12CB3460, 36963308715466584, 231282523, 231282525, 2, 640x360 
0x12CB3460, 36963308715786752, 231282553, 231282556, 3, 640x360 
0x12CB3460, 36963308716107640, 231282593, 231282596, 3, 640x360 
0x12CB3460, 36963308716426640, 231282623, 231282625, 2, 640x360 
0x12CB3460, 36963308716746480, 231282653, 231282656, 3, 640x360 
0x12CB3460, 36963308717069296, 231282684, 231282688, 4, 640x360 
0x12CB3460, 36963308717389968, 231282714, 231282717, 3, 640x360 
0x12CB3460, 36963308717706952, 231282754, 231282756, 2, 640x360 
0x12CB3460, 36963308718029552, 231282784, 231282786, 2, 640x360 
0x12CB3460, 36963308718507472, 231282833, 231282836, 3, 640x360 
0x12CB3460, 36963308718908504, 231282883, 231282887, 4, 640x360 
0x12CB3460, 36963308719145616, 231282893, 231282896, 3, 640x360 
0x12CB3460, 36963308719465544, 231282923, 231282941, 18, 640x360 
0x12CB3460, 36963308719788136, 231282953, 231282956, 3, 640x360 
0x12CB3460, 36963308720107424, 231282984, 231282988, 4, 640x360 
0x12CB3460, 36963308720425864, 231283023, 231283026, 3, 640x360 
0x12CB3460, 36963308720745496, 231283053, 231283056, 3, 640x360 
0x12CB3460, 36963308721065088, 231283083, 231283086, 3, 640x360 
0x12CB3460, 36963308721385904, 231283113, 231283116, 3, 640x360 
0x12CB3460, 36963308721706224, 231283153, 231283156, 3, 640x360 
0x12CB3460, 36963308722028088, 231283184, 231283190, 6, 640x360 
0x12CB3460, 36963308722507032, 231283232, 231283235, 3, 640x360 
0x12CB3460, 36963308722828280, 231283263, 231283266, 3, 640x360 
0x12CB3460, 36963308723148416, 231283294, 231283297, 3, 640x360 
0x12CB3460, 36963308723467448, 231283326, 231283330, 4, 640x360 
0x12CB3460, 36963308723791240, 231283393, 231283399, 6, 640x360 
0x12CB3460, 36963308724231448, 231283404, 231283408, 4, 640x360 
0x12CB3460, 36963308724426248, 231283423, 231283426, 3, 640x360 
0x12CB3460, 36963308724745816, 231283454, 231283458, 4, 640x360 
0x12CB3460, 36963308725067160, 231283483, 231283486, 3, 640x360 
0x12CB3460, 36963308725387696, 231283514, 231283517, 3, 640x360 
0x12CB3460, 36963308725707088, 231283555, 231283558, 3, 640x360 
0x12CB3460, 36963308726186248, 231283593, 231283597, 4, 640x360 
0x12CB3460, 36963308726509672, 231283634, 231283637, 3, 640x360 
0x12CB3460, 36963308726829096, 231283663, 231283667, 4, 640x360 
0x12CB3460, 36963308727151016, 231283695, 231283699, 4, 640x360 
0x12CB3460, 36963308727466296, 231283724, 231283730, 6, 640x360 
0x12CB3460, 36963308727786992, 231283752, 231283755, 3, 640x360 
0x12CB3460, 36963308728107616, 231283792, 231283795, 3, 640x360 
0x12CB3460, 36963308728428592, 231283824, 231283827, 3, 640x360 
0x12CB3460, 36963308729004912, 231283885, 231283896, 11, 640x360 
0x12CB3460, 36963308729386776, 231283914, 231283917, 3, 640x360 
0x12CB3460, 36963308729706616, 231283953, 231283956, 3, 640x360 
0x12CB3460, 36963308730187016, 231283994, 231283997, 3, 640x360 
0x12CB3460, 36963308730506696, 231284024, 231284028, 4, 640x360 
0x12CB3460, 36963308730825784, 231284062, 231284065, 3, 640x360 
0x12CB3460, 36963308731146544, 231284093, 231284096, 3, 640x360 
0x12CB3460, 36963308731466096, 231284122, 231284140, 18, 640x360 
0x12CB3460, 36963308731787800, 231284154, 231284157, 3, 640x360 
0x12CB3460, 36963308732106384, 231284193, 231284196, 3, 640x360 
0x12CB3460, 36963308732425856, 231284222, 231284225, 3, 640x360 
0x12CB3460, 36963308732746016, 231284253, 231284256, 3, 640x360 
0x12CB3460, 36963308733066632, 231284284, 231284287, 3, 640x360 
0x12CB3460, 36963308733387592, 231284313, 231284316, 3, 640x360 
0x12CB3460, 36963308733707736, 231284344, 231284347, 3, 640x360 
0x12CB3460, 36963308734186600, 231284393, 231284396, 3, 640x360 
0x12CB3460, 36963308734507312, 231284424, 231284428, 4, 640x360 
0x12CB3460, 36963308734826640, 231284463, 231284466, 3, 640x360 
0x12CB3460, 36963308735148176, 231284494, 231284497, 3, 640x360 
0x12CB3460, 36963308735467728, 231284524, 231284527, 3, 640x360 
0x12CB3460, 36963308735786384, 231284553, 231284557, 4, 640x360 
0x12CB3460, 36963308736109224, 231284594, 231284597, 3, 640x360 
0x12CB3460, 36963308736427704, 231284625, 231284628, 3, 640x360 
0x12CB3460, 36963308736749872, 231284655, 231284658, 3, 640x360 
0x12CB3460, 36963308737069032, 231284683, 231284687, 4, 640x360 
0x12CB3460, 36963308737387152, 231284714, 231284717, 3, 640x360 
0x12CB3460, 36963308737866728, 231284763, 231284766, 3, 640x360 
0x12CB3460, 36963308738186472, 231284793, 231284796, 3, 640x360 
0x12CB3460, 36963308738505416, 231284833, 231284836, 3, 640x360 
0x12CB3460, 36963308738982984, 231284883, 231284886, 3, 640x360 
0x12CB3460, 36963308739146952, 231284893, 231284895, 2, 640x360 
0x12CB3460, 36963308739467048, 231284923, 231284941, 18, 640x360 
0x12CB3460, 36963308739786128, 231284953, 231284956, 3, 640x360 
0x12CB3460, 36963308740106744, 231284984, 231284987, 3, 640x360 
0x12CB3460, 36963308740426384, 231285023, 231285026, 3, 640x360 
0x12CB3460, 36963308740746136, 231285052, 231285056, 4, 640x360 
0x12CB3460, 36963308741067888, 231285084, 231285087, 3, 640x360 
0x12CB3460, 36963308741386528, 231285113, 231285116, 3, 640x360 
0x12CB3460, 36963308741866768, 231285164, 231285167, 3, 640x360 
0x12CB3460, 36963308742186496, 231285193, 231285196, 3, 640x360 
0x12CB3460, 36963308742506848, 231285232, 231285235, 3, 640x360 
0x12CB3460, 36963308742826232, 231285263, 231285266, 3, 640x360 
0x12CB3460, 36963308743147248, 231285293, 231285296, 3, 640x360 
0x12CB3460, 36963308743466144, 231285323, 231285328, 5, 640x360 
0x12CB3460, 36963308743969432, 231285374, 231285376, 2, 640x360 
0x12CB3460, 36963308744105264, 231285384, 231285388, 4, 640x360 
0x12CB3460, 36963308744425768, 231285423, 231285426, 3, 640x360 
0x12CB3460, 36963308744747160, 231285453, 231285456, 3, 640x360 
0x12CB3460, 36963308745067208, 231285483, 231285485, 2, 640x360 
0x12CB3460, 36963308745546384, 231285533, 231285536, 3, 640x360 
0x12CB3460, 36963308745866528, 231285563, 231285565, 2, 640x360 
0x12CB3460, 36963308746187040, 231285594, 231285597, 3, 640x360 
0x12CB3460, 36963308746508496, 231285632, 231285635, 3, 640x360 
0x12CB3460, 36963308746826784, 231285665, 231285668, 3, 640x360 
0x12CB3460, 36963308747146176, 231285693, 231285696, 3, 640x360 
0x12CB3460, 36963308747467248, 231285723, 231285726, 3, 640x360 
0x12CB3460, 36963308747786712, 231285753, 231285756, 3, 640x360 
0x12CB3460, 36963308748107144, 231285792, 231285796, 4, 640x360 
0x12CB3460, 36963308748426680, 231285823, 231285826, 3, 640x360 
0x12CB3460, 36963308748972416, 231285873, 231285877, 4, 640x360 
0x12CB3460, 36963308749067248, 231285884, 231285889, 5, 640x360 
0x12CB3460, 36963308749546864, 231285933, 231285936, 3, 640x360 
0x12CB3460, 36963308749867040, 231285963, 231285966, 3, 640x360 
0x12CB3460, 36963308750187208, 231285994, 231285997, 3, 640x360 
0x12CB3460, 36963308750511880, 231286032, 231286035, 3, 640x360 
0x12CB3460, 36963308750827024, 231286064, 231286066, 2, 640x360 
0x12CB3460, 36963308751145376, 231286093, 231286097, 4, 640x360 
0x12CB3460, 36963308751467000, 231286124, 231286127, 3, 640x360 
0x12CB3460, 36963308751785008, 231286154, 231286157, 3, 640x360 
0x12CB3460, 36963308752106776, 231286194, 231286199, 5, 640x360 
0x12CB3460, 36963308752425832, 231286224, 231286231, 7, 640x360 
0x12CB3460, 36963308752747024, 231286253, 231286256, 3, 640x360 
0x12CB3460, 36963308753069440, 231286284, 231286287, 3, 640x360 
0x12CB3460, 36963308753547712, 231286333, 231286336, 3, 640x360 
0x12CB3460, 36963308753866576, 231286380, 231286383, 3, 640x360 
0x12CB3460, 36963308754185264, 231286394, 231286413, 19, 640x360 
0x12CB3460, 36963308754507936, 231286433, 231286436, 3, 640x360 
0x12CB3460, 36963308754825728, 231286463, 231286466, 3, 640x360 
0x12CB3460, 36963308755146216, 231286492, 231286496, 4, 640x360 
0x12CB3460, 36963308755468616, 231286524, 231286527, 3, 640x360 
0x12CB3460, 36963308755787016, 231286553, 231286555, 2, 640x360 
0x12CB3460, 36963308756105696, 231286584, 231286587, 3, 640x360 
0x12CB3460, 36963308756426728, 231286624, 231286627, 3, 640x360 
0x12CB3460, 36963308756750040, 231286653, 231286656, 3, 640x360 
0x12CB3460, 36963308757226536, 231286704, 231286706, 2, 640x360 
0x12CB3460, 36963308757544792, 231286733, 231286747, 14, 640x360 
0x12CB3460, 36963308757867008, 231286763, 231286766, 3, 640x360 
0x12CB3460, 36963308758186048, 231286793, 231286797, 4, 640x360 
0x12CB3460, 36963308758508600, 231286834, 231286837, 3, 640x360 
0x12CB3460, 36963308758877824, 231286875, 231286878, 3, 640x360 
0x12CB3460, 36963308759146296, 231286893, 231286897, 4, 640x360 
0x12CB3460, 36963308759465328, 231286923, 231286925, 2, 640x360 
0x12CB3460, 36963308759785800, 231286954, 231286956, 2, 640x360 
0x12CB3460, 36963308760107344, 231286994, 231286997, 3, 640x360 
0x12CB3460, 36963308760428752, 231287023, 231287027, 4, 640x360 
0x12CB3460, 36963308760747384, 231287053, 231287056, 3, 640x360 
0x12CB3460, 36963308761224856, 231287105, 231287119, 14, 640x360 
0x12CB3460, 36963308761547520, 231287134, 231287136, 2, 640x360 
0x12CB3460, 36963308761866184, 231287164, 231287167, 3, 640x360 
0x12CB3460, 36963308762190488, 231287194, 231287216, 22, 640x360 
0x12CB3460, 36963308762506848, 231287227, 231287246, 19, 640x360 
0x12CB3460, 36963308762826176, 231287263, 231287282, 19, 640x360 
0x12CB3460, 36963308763149736, 231287294, 231287307, 13, 640x360 
0x12CB3460, 36963308763465184, 231287324, 231287343, 19, 640x360 
0x12CB3460, 36963308763786224, 231287361, 231287372, 11, 640x360 
0x12CB3460, 36963308764105488, 231287384, 231287387, 3, 640x360 
0x12CB3460, 36963308764427040, 231287425, 231287451, 26, 640x360 
0x12CB3460, 36963308764750664, 231287456, 231287483, 27, 640x360 
0x12CB3460, 36963308765225088, 231287503, 231287520, 17, 640x360 
0x12CB3460, 36963308765545496, 231287533, 231287535, 2, 640x360 
0x12CB3460, 36963308765866216, 231287563, 231287567, 4, 640x360 
0x12CB3460, 36963308766186096, 231287593, 231287596, 3, 640x360 
0x12CB3460, 36963308766504912, 231287624, 231287628, 4, 640x360 
0x12CB3460, 36963308766826504, 231287663, 231287667, 4, 640x360 
0x12CB3460, 36963308767144824, 231287692, 231287695, 3, 640x360 
0x12CB3460, 36963308767465352, 231287724, 231287726, 2, 640x360 
0x12CB3460, 36963308767786232, 231287753, 231287756, 3, 640x360 
0x12CB3460, 36963308768106912, 231287784, 231287788, 4, 640x360 
0x12CB3460, 36963308768425888, 231287824, 231287827, 3, 640x360 
0x12CB3460, 36963308768907640, 231287876, 231287880, 4, 640x360 
0x12CB3460, 36963308769224488, 231287903, 231287906, 3, 640x360 
0x12CB3460, 36963308769547392, 231287933, 231287936, 3, 640x360 
0x12CB3460, 36963308769867280, 231287963, 231287966, 3, 640x360 
0x12CB3460, 36963308770186184, 231287997, 231288001, 4, 640x360 
0x12CB3460, 36963308770505160, 231288025, 231288030, 5, 640x360 
0x12CB3460, 36963308770825656, 231288063, 231288066, 3, 640x360 
0x12CB3460, 36963308771145936, 231288093, 231288096, 3, 640x360 
0x12CB3460, 36963308771465584, 231288123, 231288141, 18, 640x360 
0x12CB3460, 36963308771786208, 231288155, 231288158, 3, 640x360 
0x12CB3460, 36963308772106696, 231288193, 231288196, 3, 640x360 
0x12CB3460, 36963308772426400, 231288224, 231288227, 3, 640x360 
0x12CB3460, 36963308772906616, 231288264, 231288268, 4, 640x360 
0x12CB3460, 36963308773226208, 231288303, 231288306, 3, 640x360 
0x12CB3460, 36963308773546944, 231288333, 231288335, 2, 640x360 
0x12CB3460, 36963308773868536, 231288374, 231288377, 3, 640x360 
0x12CB3460, 36963308774186176, 231288393, 231288396, 3, 640x360 
0x12CB3460, 36963308774511272, 231288432, 231288435, 3, 640x360 
0x12CB3460, 36963308774827120, 231288463, 231288466, 3, 640x360 
0x12CB3460, 36963308775147752, 231288493, 231288496, 3, 640x360 
0x12CB3460, 36963308775465568, 231288523, 231288527, 4, 640x360 
0x12CB3460, 36963308775786072, 231288553, 231288556, 3, 640x360 
0x12CB3460, 36963308776106696, 231288584, 231288588, 4, 640x360 
0x12CB3460, 36963308776587664, 231288633, 231288637, 4, 640x360 
0x12CB3460, 36963308776906776, 231288667, 231288671, 4, 640x360 
0x12CB3460, 36963308777225624, 231288703, 231288721, 18, 640x360 
0x12CB3460, 36963308777546296, 231288733, 231288736, 3, 640x360 
0x12CB3460, 36963308777866976, 231288763, 231288766, 3, 640x360 
0x12CB3460, 36963308778185536, 231288794, 231288797, 3, 640x360 
0x12CB3460, 36963308778506952, 231288824, 231288828, 4, 640x360 
0x12CB3460, 36963308778826432, 231288875, 231288878, 3, 640x360 
0x12CB3460, 36963308779144984, 231288893, 231288895, 2, 640x360 
0x12CB3460, 36963308779465728, 231288923, 231288926, 3, 640x360 
0x12CB3460, 36963308779785552, 231288953, 231288956, 3, 640x360 
0x12CB3460, 36963308780106232, 231288983, 231288987, 4, 640x360 
0x12CB3460, 36963308780587472, 231289033, 231289037, 4, 640x360 
0x12CB3460, 36963308780905968, 231289063, 231289067, 4, 640x360 
0x12CB3460, 36963308781224816, 231289104, 231289106, 2, 640x360 
0x12CB3460, 36963308781547056, 231289132, 231289135, 3, 640x360 
0x12CB3460, 36963308781868144, 231289164, 231289167, 3, 640x360 
0x12CB3460, 36963308782186656, 231289193, 231289196, 3, 640x360 
0x12CB3460, 36963308782507848, 231289224, 231289228, 4, 640x360 
0x12CB3460, 36963308782826232, 231289263, 231289266, 3, 640x360 
0x12CB3460, 36963308783146976, 231289293, 231289296, 3, 640x360 
0x12CB3460, 36963308783466680, 231289324, 231289327, 3, 640x360 
0x12CB3460, 36963308783788416, 231289388, 231289391, 3, 640x360 
0x12CB3460, 36963308784587104, 231289433, 231289436, 3, 640x360 
0x12CB3460, 36963308784907280, 231289474, 231289478, 4, 640x360 
0x12CB3460, 36963308785228144, 231289504, 231289506, 2, 640x360 
0x12CB3460, 36963308785548544, 231289533, 231289536, 3, 640x360 
0x12CB3460, 36963308785866960, 231289563, 231289566, 3, 640x360 
0x12CB3460, 36963308786185920, 231289593, 231289596, 3, 640x360 
0x12CB3460, 36963308786506800, 231289634, 231289637, 3, 640x360 
0x12CB3460, 36963308786827584, 231289665, 231289668, 3, 640x360 
0x12CB3460, 36963308787151872, 231289694, 231289698, 4, 640x360 
0x12CB3460, 36963308787468872, 231289725, 231289728, 3, 640x360 
0x12CB3460, 36963308787786000, 231289753, 231289756, 3, 640x360 
0x12CB3460, 36963308788266136, 231289805, 231289820, 15, 640x360 
0x12CB3460, 36963308788586056, 231289833, 231289836, 3, 640x360 
0x12CB3460, 36963308788905456, 231289868, 231289872, 4, 640x360 
0x12CB3460, 36963308789226792, 231289903, 231289906, 3, 640x360 
0x12CB3460, 36963308789547336, 231289933, 231289936, 3, 640x360 
0x12CB3460, 36963308789895344, 231289976, 231289985, 9, 640x360 
0x12CB3460, 36963308790186264, 231289996, 231290004, 8, 640x360 
0x12CB3460, 36963308790506816, 231290034, 231290053, 19, 640x360 
0x12CB3460, 36963308790826560, 231290064, 231290067, 3, 640x360 
0x12CB3460, 36963308791146832, 231290093, 231290099, 6, 640x360 
0x12CB3460, 36963308791465168, 231290124, 231290127, 3, 640x360 
0x12CB3460, 36963308791790576, 231290153, 231290156, 3, 640x360 
0x12CB3460, 36963308792268760, 231290203, 231290206, 3, 640x360 
0x12CB3460, 36963308792585240, 231290233, 231290236, 3, 640x360 
0x12CB3460, 36963308792907480, 231290274, 231290276, 2, 640x360 
0x12CB3460, 36963308793226352, 231290303, 231290307, 4, 640x360 
0x12CB3460, 36963308793546640, 231290333, 231290336, 3, 640x360 
0x12CB3460, 36963308794018264, 231290383, 231290386, 3, 640x360 
0x12CB3460, 36963308794184720, 231290393, 231290396, 3, 640x360 
0x12CB3460, 36963308794505632, 231290434, 231290436, 2, 640x360 
0x12CB3460, 36963308794825272, 231290463, 231290466, 3, 640x360 
0x12CB3460, 36963308795147072, 231290493, 231290496, 3, 640x360 
0x12CB3460, 36963308795468264, 231290523, 231290526, 3, 640x360 
0x12CB3460, 36963308795785872, 231290554, 231290557, 3, 640x360 
0x12CB3460, 36963308796266832, 231290603, 231290606, 3, 640x360 
0x12CB3460, 36963308796585784, 231290634, 231290637, 3, 640x360 
0x12CB3460, 36963308796906200, 231290673, 231290676, 3, 640x360 
0x12CB3460, 36963308797225416, 231290703, 231290706, 3, 640x360 
0x12CB3460, 36963308797545528, 231290732, 231290735, 3, 640x360 
0x12CB3460, 36963308797866936, 231290763, 231290773, 10, 640x360 
0x12CB3460, 36963308798187568, 231290794, 231290796, 2, 640x360 
0x12CB3460, 36963308798505904, 231290833, 231290836, 3, 640x360 
0x12CB3460, 36963308799065048, 231290883, 231290887, 4, 640x360 
0x12CB3460, 36963308799465432, 231290923, 231290926, 3, 640x360 
0x12CB3460, 36963308799946712, 231290973, 231290976, 3, 640x360 
0x12CB3460, 36963308800267536, 231291004, 231291007, 3, 640x360 
0x12CB3460, 36963308800586552, 231291034, 231291037, 3, 640x360 
0x12CB3460, 36963308800905616, 231291064, 231291068, 4, 640x360 
0x12CB3460, 36963308801225688, 231291103, 231291106, 3, 640x360 
0x12CB3460, 36963308801546192, 231291133, 231291136, 3, 640x360 
0x12CB3460, 36963308801866240, 231291163, 231291166, 3, 640x360 
0x12CB3460, 36963308802184728, 231291195, 231291199, 4, 640x360 
0x12CB3460, 36963308802505448, 231291233, 231291236, 3, 640x360 
0x12CB3460, 36963308802826824, 231291263, 231291266, 3, 640x360 
0x12CB3460, 36963308803147264, 231291295, 231291298, 3, 640x360 
0x12CB3460, 36963308803467024, 231291323, 231291326, 3, 640x360 
0x12CB3460, 36963308804047784, 231291384, 231291390, 6, 640x360 
0x12CB3460, 36963308804265712, 231291403, 231291406, 3, 640x360 
0x12CB3460, 36963308804586696, 231291433, 231291436, 3, 640x360 
0x12CB3460, 36963308804907264, 231291473, 231291476, 3, 640x360 
0x12CB3460, 36963308805229016, 231291503, 231291506, 3, 640x360 
0x12CB3460, 36963308805546056, 231291533, 231291536, 3, 640x360 
0x12CB3460, 36963308805866288, 231291563, 231291565, 2, 640x360 
0x12CB3460, 36963308806186680, 231291593, 231291596, 3, 640x360 
0x12CB3460, 36963308806507544, 231291634, 231291637, 3, 640x360 
0x12CB3460, 36963308806828152, 231291664, 231291668, 4, 640x360 
0x12CB3460, 36963308807147016, 231291693, 231291700, 7, 640x360 
0x12CB3460, 36963308807465760, 231291723, 231291726, 3, 640x360 
0x12CB3460, 36963308807946264, 231291773, 231291777, 4, 640x360 
0x12CB3460, 36963308808266536, 231291804, 231291806, 2, 640x360 
0x12CB3460, 36963308808585160, 231291834, 231291837, 3, 640x360 
0x12CB3460, 36963308808972208, 231291873, 231291876, 3, 640x360 
0x12CB3460, 36963308809224704, 231291903, 231291906, 3, 640x360 
0x12CB3460, 36963308809545496, 231291933, 231291936, 3, 640x360 
0x12CB3460, 36963308809866920, 231291963, 231291966, 3, 640x360 
0x12CB3460, 36963308810186168, 231291994, 231291997, 3, 640x360 
0x12CB3460, 36963308810506632, 231292033, 231292036, 3, 640x360 
0x12CB3460, 36963308810826376, 231292063, 231292065, 2, 640x360 
0x12CB3460, 36963308811145304, 231292093, 231292096, 3, 640x360 
0x12CB3460, 36963308811625960, 231292143, 231292146, 3, 640x360 
0x12CB3460, 36963308811944792, 231292173, 231292181, 8, 640x360 
0x12CB3460, 36963308812265088, 231292202, 231292205, 3, 640x360 
0x12CB3460, 36963308812585808, 231292233, 231292236, 3, 640x360 
0x12CB3460, 36963308812906208, 231292273, 231292276, 3, 640x360 
0x12CB3460, 36963308813225872, 231292303, 231292306, 3, 640x360 
0x12CB3460, 36963308813546144, 231292333, 231292336, 3, 640x360 
0x12CB3460, 36963308814085448, 231292393, 231292398, 5, 640x360 
0x12CB3460, 36963308814506712, 231292424, 231292428, 4, 640x360 
0x12CB3460, 36963308814825072, 231292464, 231292466, 2, 640x360 
0x12CB3460, 36963308815148248, 231292493, 231292496, 3, 640x360 
0x12CB3460, 36963308815625128, 231292543, 231292546, 3, 640x360 
0x12CB3460, 36963308815947496, 231292574, 231292577, 3, 640x360 
0x12CB3460, 36963308816266576, 231292603, 231292606, 3, 640x360 
0x12CB3460, 36963308816585968, 231292633, 231292637, 4, 640x360 
0x12CB3460, 36963308816906672, 231292673, 231292677, 4, 640x360 
0x12CB3460, 36963308817227912, 231292705, 231292710, 5, 640x360 
0x12CB3460, 36963308817548568, 231292733, 231292736, 3, 640x360 
0x12CB3460, 36963308817865576, 231292763, 231292765, 2, 640x360 
0x12CB3460, 36963308818184800, 231292794, 231292797, 3, 640x360 
0x12CB3460, 36963308818505704, 231292834, 231292877, 43, 640x360 
0x12CB3460, 36963308819052672, 231292884, 231292887, 3, 640x360 
0x12CB3460, 36963308819304184, 231292913, 231292916, 3, 640x360 
0x12CB3460, 36963308819624760, 231292943, 231292946, 3, 640x360 
0x12CB3460, 36963308819944688, 231292974, 231292977, 3, 640x360 
0x12CB3460, 36963308820266640, 231293003, 231293007, 4, 640x360 
0x12CB3460, 36963308820586256, 231293034, 231293036, 2, 640x360 
0x12CB3460, 36963308820906160, 231293073, 231293077, 4, 640x360 
0x12CB3460, 36963308821225008, 231293103, 231293105, 2, 640x360 
0x12CB3460, 36963308821545864, 231293134, 231293136, 2, 640x360 
0x12CB3460, 36963308821866064, 231293163, 231293166, 3, 640x360 
0x12CB3460, 36963308822186720, 231293194, 231293197, 3, 640x360 
0x12CB3460, 36963308822506928, 231293224, 231293227, 3, 640x360 
0x12CB3460, 36963308822826448, 231293263, 231293265, 2, 640x360 
0x12CB3460, 36963308823306712, 231293314, 231293316, 2, 640x360 
0x12CB3460, 36963308823626160, 231293344, 231293361, 17, 640x360 
0x12CB3460, 36963308824028416, 231293384, 231293387, 3, 640x360 
0x12CB3460, 36963308824265960, 231293403, 231293406, 3, 640x360 
0x12CB3460, 36963308824584832, 231293432, 231293435, 3, 640x360 
0x12CB3460, 36963308824907160, 231293464, 231293468, 4, 640x360 
0x12CB3460, 36963308825224656, 231293505, 231293509, 4, 640x360 
0x12CB3460, 36963308825546656, 231293533, 231293538, 5, 640x360 
0x12CB3460, 36963308825864776, 231293564, 231293567, 3, 640x360 
0x12CB3460, 36963308826185280, 231293593, 231293596, 3, 640x360 
0x12CB3460, 36963308826504968, 231293625, 231293631, 6, 640x360 
0x12CB3460, 36963308826826360, 231293663, 231293666, 3, 640x360 
0x12CB3460, 36963308827306808, 231293704, 231293707, 3, 640x360 
0x12CB3460, 36963308827624440, 231293743, 231293746, 3, 640x360 
0x12CB3460, 36963308827946520, 231293773, 231293777, 4, 640x360 
0x12CB3460, 36963308828266168, 231293804, 231293806, 2, 640x360 
0x12CB3460, 36963308828586384, 231293834, 231293837, 3, 640x360 
0x12CB3460, 36963308828905816, 231293880, 231293884, 4, 640x360 
0x12CB3460, 36963308829228080, 231293898, 231293914, 16, 640x360 
0x12CB3460, 36963308829546968, 231293933, 231293948, 15, 640x360 
0x12CB3460, 36963308829865408, 231293964, 231293979, 15, 640x360 
0x12CB3460, 36963308830185936, 231293993, 231294002, 9, 640x360 
0x12CB3460, 36963308830509048, 231294025, 231294039, 14, 640x360 
0x12CB3460, 36963308830985800, 231294073, 231294076, 3, 640x360 
0x12CB3460, 36963308831305992, 231294114, 231294116, 2, 640x360 
0x12CB3460, 36963308831628616, 231294144, 231294160, 16, 640x360 
0x12CB3460, 36963308831946952, 231294173, 231294180, 7, 640x360 
0x12CB3460, 36963308832266088, 231294204, 231294215, 11, 640x360 
0x12CB3460, 36963308832584912, 231294233, 231294236, 3, 640x360 
0x12CB3460, 36963308832906152, 231294264, 231294267, 3, 640x360 
0x12CB3460, 36963308833224864, 231294304, 231294306, 2, 640x360 
0x12CB3460, 36963308833545264, 231294333, 231294336, 3, 640x360 
0x12CB3460, 36963308833867952, 231294376, 231294379, 3, 640x360 
0x12CB3460, 36963308834185976, 231294393, 231294396, 3, 640x360 
0x12CB3460, 36963308834506000, 231294433, 231294435, 2, 640x360 
0x12CB3460, 36963308834984584, 231294474, 231294476, 2, 640x360 
0x12CB3460, 36963308835308096, 231294514, 231294517, 3, 640x360 
0x12CB3460, 36963308835627384, 231294543, 231294551, 8, 640x360 
0x12CB3460, 36963308835947632, 231294573, 231294576, 3, 640x360 
0x12CB3460, 36963308836268448, 231294603, 231294607, 4, 640x360 
0x12CB3460, 36963308836587064, 231294634, 231294636, 2, 640x360 
0x12CB3460, 36963308836905424, 231294664, 231294667, 3, 640x360 
0x12CB3460, 36963308837225088, 231294704, 231294707, 3, 640x360 
0x12CB3460, 36963308837548656, 231294733, 231294735, 2, 640x360 
0x12CB3460, 36963308837864912, 231294763, 231294766, 3, 640x360 
0x12CB3460, 36963308838186448, 231294794, 231294797, 3, 640x360 
0x12CB3460, 36963308838508232, 231294833, 231294836, 3, 640x360 
0x12CB3460, 36963308838986368, 231294882, 231294885, 3, 640x360 
0x12CB3460, 36963308839305176, 231294914, 231294916, 2, 640x360 
0x12CB3460, 36963308839624488, 231294943, 231294946, 3, 640x360 
0x12CB3460, 36963308839946416, 231294974, 231294977, 3, 640x360 
0x12CB3460, 36963308840266784, 231295004, 231295007, 3, 640x360 
0x12CB3460, 36963308840586136, 231295033, 231295037, 4, 640x360 
0x12CB3460, 36963308840905440, 231295063, 231295068, 5, 640x360 
0x12CB3460, 36963308841225720, 231295103, 231295106, 3, 640x360 
0x12CB3460, 36963308841546968, 231295133, 231295135, 2, 640x360 
0x12CB3460, 36963308841864832, 231295163, 231295170, 7, 640x360 
0x12CB3460, 36963308842184952, 231295193, 231295196, 3, 640x360 
0x12CB3460, 36963308842663976, 231295243, 231295246, 3, 640x360 
0x12CB3460, 36963308842986648, 231295272, 231295276, 4, 640x360 
0x12CB3460, 36963308843306328, 231295313, 231295316, 3, 640x360 
0x12CB3460, 36963308843625808, 231295344, 231295363, 19, 640x360 
0x12CB3460, 36963308843946424, 231295376, 231295379, 3, 640x360 
0x12CB3460, 36963308844270968, 231295403, 231295406, 3, 640x360 
0x12CB3460, 36963308844585656, 231295434, 231295436, 2, 640x360 
0x12CB3460, 36963308844904968, 231295464, 231295468, 4, 640x360 
0x12CB3460, 36963308845226664, 231295503, 231295506, 3, 640x360 
0x12CB3460, 36963308845546368, 231295533, 231295540, 7, 640x360 
0x12CB3460, 36963308845865296, 231295563, 231295565, 2, 640x360 
0x12CB3460, 36963308846187568, 231295594, 231295597, 3, 640x360 
0x12CB3460, 36963308846668200, 231295644, 231295648, 4, 640x360 
0x12CB3460, 36963308846986672, 231295674, 231295678, 4, 640x360 
0x12CB3460, 36963308847306616, 231295713, 231295715, 2, 640x360 
0x12CB3460, 36963308847629552, 231295743, 231295746, 3, 640x360 
0x12CB3460, 36963308847944864, 231295773, 231295776, 3, 640x360 
0x12CB3460, 36963308848266536, 231295804, 231295807, 3, 640x360 
0x12CB3460, 36963308848586728, 231295833, 231295836, 3, 640x360 
0x12CB3460, 36963308848906848, 231295880, 231295882, 2, 640x360 
0x12CB3460, 36963308849226744, 231295897, 231295900, 3, 640x360 
0x12CB3460, 36963308849545712, 231295933, 231295936, 3, 640x360 
0x12CB3460, 36963308849865936, 231295963, 231295965, 2, 640x360 
0x12CB3460, 36963308850185888, 231295994, 231295997, 3, 640x360 
0x12CB3460, 36963308850664320, 231296043, 231296046, 3, 640x360 
0x12CB3460, 36963308850986864, 231296074, 231296077, 3, 640x360 
0x12CB3460, 36963308851305040, 231296103, 231296108, 5, 640x360 
0x12CB3460, 36963308851624576, 231296143, 231296146, 3, 640x360 
0x12CB3460, 36963308851946480, 231296174, 231296176, 2, 640x360 
0x12CB3460, 36963308852267664, 231296204, 231296209, 5, 640x360 
0x12CB3460, 36963308852585240, 231296234, 231296236, 2, 640x360 
0x12CB3460, 36963308852905312, 231296263, 231296266, 3, 640x360 
0x12CB3460, 36963308853225168, 231296304, 231296307, 3, 640x360 
0x12CB3460, 36963308853547432, 231296335, 231296338, 3, 640x360 
0x12CB3460, 36963308853867776, 231296363, 231296367, 4, 640x360 
0x12CB3460, 36963308854345400, 231296413, 231296416, 3, 640x360 
0x12CB3460, 36963308854665848, 231296443, 231296446, 3, 640x360 
0x12CB3460, 36963308854984712, 231296473, 231296477, 4, 640x360 
0x12CB3460, 36963308855305040, 231296504, 231296508, 4, 640x360 
0x12CB3460, 36963308855626368, 231296543, 231296546, 3, 640x360 
0x12CB3460, 36963308855946920, 231296573, 231296576, 3, 640x360 
0x12CB3460, 36963308856267880, 231296603, 231296606, 3, 640x360 
0x12CB3460, 36963308856587360, 231296633, 231296637, 4, 640x360 
0x12CB3460, 36963308856907480, 231296664, 231296668, 4, 640x360 
0x12CB3460, 36963308857225064, 231296703, 231296706, 3, 640x360 
0x12CB3460, 36963308857545432, 231296733, 231296735, 2, 640x360 
0x12CB3460, 36963308857866296, 231296763, 231296766, 3, 640x360 
0x12CB3460, 36963308858345784, 231296813, 231296815, 2, 640x360 
0x12CB3460, 36963308858666008, 231296843, 231296851, 8, 640x360 
0x12CB3460, 36963308858985280, 231296878, 231296881, 3, 640x360 
0x12CB3460, 36963308859306224, 231296904, 231296908, 4, 640x360 
0x12CB3460, 36963308859627696, 231296943, 231296946, 3, 640x360 
0x12CB3460, 36963308859944688, 231296973, 231296976, 3, 640x360 
0x12CB3460, 36963308860265776, 231297004, 231297006, 2, 640x360 
0x12CB3460, 36963308860586632, 231297033, 231297036, 3, 640x360 
0x12CB3460, 36963308860906408, 231297064, 231297067, 3, 640x360 
0x12CB3460, 36963308861224408, 231297104, 231297114, 10, 640x360 
0x12CB3460, 36963308861545944, 231297133, 231297136, 3, 640x360 
0x12CB3460, 36963308862025840, 231297183, 231297186, 3, 640x360 
0x12CB3460, 36963308862346656, 231297213, 231297217, 4, 640x360 
0x12CB3460, 36963308862665688, 231297243, 231297246, 3, 640x360 
0x12CB3460, 36963308862984368, 231297273, 231297281, 8, 640x360 
0x12CB3460, 36963308863306312, 231297304, 231297308, 4, 640x360 
0x12CB3460, 36963308863626872, 231297343, 231297348, 5, 640x360 
0x12CB3460, 36963308863946056, 231297384, 231297387, 3, 640x360 
0x12CB3460, 36963308864269288, 231297403, 231297406, 3, 640x360 
0x12CB3460, 36963308864584752, 231297433, 231297436, 3, 640x360 
0x12CB3460, 36963308864906544, 231297474, 231297480, 6, 640x360 
0x12CB3460, 36963308865225880, 231297504, 231297507, 3, 640x360 
0x12CB3460, 36963308865553360, 231297534, 231297537, 3, 640x360 
0x12CB3460, 36963308866026672, 231297583, 231297585, 2, 640x360 
0x12CB3460, 36963308866346024, 231297613, 231297616, 3, 640x360 
0x12CB3460, 36963308866666328, 231297643, 231297646, 3, 640x360 
0x12CB3460, 36963308866987056, 231297674, 231297677, 3, 640x360 
0x12CB3460, 36963308867307920, 231297705, 231297709, 4, 640x360 
0x12CB3460, 36963308867625536, 231297743, 231297746, 3, 640x360 
0x12CB3460, 36963308867945032, 231297773, 231297776, 3, 640x360 
0x12CB3460, 36963308868266376, 231297804, 231297807, 3, 640x360 
0x12CB3460, 36963308868586288, 231297834, 231297837, 3, 640x360 
0x12CB3460, 36963308868907160, 231297877, 231297890, 13, 640x360 
0x12CB3460, 36963308869226216, 231297903, 231297906, 3, 640x360 
0x12CB3460, 36963308869545336, 231297933, 231297936, 3, 640x360 
0x12CB3460, 36963308870027792, 231297983, 231297986, 3, 640x360 
0x12CB3460, 36963308870345648, 231298013, 231298016, 3, 640x360 
0x12CB3460, 36963308870667080, 231298044, 231298047, 3, 640x360 
0x12CB3460, 36963308870985536, 231298072, 231298076, 4, 640x360 
0x12CB3460, 36963308871305528, 231298103, 231298108, 5, 640x360 
0x12CB3460, 36963308871626264, 231298143, 231298146, 3, 640x360 
0x12CB3460, 36963308871944856, 231298174, 231298191, 17, 640x360 
0x12CB3460, 36963308872266368, 231298203, 231298206, 3, 640x360 
0x12CB3460, 36963308872585448, 231298233, 231298236, 3, 640x360 
0x12CB3460, 36963308872905976, 231298263, 231298267, 4, 640x360 
0x12CB3460, 36963308873225880, 231298304, 231298307, 3, 640x360 
0x12CB3460, 36963308873705688, 231298344, 231298348, 4, 640x360 
0x12CB3460, 36963308874026232, 231298376, 231298380, 4, 640x360 
0x12CB3460, 36963308874346016, 231298413, 231298415, 2, 640x360 
0x12CB3460, 36963308874664704, 231298443, 231298446, 3, 640x360 
0x12CB3460, 36963308874985256, 231298473, 231298476, 3, 640x360 
0x12CB3460, 36963308875307280, 231298513, 231298516, 3, 640x360 
0x12CB3460, 36963308875629336, 231298544, 231298551, 7, 640x360 
0x12CB3460, 36963308875944712, 231298573, 231298576, 3, 640x360 
0x12CB3460, 36963308876265384, 231298604, 231298606, 2, 640x360 
0x12CB3460, 36963308876588080, 231298635, 231298638, 3, 640x360 
0x12CB3460, 36963308876905600, 231298665, 231298669, 4, 640x360 
0x12CB3460, 36963308877224776, 231298703, 231298705, 2, 640x360 
0x12CB3460, 36963308877705856, 231298744, 231298748, 4, 640x360 
0x12CB3460, 36963308878025144, 231298783, 231298786, 3, 640x360 
0x12CB3460, 36963308878345728, 231298813, 231298815, 2, 640x360 
0x12CB3460, 36963308878664952, 231298843, 231298862, 19, 640x360 
0x12CB3460, 36963308878985968, 231298876, 231298879, 3, 640x360 
0x12CB3460, 36963308879307144, 231298903, 231298907, 4, 640x360 
0x12CB3460, 36963308879624904, 231298944, 231298947, 3, 640x360 
0x12CB3460, 36963308879944512, 231298973, 231298976, 3, 640x360 
0x12CB3460, 36963308880265416, 231299003, 231299006, 3, 640x360 
0x12CB3460, 36963308880585384, 231299033, 231299036, 3, 640x360 
0x12CB3460, 36963308880904984, 231299065, 231299068, 3, 640x360 
0x12CB3460, 36963308881226048, 231299103, 231299106, 3, 640x360 
0x12CB3460, 36963308881705224, 231299144, 231299147, 3, 640x360 
0x12CB3460, 36963308882024192, 231299183, 231299186, 3, 640x360 
0x12CB3460, 36963308882345024, 231299212, 231299215, 3, 640x360 
0x12CB3460, 36963308882666112, 231299243, 231299246, 3, 640x360 
0x12CB3460, 36963308882986640, 231299272, 231299275, 3, 640x360 
0x12CB3460, 36963308883304768, 231299304, 231299307, 3, 640x360 
0x12CB3460, 36963308883626136, 231299343, 231299346, 3, 640x360 
0x12CB3460, 36963308883945664, 231299379, 231299383, 4, 640x360 
0x12CB3460, 36963308884266648, 231299404, 231299409, 5, 640x360 
0x12CB3460, 36963308884584984, 231299433, 231299436, 3, 640x360 
0x12CB3460, 36963308884906784, 231299473, 231299476, 3, 640x360 
0x12CB3460, 36963308885387904, 231299514, 231299517, 3, 640x360 
0x12CB3460, 36963308885707848, 231299553, 231299556, 3, 640x360 
0x12CB3460, 36963308886025904, 231299583, 231299586, 3, 640x360 
0x12CB3460, 36963308886345096, 231299614, 231299617, 3, 640x360 
0x12CB3460, 36963308886666640, 231299644, 231299648, 4, 640x360 
0x12CB3460, 36963308886986672, 231299673, 231299677, 4, 640x360 
0x12CB3460, 36963308887307160, 231299714, 231299724, 10, 640x360 
0x12CB3460, 36963308887623904, 231299743, 231299746, 3, 640x360 
0x12CB3460, 36963308887945344, 231299773, 231299776, 3, 640x360 
0x12CB3460, 36963308888267096, 231299803, 231299806, 3, 640x360 
0x12CB3460, 36963308888585176, 231299832, 231299837, 5, 640x360 
0x12CB3460, 36963308888905240, 231299885, 231299890, 5, 640x360 
0x12CB3460, 36963308889384384, 231299914, 231299917, 3, 640x360 
0x12CB3460, 36963308889705976, 231299953, 231299956, 3, 640x360 
0x12CB3460, 36963308890024248, 231299983, 231299987, 4, 640x360 
0x12CB3460, 36963308890345176, 231300014, 231300022, 8, 640x360 
0x12CB3460, 36963308890664544, 231300043, 231300054, 11, 640x360 
0x12CB3460, 36963308890990104, 231300074, 231300080, 6, 640x360 
0x12CB3460, 36963308891304248, 231300103, 231300107, 4, 640x360 
0x12CB3460, 36963308891624016, 231300143, 231300147, 4, 640x360 
0x12CB3460, 36963308891945688, 231300172, 231300175, 3, 640x360 
0x12CB3460, 36963308892269552, 231300204, 231300208, 4, 640x360 
0x12CB3460, 36963308892584936, 231300233, 231300236, 3, 640x360 
0x12CB3460, 36963308893063848, 231300283, 231300286, 3, 640x360 
0x12CB3460, 36963308893385504, 231300313, 231300316, 3, 640x360 
0x12CB3460, 36963308893705888, 231300344, 231300350, 6, 640x360 
0x12CB3460, 36963308894024536, 231300383, 231300389, 6, 640x360 
0x12CB3460, 36963308894345328, 231300413, 231300416, 3, 640x360 
0x12CB3460, 36963308894665736, 231300443, 231300446, 3, 640x360 
0x12CB3460, 36963308894986280, 231300474, 231300477, 3, 640x360 
0x12CB3460, 36963308895306048, 231300513, 231300516, 3, 640x360 
0x12CB3460, 36963308895624696, 231300544, 231300550, 6, 640x360 
0x12CB3460, 36963308895945416, 231300573, 231300591, 18, 640x360 
0x12CB3460, 36963308896265496, 231300603, 231300606, 3, 640x360 
0x12CB3460, 36963308896585480, 231300633, 231300636, 3, 640x360 
0x12CB3460, 36963308897066592, 231300684, 231300687, 3, 640x360 
0x12CB3460, 36963308897384360, 231300713, 231300730, 17, 640x360 
0x12CB3460, 36963308897706512, 231300753, 231300756, 3, 640x360 
0x12CB3460, 36963308898028200, 231300783, 231300791, 8, 640x360 
0x12CB3460, 36963308898346904, 231300813, 231300816, 3, 640x360 
0x12CB3460, 36963308898665072, 231300843, 231300846, 3, 640x360 
0x12CB3460, 36963308898988504, 231300886, 231300889, 3, 640x360 
0x12CB3460, 36963308899307640, 231300904, 231300909, 5, 640x360 
0x12CB3460, 36963308899628368, 231300943, 231300947, 4, 640x360 
0x12CB3460, 36963308899947192, 231300974, 231300981, 7, 640x360 
0x12CB3460, 36963308900268864, 231301003, 231301011, 8, 640x360 
0x12CB3460, 36963308900587928, 231301034, 231301041, 7, 640x360 
0x12CB3460, 36963308901063896, 231301083, 231301086, 3, 640x360 
0x12CB3460, 36963308901385240, 231301113, 231301116, 3, 640x360 
0x12CB3460, 36963308901706176, 231301152, 231301155, 3, 640x360 
0x12CB3460, 36963308902023992, 231301183, 231301187, 4, 640x360 
0x12CB3460, 36963308902345856, 231301213, 231301217, 4, 640x360 
0x12CB3460, 36963308902664240, 231301243, 231301246, 3, 640x360 
0x12CB3460, 36963308902985408, 231301273, 231301277, 4, 640x360 
0x12CB3460, 36963308903305448, 231301304, 231301309, 5, 640x360 
0x12CB3460, 36963308903625784, 231301344, 231301346, 2, 640x360 
0x12CB3460, 36963308903944496, 231301379, 231301384, 5, 640x360 
0x12CB3460, 36963308904266600, 231301403, 231301406, 3, 640x360 
0x12CB3460, 36963308904744792, 231301453, 231301459, 6, 640x360 
0x12CB3460, 36963308905065376, 231301484, 231301486, 2, 640x360 
0x12CB3460, 36963308905386080, 231301512, 231301516, 4, 640x360 
0x12CB3460, 36963308905705440, 231301543, 231301548, 5, 640x360 
0x12CB3460, 36963308906024424, 231301584, 231301586, 2, 640x360 
0x12CB3460, 36963308906346968, 231301613, 231301616, 3, 640x360 
0x12CB3460, 36963308906668096, 231301644, 231301647, 3, 640x360 
0x12CB3460, 36963308906987240, 231301674, 231301678, 4, 640x360 
0x12CB3460, 36963308907307584, 231301713, 231301716, 3, 640x360 
0x12CB3460, 36963308907625320, 231301745, 231301753, 8, 640x360 
0x12CB3460, 36963308907944728, 231301773, 231301776, 3, 640x360 
0x12CB3460, 36963308908266952, 231301804, 231301807, 3, 640x360 
0x12CB3460, 36963308908744888, 231301875, 231301880, 5, 640x360 
0x12CB3460, 36963308909063904, 231301885, 231301892, 7, 640x360 
0x12CB3460, 36963308909386264, 231301913, 231301916, 3, 640x360 
0x12CB3460, 36963308909706072, 231301953, 231301956, 3, 640x360 
0x12CB3460, 36963308910025704, 231301983, 231301990, 7, 640x360 
0x12CB3460, 36963308910345664, 231302014, 231302017, 3, 640x360 
0x12CB3460, 36963308910667568, 231302044, 231302054, 10, 640x360 
0x12CB3460, 36963308910984336, 231302073, 231302077, 4, 640x360 
0x12CB3460, 36963308911304488, 231302104, 231302108, 4, 640x360 
0x12CB3460, 36963308911625496, 231302143, 231302146, 3, 640x360 
0x12CB3460, 36963308911945600, 231302173, 231302176, 3, 640x360 
0x12CB3460, 36963308912269024, 231302203, 231302209, 6, 640x360 
0x12CB3460, 36963308912746384, 231302253, 231302256, 3, 640x360 
0x12CB3460, 36963308913063888, 231302283, 231302286, 3, 640x360 
0x12CB3460, 36963308913384240, 231302313, 231302322, 9, 640x360 
0x12CB3460, 36963308913705336, 231302384, 231302387, 3, 640x360 
0x12CB3460, 36963308914346136, 231302413, 231302416, 3, 640x360 
0x12CB3460, 36963308914665160, 231302443, 231302446, 3, 640x360 
0x12CB3460, 36963308914985064, 231302473, 231302477, 4, 640x360 
0x12CB3460, 36963308915304976, 231302503, 231302507, 4, 640x360 
0x12CB3460, 36963308915625288, 231302543, 231302552, 9, 640x360 
0x12CB3460, 36963308915945712, 231302573, 231302576, 3, 640x360 
0x12CB3460, 36963308916425744, 231302623, 231302625, 2, 640x360 
0x12CB3460, 36963308916746488, 231302652, 231302655, 3, 640x360 
0x12CB3460, 36963308917065528, 231302684, 231302688, 4, 640x360 
0x12CB3460, 36963308917386544, 231302713, 231302718, 5, 640x360 
0x12CB3460, 36963308917705208, 231302753, 231302756, 3, 640x360 
0x12CB3460, 36963308918025328, 231302783, 231302786, 3, 640x360 
0x12CB3460, 36963308918345968, 231302814, 231302816, 2, 640x360 
0x12CB3460, 36963308918665720, 231302843, 231302846, 3, 640x360 
0x12CB3460, 36963308918985288, 231302884, 231302887, 3, 640x360 
0x12CB3460, 36963308919304920, 231302904, 231302908, 4, 640x360 
0x12CB3460, 36963308919625456, 231302943, 231302946, 3, 640x360 
0x12CB3460, 36963308919944640, 231302974, 231302977, 3, 640x360 
0x12CB3460, 36963308920425392, 231303024, 231303042, 18, 640x360 
0x12CB3460, 36963308920747888, 231303054, 231303057, 3, 640x360 
0x12CB3460, 36963308921063656, 231303082, 231303085, 3, 640x360 
0x12CB3460, 36963308921384824, 231303114, 231303119, 5, 640x360 
0x12CB3460, 36963308921705160, 231303153, 231303156, 3, 640x360 
0x12CB3460, 36963308922025432, 231303182, 231303186, 4, 640x360 
0x12CB3460, 36963308922346424, 231303213, 231303216, 3, 640x360 
0x12CB3460, 36963308922664536, 231303242, 231303246, 4, 640x360 
0x12CB3460, 36963308922984752, 231303273, 231303276, 3, 640x360 
0x12CB3460, 36963308923305424, 231303304, 231303308, 4, 640x360 
0x12CB3460, 36963308923624848, 231303343, 231303346, 3, 640x360 
0x12CB3460, 36963308923951720, 231303374, 231303380, 6, 640x360 
0x12CB3460, 36963308924424344, 231303423, 231303426, 3, 640x360 
0x12CB3460, 36963308924744528, 231303452, 231303455, 3, 640x360 
0x12CB3460, 36963308925067368, 231303483, 231303487, 4, 640x360 
0x12CB3460, 36963308925386120, 231303513, 231303517, 4, 640x360 
0x12CB3460, 36963308925705960, 231303544, 231303547, 3, 640x360 
0x12CB3460, 36963308926025904, 231303583, 231303586, 3, 640x360 
0x12CB3460, 36963308926344712, 231303613, 231303616, 3, 640x360 
0x12CB3460, 36963308926664504, 231303642, 231303645, 3, 640x360 
0x12CB3460, 36963308926985736, 231303673, 231303677, 4, 640x360 
0x12CB3460, 36963308927306912, 231303713, 231303717, 4, 640x360 
0x12CB3460, 36963308927624744, 231303743, 231303745, 2, 640x360 
0x12CB3460, 36963308928105624, 231303784, 231303788, 4, 640x360 
0x12CB3460, 36963308928423600, 231303823, 231303826, 3, 640x360 
0x12CB3460, 36963308928745568, 231303853, 231303873, 20, 640x360 
0x12CB3460, 36963308929066312, 231303885, 231303888, 3, 640x360 
0x12CB3460, 36963308929384080, 231303913, 231303916, 3, 640x360 
0x12CB3460, 36963308929707200, 231303953, 231303956, 3, 640x360 
0x12CB3460, 36963308930025408, 231303983, 231303986, 3, 640x360 
0x12CB3460, 36963308930347008, 231304013, 231304016, 3, 640x360 
0x12CB3460, 36963308930665256, 231304044, 231304051, 7, 640x360 
0x12CB3460, 36963308930986216, 231304073, 231304077, 4, 640x360 
0x12CB3460, 36963308931306472, 231304113, 231304115, 2, 640x360 
0x12CB3460, 36963308931624592, 231304143, 231304146, 3, 640x360 
0x12CB3460, 36963308932109664, 231304194, 231304199, 5, 640x360 
0x12CB3460, 36963308932425712, 231304223, 231304226, 3, 640x360 
0x12CB3460, 36963308932744184, 231304252, 231304255, 3, 640x360 
0x12CB3460, 36963308933064672, 231304283, 231304285, 2, 640x360 
0x12CB3460, 36963308933386088, 231304313, 231304319, 6, 640x360 
0x12CB3460, 36963308933705464, 231304379, 231304382, 3, 640x360 
0x12CB3460, 36963308934346104, 231304413, 231304415, 2, 640x360 
0x12CB3460, 36963308934664976, 231304443, 231304446, 3, 640x360 
0x12CB3460, 36963308934987432, 231304473, 231304478, 5, 640x360 
0x12CB3460, 36963308935306744, 231304513, 231304515, 2, 640x360 
0x12CB3460, 36963308935788704, 231304553, 231304557, 4, 640x360 
0x12CB3460, 36963308936105344, 231304583, 231304586, 3, 640x360 
0x12CB3460, 36963308936423912, 231304623, 231304627, 4, 640x360 
0x12CB3460, 36963308936744008, 231304653, 231304655, 2, 640x360 
0x12CB3460, 36963308937065224, 231304683, 231304686, 3, 640x360 
0x12CB3460, 36963308937384072, 231304713, 231304715, 2, 640x360 
0x12CB3460, 36963308937703880, 231304753, 231304755, 2, 640x360 
0x12CB3460, 36963308938023496, 231304783, 231304786, 3, 640x360 
0x12CB3460, 36963308938344576, 231304813, 231304820, 7, 640x360 
0x12CB3460, 36963308938665048, 231304843, 231304862, 19, 640x360 
0x12CB3460, 36963308938985368, 231304876, 231304879, 3, 640x360 
0x12CB3460, 36963308939306904, 231304914, 231304917, 3, 640x360 
0x12CB3460, 36963308939785208, 231304954, 231304956, 2, 640x360 
0x12CB3460, 36963308940103480, 231304983, 231304987, 4, 640x360 
0x12CB3460, 36963308940424248, 231305023, 231305026, 3, 640x360 
0x12CB3460, 36963308940746440, 231305053, 231305056, 3, 640x360 
0x12CB3460, 36963308941063792, 231305083, 231305086, 3, 640x360 
0x12CB3460, 36963308941385496, 231305112, 231305115, 3, 640x360 
0x12CB3460, 36963308941705720, 231305152, 231305155, 3, 640x360 
0x12CB3460, 36963308942024784, 231305183, 231305186, 3, 640x360 
0x12CB3460, 36963308942345360, 231305213, 231305216, 3, 640x360 
0x12CB3460, 36963308942664952, 231305243, 231305245, 2, 640x360 
0x12CB3460, 36963308942985320, 231305273, 231305276, 3, 640x360 
0x12CB3460, 36963308943305888, 231305304, 231305308, 4, 640x360 
0x12CB3460, 36963308943785736, 231305388, 231305391, 3, 640x360 
0x12CB3460, 36963308944425048, 231305423, 231305426, 3, 640x360 
0x12CB3460, 36963308944745688, 231305453, 231305456, 3, 640x360 
0x12CB3460, 36963308945066304, 231305483, 231305486, 3, 640x360 
0x12CB3460, 36963308945384720, 231305513, 231305516, 3, 640x360 
0x12CB3460, 36963308945705096, 231305544, 231305548, 4, 640x360 
0x12CB3460, 36963308946026400, 231305583, 231305586, 3, 640x360 
0x12CB3460, 36963308946344776, 231305612, 231305615, 3, 640x360 
0x12CB3460, 36963308946664344, 231305643, 231305646, 3, 640x360 
0x12CB3460, 36963308946983840, 231305673, 231305677, 4, 640x360 
0x12CB3460, 36963308947465744, 231305724, 231305727, 3, 640x360 
0x12CB3460, 36963308947785392, 231305754, 231305756, 2, 640x360 
0x12CB3460, 36963308948105344, 231305792, 231305795, 3, 640x360 
0x12CB3460, 36963308948426016, 231305823, 231305826, 3, 640x360 
0x12CB3460, 36963308948745928, 231305888, 231305891, 3, 640x360 
0x12CB3460, 36963308949384488, 231305913, 231305916, 3, 640x360 
0x12CB3460, 36963308949704744, 231305944, 231305948, 4, 640x360 
0x12CB3460, 36963308950026112, 231305984, 231305987, 3, 640x360 
0x12CB3460, 36963308950344392, 231306013, 231306016, 3, 640x360 
0x12CB3460, 36963308950665208, 231306044, 231306068, 24, 640x360 
0x12CB3460, 36963308950985816, 231306074, 231306077, 3, 640x360 
0x12CB3460, 36963308951464800, 231306122, 231306125, 3, 640x360 
0x12CB3460, 36963308951785736, 231306153, 231306156, 3, 640x360 
0x12CB3460, 36963308952105240, 231306193, 231306198, 5, 640x360 
0x12CB3460, 36963308952424192, 231306224, 231306227, 3, 640x360 
0x12CB3460, 36963308952744872, 231306253, 231306256, 3, 640x360 
0x12CB3460, 36963308953064704, 231306283, 231306286, 3, 640x360 
0x12CB3460, 36963308953386648, 231306313, 231306317, 4, 640x360 
0x12CB3460, 36963308953704712, 231306344, 231306349, 5, 640x360 
0x12CB3460, 36963308954024352, 231306379, 231306382, 3, 640x360 
0x12CB3460, 36963308954345240, 231306413, 231306415, 2, 640x360 
0x12CB3460, 36963308954664624, 231306443, 231306446, 3, 640x360 
0x12CB3460, 36963308954985240, 231306474, 231306476, 2, 640x360 
0x12CB3460, 36963308955467320, 231306524, 231306527, 3, 640x360 
0x12CB3460, 36963308955790040, 231306556, 231306560, 4, 640x360 
0x12CB3460, 36963308956106976, 231306593, 231306596, 3, 640x360 
0x12CB3460, 36963308956425464, 231306625, 231306628, 3, 640x360 
0x12CB3460, 36963308956747472, 231306655, 231306658, 3, 640x360 
0x12CB3460, 36963308957067984, 231306683, 231306687, 4, 640x360 
0x12CB3460, 36963308957384184, 231306714, 231306718, 4, 640x360 
0x12CB3460, 36963308957704808, 231306754, 231306756, 2, 640x360 
0x12CB3460, 36963308958024488, 231306784, 231306786, 2, 640x360 
0x12CB3460, 36963308958347232, 231306813, 231306815, 2, 640x360 
0x12CB3460, 36963308958663864, 231306843, 231306859, 16, 640x360 
0x12CB3460, 36963308959145368, 231306889, 231306893, 4, 640x360 
0x12CB3460, 36963308959467040, 231306923, 231306933, 10, 640x360 
0x12CB3460, 36963308959784656, 231306953, 231306961, 8, 640x360 
0x12CB3460, 36963308960105328, 231306983, 231306987, 4, 640x360 
0x12CB3460, 36963308960423400, 231307024, 231307028, 4, 640x360 
0x12CB3460, 36963308960749344, 231307054, 231307063, 9, 640x360 
0x12CB3460, 36963308961064504, 231307083, 231307089, 6, 640x360 
0x12CB3460, 36963308961384488, 231307114, 231307121, 7, 640x360 
0x12CB3460, 36963308961704480, 231307145, 231307149, 4, 640x360 
0x12CB3460, 36963308962024888, 231307183, 231307186, 3, 640x360 
0x12CB3460, 36963308962343912, 231307213, 231307217, 4, 640x360 
0x12CB3460, 36963308962663640, 231307243, 231307245, 2, 640x360 
0x12CB3460, 36963308963145472, 231307294, 231307297, 3, 640x360 
0x12CB3460, 36963308963464464, 231307323, 231307326, 3, 640x360 
0x12CB3460, 36963308963785952, 231307377, 231307380, 3, 640x360 
0x12CB3460, 36963308964104200, 231307385, 231307389, 4, 640x360 
0x12CB3460, 36963308964425600, 231307423, 231307426, 3, 640x360 
0x12CB3460, 36963308964746488, 231307452, 231307455, 3, 640x360 
0x12CB3460, 36963308965066576, 231307483, 231307486, 3, 640x360 
0x12CB3460, 36963308965387096, 231307513, 231307517, 4, 640x360 
0x12CB3460, 36963308965706384, 231307554, 231307556, 2, 640x360 
0x12CB3460, 36963308966023904, 231307583, 231307585, 2, 640x360 
0x12CB3460, 36963308966345368, 231307613, 231307616, 3, 640x360 
0x12CB3460, 36963308966827104, 231307663, 231307666, 3, 640x360 
0x12CB3460, 36963308967147184, 231307694, 231307697, 3, 640x360 
0x12CB3460, 36963308967463576, 231307723, 231307726, 3, 640x360 
0x12CB3460, 36963308967784864, 231307754, 231307756, 2, 640x360 
0x12CB3460, 36963308968105696, 231307793, 231307796, 3, 640x360 
0x12CB3460, 36963308968424896, 231307824, 231307826, 2, 640x360 
0x12CB3460, 36963308968748696, 231307876, 231307880, 4, 640x360 
0x12CB3460, 36963308969063672, 231307884, 231307887, 3, 640x360 
0x12CB3460, 36963308969384672, 231307913, 231307916, 3, 640x360 
0x12CB3460, 36963308969704112, 231307943, 231307947, 4, 640x360 
0x12CB3460, 36963308970030160, 231307984, 231307986, 2, 640x360 
0x12CB3460, 36963308970344232, 231308013, 231308018, 5, 640x360 
0x12CB3460, 36963308970823464, 231308062, 231308066, 4, 640x360 
0x12CB3460, 36963308971144832, 231308093, 231308096, 3, 640x360 
0x12CB3460, 36963308971464504, 231308123, 231308125, 2, 640x360 
0x12CB3460, 36963308971785840, 231308153, 231308156, 3, 640x360 
0x12CB3460, 36963308972105168, 231308194, 231308196, 2, 640x360 
0x12CB3460, 36963308972426480, 231308224, 231308227, 3, 640x360 
0x12CB3460, 36963308972743400, 231308253, 231308256, 3, 640x360 
0x12CB3460, 36963308973064160, 231308282, 231308285, 3, 640x360 
0x12CB3460, 36963308973385480, 231308313, 231308316, 3, 640x360 
0x12CB3460, 36963308973704712, 231308378, 231308381, 3, 640x360 
0x12CB3460, 36963308974345424, 231308413, 231308415, 2, 640x360 
0x12CB3460, 36963308974825408, 231308464, 231308467, 3, 640x360 
0x12CB3460, 36963308975145856, 231308495, 231308498, 3, 640x360 
0x12CB3460, 36963308975464584, 231308526, 231308530, 4, 640x360 
0x12CB3460, 36963308975788472, 231308553, 231308557, 4, 640x360 
0x12CB3460, 36963308976105600, 231308593, 231308595, 2, 640x360 
0x12CB3460, 36963308976424776, 231308624, 231308627, 3, 640x360 
0x12CB3460, 36963308976748336, 231308656, 231308659, 3, 640x360 
0x12CB3460, 36963308977067096, 231308684, 231308688, 4, 640x360 
0x12CB3460, 36963308977383432, 231308714, 231308717, 3, 640x360 
0x12CB3460, 36963308977705080, 231308743, 231308747, 4, 640x360 
0x12CB3460, 36963308978027712, 231308783, 231308786, 3, 640x360 
0x12CB3460, 36963308978502928, 231308824, 231308829, 5, 640x360 
0x12CB3460, 36963308978824432, 231308857, 231308862, 5, 640x360 
0x12CB3460, 36963308979145952, 231308893, 231308895, 2, 640x360 
0x12CB3460, 36963308979464240, 231308923, 231308926, 3, 640x360 
0x12CB3460, 36963308979785864, 231308953, 231308956, 3, 640x360 
0x12CB3460, 36963308980105184, 231308984, 231308988, 4, 640x360 
0x12CB3460, 36963308980424488, 231309024, 231309042, 18, 640x360 
0x12CB3460, 36963308980745072, 231309053, 231309056, 3, 640x360 
0x12CB3460, 36963308981065264, 231309083, 231309086, 3, 640x360 
0x12CB3460, 36963308981384800, 231309113, 231309116, 3, 640x360 
0x12CB3460, 36963308981704952, 231309144, 231309148, 4, 640x360 
0x12CB3460, 36963308982024496, 231309182, 231309185, 3, 640x360 
0x12CB3460, 36963308982507608, 231309225, 231309229, 4, 640x360 
0x12CB3460, 36963308982825656, 231309263, 231309266, 3, 640x360 
0x12CB3460, 36963308983145608, 231309294, 231309296, 2, 640x360 
0x12CB3460, 36963308983464024, 231309323, 231309325, 2, 640x360 
0x12CB3460, 36963308983784472, 231309371, 231309374, 3, 640x360 
0x12CB3460, 36963308984104840, 231309384, 231309388, 4, 640x360 
0x12CB3460, 36963308984425184, 231309423, 231309426, 3, 640x360 
0x12CB3460, 36963308984745488, 231309453, 231309455, 2, 640x360 
0x12CB3460, 36963308985066544, 231309484, 231309487, 3, 640x360 
0x12CB3460, 36963308985386984, 231309514, 231309517, 3, 640x360 
0x12CB3460, 36963308985707104, 231309554, 231309557, 3, 640x360 
0x12CB3460, 36963308986028584, 231309583, 231309585, 2, 640x360 
0x12CB3460, 36963308986504424, 231309633, 231309636, 3, 640x360 
0x12CB3460, 36963308986824704, 231309664, 231309667, 3, 640x360 
0x12CB3460, 36963308987147464, 231309694, 231309698, 4, 640x360 
0x12CB3460, 36963308987463592, 231309723, 231309726, 3, 640x360 
0x12CB3460, 36963308987785632, 231309753, 231309755, 2, 640x360 
0x12CB3460, 36963308988103656, 231309784, 231309787, 3, 640x360 
0x12CB3460, 36963308988424440, 231309826, 231309833, 7, 640x360 
0x12CB3460, 36963308988743512, 231309897, 231309901, 4, 640x360 
0x12CB3460, 36963308989384704, 231309913, 231309921, 8, 640x360 
0x12CB3460, 36963308989705096, 231309943, 231309947, 4, 640x360 
0x12CB3460, 36963308990183160, 231309993, 231310002, 9, 640x360 
0x12CB3460, 36963308990503224, 231310025, 231310028, 3, 640x360 
0x12CB3460, 36963308990826832, 231310063, 231310073, 10, 640x360 
0x12CB3460, 36963308991143872, 231310093, 231310098, 5, 640x360 
0x12CB3460, 36963308991466224, 231310123, 231310127, 4, 640x360 
0x12CB3460, 36963308991784784, 231310154, 231310157, 3, 640x360 
0x12CB3460, 36963308992104640, 231310194, 231310197, 3, 640x360 
0x12CB3460, 36963308992425800, 231310223, 231310226, 3, 640x360 
0x12CB3460, 36963308992745176, 231310253, 231310255, 2, 640x360 
0x12CB3460, 36963308993064136, 231310283, 231310286, 3, 640x360 
0x12CB3460, 36963308993384288, 231310314, 231310316, 2, 640x360 
0x12CB3460, 36963308993705024, 231310375, 231310378, 3, 640x360 
0x12CB3460, 36963308994184248, 231310394, 231310396, 2, 640x360 
0x12CB3460, 36963308994504768, 231310433, 231310436, 3, 640x360 
0x12CB3460, 36963308994825464, 231310463, 231310466, 3, 640x360 
0x12CB3460, 36963308995145792, 231310493, 231310496, 3, 640x360 
0x12CB3460, 36963308995468008, 231310525, 231310528, 3, 640x360 
0x12CB3460, 36963308995787064, 231310554, 231310559, 5, 640x360 
0x12CB3460, 36963308996105184, 231310593, 231310596, 3, 640x360 
0x12CB3460, 36963308996423736, 231310623, 231310626, 3, 640x360 
0x12CB3460, 36963308996747536, 231310654, 231310657, 3, 640x360 
0x12CB3460, 36963308997066808, 231310684, 231310690, 6, 640x360 
0x12CB3460, 36963308997384952, 231310712, 231310716, 4, 640x360 
0x12CB3460, 36963308997705656, 231310752, 231310755, 3, 640x360 
0x12CB3460, 36963308998183296, 231310792, 231310795, 3, 640x360 
0x12CB3460, 36963308998503856, 231310825, 231310828, 3, 640x360 
0x12CB3460, 36963308998826936, 231310875, 231310878, 3, 640x360 
0x12CB3460, 36963308999145096, 231310892, 231310895, 3, 640x360 
0x12CB3460, 36963308999463680, 231310923, 231310928, 5, 640x360 
0x12CB3460, 36963308999784352, 231310953, 231310956, 3, 640x360 
0x12CB3460, 36963309000103448, 231310984, 231310988, 4, 640x360 
0x12CB3460, 36963309000424424, 231311024, 231311027, 3, 640x360 
0x12CB3460, 36963309000744944, 231311054, 231311057, 3, 640x360 
0x12CB3460, 36963309001064584, 231311083, 231311086, 3, 640x360 
0x12CB3460, 36963309001384704, 231311114, 231311117, 3, 640x360 
0x12CB3460, 36963309001865120, 231311164, 231311167, 3, 640x360 
0x12CB3460, 36963309002183696, 231311193, 231311196, 3, 640x360 
0x12CB3460, 36963309002506632, 231311233, 231311237, 4, 640x360 
0x12CB3460, 36963309002823384, 231311262, 231311266, 4, 640x360 
0x12CB3460, 36963309003144840, 231311293, 231311296, 3, 640x360 
0x12CB3460, 36963309003464736, 231311323, 231311326, 3, 640x360 
0x12CB3460, 36963309003785616, 231311353, 231311377, 24, 640x360 
0x12CB3460, 36963309004104360, 231311384, 231311387, 3, 640x360 
0x12CB3460, 36963309004424072, 231311424, 231311429, 5, 640x360 
0x12CB3460, 36963309004744872, 231311453, 231311456, 3, 640x360 
0x12CB3460, 36963309005065120, 231311483, 231311486, 3, 640x360 
0x12CB3460, 36963309005386240, 231311514, 231311517, 3, 640x360 
0x12CB3460, 36963309005865840, 231311563, 231311566, 3, 640x360 
0x12CB3460, 36963309006184352, 231311594, 231311597, 3, 640x360 
0x12CB3460, 36963309006503248, 231311625, 231311629, 4, 640x360 
0x12CB3460, 36963309006824968, 231311664, 231311667, 3, 640x360 
0x12CB3460, 36963309007145000, 231311693, 231311696, 3, 640x360 
0x12CB3460, 36963309007464120, 231311724, 231311727, 3, 640x360 
0x12CB3460, 36963309007784640, 231311753, 231311756, 3, 640x360 
0x12CB3460, 36963309008105336, 231311784, 231311789, 5, 640x360 
0x12CB3460, 36963309008424592, 231311816, 231311820, 4, 640x360 
0x12CB3460, 36963309008744616, 231311876, 231311880, 4, 640x360 
0x12CB3460, 36963309009065336, 231311884, 231311887, 3, 640x360 
0x12CB3460, 36963309009545088, 231311933, 231311936, 3, 640x360 
0x12CB3460, 36963309009865664, 231311963, 231311965, 2, 640x360 
0x12CB3460, 36963309010184408, 231311994, 231311997, 3, 640x360 
0x12CB3460, 36963309010503800, 231312024, 231312028, 4, 640x360 
0x12CB3460, 36963309010824264, 231312064, 231312067, 3, 640x360 
0x12CB3460, 36963309011145616, 231312093, 231312096, 3, 640x360 
0x12CB3460, 36963309011464696, 231312123, 231312129, 6, 640x360 
0x12CB3460, 36963309011785040, 231312154, 231312168, 14, 640x360 
0x12CB3460, 36963309012147528, 231312193, 231312197, 4, 640x360 
0x12CB3460, 36963309012424808, 231312223, 231312236, 13, 640x360 
0x12CB3460, 36963309012748400, 231312253, 231312256, 3, 640x360 
0x12CB3460, 36963309013063664, 231312283, 231312287, 4, 640x360 
0x12CB3460, 36963309013544976, 231312334, 231312338, 4, 640x360 
0x12CB3460, 36963309014039456, 231312383, 231312389, 6, 640x360 
0x12CB3460, 36963309014184512, 231312393, 231312395, 2, 640x360 
0x12CB3460, 36963309014503944, 231312432, 231312435, 3, 640x360 
0x12CB3460, 36963309014825960, 231312463, 231312466, 3, 640x360 
0x12CB3460, 36963309015146232, 231312494, 231312497, 3, 640x360 
0x12CB3460, 36963309015465304, 231312524, 231312527, 3, 640x360 
0x12CB3460, 36963309015785280, 231312554, 231312557, 3, 640x360 
0x12CB3460, 36963309016103920, 231312593, 231312595, 2, 640x360 
0x12CB3460, 36963309016425688, 231312624, 231312627, 3, 640x360 
0x12CB3460, 36963309016744400, 231312653, 231312656, 3, 640x360 
0x12CB3460, 36963309017065720, 231312683, 231312686, 3, 640x360 
0x12CB3460, 36963309017553744, 231312733, 231312736, 3, 640x360 
0x12CB3460, 36963309017865048, 231312763, 231312766, 3, 640x360 
0x12CB3460, 36963309018185872, 231312794, 231312797, 3, 640x360 
0x12CB3460, 36963309018508216, 231312833, 231312835, 2, 640x360 
0x12CB3460, 36963309019052928, 231312884, 231312888, 4, 640x360 
0x12CB3460, 36963309019146128, 231312894, 231312897, 3, 640x360 
0x12CB3460, 36963309019463896, 231312923, 231312926, 3, 640x360 
0x12CB3460, 36963309019783456, 231312954, 231312956, 2, 640x360 
0x12CB3460, 36963309020104296, 231312983, 231312987, 4, 640x360 
0x12CB3460, 36963309020425024, 231313023, 231313027, 4, 640x360 
0x12CB3460, 36963309020744968, 231313053, 231313062, 9, 640x360 
0x12CB3460, 36963309021224528, 231313103, 231313105, 2, 640x360 
0x12CB3460, 36963309021544704, 231313132, 231313135, 3, 640x360 
0x12CB3460, 36963309021862952, 231313163, 231313166, 3, 640x360 
0x12CB3460, 36963309022183400, 231313192, 231313195, 3, 640x360 
0x12CB3460, 36963309022504024, 231313223, 231313226, 3, 640x360 
0x12CB3460, 36963309022828120, 231313263, 231313266, 3, 640x360 
0x12CB3460, 36963309023144952, 231313292, 231313295, 3, 640x360 
0x12CB3460, 36963309023463320, 231313324, 231313330, 6, 640x360 
0x12CB3460, 36963309023792120, 231313362, 231313378, 16, 640x360 
0x12CB3460, 36963309024107728, 231313396, 231313402, 6, 640x360 
0x12CB3460, 36963309024427576, 231313423, 231313427, 4, 640x360 
0x12CB3460, 36963309024745568, 231313453, 231313456, 3, 640x360 
0x12CB3460, 36963309025223856, 231313504, 231313507, 3, 640x360 
0x12CB3460, 36963309025543896, 231313533, 231313536, 3, 640x360 
0x12CB3460, 36963309025865432, 231313563, 231313566, 3, 640x360 
0x12CB3460, 36963309026186000, 231313593, 231313597, 4, 640x360 
0x12CB3460, 36963309026506696, 231313624, 231313627, 3, 640x360 
0x12CB3460, 36963309026824376, 231313663, 231313666, 3, 640x360 
0x12CB3460, 36963309027146200, 231313693, 231313696, 3, 640x360 
0x12CB3460, 36963309027466736, 231313723, 231313726, 3, 640x360 
0x12CB3460, 36963309027783832, 231313753, 231313756, 3, 640x360 
0x12CB3460, 36963309028105352, 231313792, 231313795, 3, 640x360 
0x12CB3460, 36963309028425840, 231313824, 231313827, 3, 640x360 
0x12CB3460, 36963309028745472, 231313882, 231313890, 8, 640x360 
0x12CB3460, 36963309029224096, 231313903, 231313906, 3, 640x360 
0x12CB3460, 36963309029546224, 231313933, 231313939, 6, 640x360 
0x12CB3460, 36963309029863760, 231313963, 231313970, 7, 640x360 
0x12CB3460, 36963309030183416, 231313993, 231313996, 3, 640x360 
0x12CB3460, 36963309030504824, 231314025, 231314028, 3, 640x360 
0x12CB3460, 36963309030828456, 231314063, 231314071, 8, 640x360 
0x12CB3460, 36963309031143872, 231314094, 231314100, 6, 640x360 
0x12CB3460, 36963309031465368, 231314123, 231314127, 4, 640x360 
0x12CB3460, 36963309031783104, 231314154, 231314159, 5, 640x360 
0x12CB3460, 36963309032103136, 231314184, 231314187, 3, 640x360 
0x12CB3460, 36963309032424512, 231314223, 231314226, 3, 640x360 
0x12CB3460, 36963309032902400, 231314272, 231314275, 3, 640x360 
0x12CB3460, 36963309033225608, 231314303, 231314305, 2, 640x360 
0x12CB3460, 36963309033546512, 231314332, 231314339, 7, 640x360 
0x12CB3460, 36963309033865936, 231314386, 231314389, 3, 640x360 
0x12CB3460, 36963309034185864, 231314394, 231314398, 4, 640x360 
0x12CB3460, 36963309034503152, 231314433, 231314435, 2, 640x360 
0x12CB3460, 36963309034824240, 231314456, 231314461, 5, 640x360 
0x12CB3460, 36963309035144304, 231314493, 231314496, 3, 640x360 
0x12CB3460, 36963309035464280, 231314524, 231314526, 2, 640x360 
0x12CB3460, 36963309035784040, 231314553, 231314557, 4, 640x360 
0x12CB3460, 36963309036104904, 231314593, 231314596, 3, 640x360 
0x12CB3460, 36963309036426536, 231314625, 231314631, 6, 640x360 
0x12CB3460, 36963309036903472, 231314674, 231314678, 4, 640x360 
0x12CB3460, 36963309037225608, 231314704, 231314707, 3, 640x360 
0x12CB3460, 36963309037546584, 231314733, 231314735, 2, 640x360 
0x12CB3460, 36963309037863880, 231314763, 231314766, 3, 640x360 
0x12CB3460, 36963309038183424, 231314793, 231314800, 7, 640x360 
0x12CB3460, 36963309038505208, 231314825, 231314829, 4, 640x360 
0x12CB3460, 36963309038824456, 231314876, 231314882, 6, 640x360 
0x12CB3460, 36963309039147696, 231314893, 231314898, 5, 640x360 
0x12CB3460, 36963309039467312, 231314923, 231314927, 4, 640x360 
0x12CB3460, 36963309039784504, 231314954, 231314956, 2, 640x360 
0x12CB3460, 36963309040103384, 231314983, 231314987, 4, 640x360 
0x12CB3460, 36963309040424968, 231315024, 231315026, 2, 640x360 
0x12CB3460, 36963309040905344, 231315063, 231315067, 4, 640x360 
0x12CB3460, 36963309041226224, 231315103, 231315106, 3, 640x360 
0x12CB3460, 36963309041544848, 231315133, 231315136, 3, 640x360 
0x12CB3460, 36963309041864456, 231315163, 231315166, 3, 640x360 
0x12CB3460, 36963309042183952, 231315194, 231315197, 3, 640x360 
0x12CB3460, 36963309042507016, 231315225, 231315233, 8, 640x360 
0x12CB3460, 36963309042823992, 231315263, 231315267, 4, 640x360 
0x12CB3460, 36963309043143496, 231315293, 231315295, 2, 640x360 
0x12CB3460, 36963309043463856, 231315324, 231315326, 2, 640x360 
0x12CB3460, 36963309043785224, 231315370, 231315373, 3, 640x360 
0x12CB3460, 36963309044106552, 231315383, 231315386, 3, 640x360 
0x12CB3460, 36963309044582944, 231315432, 231315435, 3, 640x360 
0x12CB3460, 36963309044905344, 231315463, 231315466, 3, 640x360 
0x12CB3460, 36963309045223232, 231315503, 231315506, 3, 640x360 
0x12CB3460, 36963309045544592, 231315533, 231315535, 2, 640x360 
0x12CB3460, 36963309045864760, 231315563, 231315566, 3, 640x360 
0x12CB3460, 36963309046184480, 231315593, 231315596, 3, 640x360 
0x12CB3460, 36963309046505056, 231315624, 231315628, 4, 640x360 
0x12CB3460, 36963309046824232, 231315664, 231315667, 3, 640x360 
0x12CB3460, 36963309047144240, 231315693, 231315696, 3, 640x360 
0x12CB3460, 36963309047464984, 231315724, 231315726, 2, 640x360 
0x12CB3460, 36963309047783568, 231315754, 231315756, 2, 640x360 
0x12CB3460, 36963309048104664, 231315784, 231315787, 3, 640x360 
0x12CB3460, 36963309048584552, 231315833, 231315836, 3, 640x360 
0x12CB3460, 36963309048903728, 231315879, 231315883, 4, 640x360 
0x12CB3460, 36963309049223352, 231315902, 231315905, 3, 640x360 
0x12CB3460, 36963309049544496, 231315933, 231315936, 3, 640x360 
0x12CB3460, 36963309049863792, 231315963, 231315965, 2, 640x360 
0x12CB3460, 36963309050185208, 231315994, 231315997, 3, 640x360 
0x12CB3460, 36963309050504808, 231316033, 231316036, 3, 640x360 
0x12CB3460, 36963309050824792, 231316063, 231316066, 3, 640x360 
0x12CB3460, 36963309051142776, 231316093, 231316096, 3, 640x360 
0x12CB3460, 36963309051463136, 231316122, 231316125, 3, 640x360 
0x12CB3460, 36963309051783512, 231316153, 231316156, 3, 640x360 
0x12CB3460, 36963309052263296, 231316203, 231316206, 3, 640x360 
0x12CB3460, 36963309052587128, 231316232, 231316236, 4, 640x360 
0x12CB3460, 36963309052903032, 231316264, 231316267, 3, 640x360 
0x12CB3460, 36963309053223496, 231316303, 231316306, 3, 640x360 
0x12CB3460, 36963309053544184, 231316333, 231316336, 3, 640x360 
0x12CB3460, 36963309053864592, 231316375, 231316378, 3, 640x360 
0x12CB3460, 36963309054184544, 231316394, 231316396, 2, 640x360 
0x12CB3460, 36963309054502920, 231316424, 231316427, 3, 640x360 
0x12CB3460, 36963309054824544, 231316463, 231316466, 3, 640x360 
0x12CB3460, 36963309055144184, 231316493, 231316496, 3, 640x360 
0x12CB3460, 36963309055466704, 231316524, 231316527, 3, 640x360 
0x12CB3460, 36963309055786232, 231316554, 231316559, 5, 640x360 
0x12CB3460, 36963309056262656, 231316603, 231316606, 3, 640x360 
0x12CB3460, 36963309056584928, 231316633, 231316637, 4, 640x360 
0x12CB3460, 36963309056906152, 231316674, 231316678, 4, 640x360 
0x12CB3460, 36963309057223080, 231316703, 231316707, 4, 640x360 
0x12CB3460, 36963309057544176, 231316733, 231316735, 2, 640x360 
0x12CB3460, 36963309057864424, 231316762, 231316765, 3, 640x360 
0x12CB3460, 36963309058183768, 231316794, 231316797, 3, 640x360 
0x12CB3460, 36963309058503672, 231316824, 231316828, 4, 640x360 
0x12CB3460, 36963309058825000, 231316876, 231316879, 3, 640x360 
0x12CB3460, 36963309059143104, 231316893, 231316896, 3, 640x360 
0x12CB3460, 36963309059463936, 231316923, 231316926, 3, 640x360 
0x12CB3460, 36963309059784712, 231316954, 231316956, 2, 640x360 
0x12CB3460, 36963309060263520, 231317004, 231317007, 3, 640x360 
0x12CB3460, 36963309060585776, 231317033, 231317038, 5, 640x360 
0x12CB3460, 36963309060902904, 231317064, 231317069, 5, 640x360 
0x12CB3460, 36963309061222864, 231317103, 231317106, 3, 640x360 
0x12CB3460, 36963309061544256, 231317132, 231317135, 3, 640x360 
0x12CB3460, 36963309061865280, 231317164, 231317166, 2, 640x360 
0x12CB3460, 36963309062184320, 231317194, 231317197, 3, 640x360 
0x12CB3460, 36963309062504224, 231317224, 231317228, 4, 640x360 
0x12CB3460, 36963309062825288, 231317263, 231317265, 2, 640x360 
0x12CB3460, 36963309063145544, 231317293, 231317296, 3, 640x360 
0x12CB3460, 36963309063466600, 231317323, 231317327, 4, 640x360 
0x12CB3460, 36963309063945368, 231317380, 231317384, 4, 640x360 
0x12CB3460, 36963309064263272, 231317403, 231317405, 2, 640x360 
0x12CB3460, 36963309064584528, 231317432, 231317436, 4, 640x360 
0x12CB3460, 36963309064903800, 231317464, 231317467, 3, 640x360 
0x12CB3460, 36963309065224376, 231317504, 231317507, 3, 640x360 
0x12CB3460, 36963309065545280, 231317534, 231317537, 3, 640x360 
0x12CB3460, 36963309065863720, 231317564, 231317569, 5, 640x360 
0x12CB3460, 36963309066182832, 231317592, 231317596, 4, 640x360 
0x12CB3460, 36963309066504384, 231317624, 231317628, 4, 640x360 
0x12CB3460, 36963309066824416, 231317664, 231317667, 3, 640x360 
0x12CB3460, 36963309067144896, 231317694, 231317697, 3, 640x360 
0x12CB3460, 36963309067467152, 231317723, 231317727, 4, 640x360 
0x12CB3460, 36963309067945184, 231317773, 231317776, 3, 640x360 
0x12CB3460, 36963309068263768, 231317803, 231317806, 3, 640x360 
0x12CB3460, 36963309068586312, 231317833, 231317836, 3, 640x360 
0x12CB3460, 36963309068910176, 231317885, 231317888, 3, 640x360 
0x12CB3460, 36963309069223640, 231317904, 231317906, 2, 640x360 
0x12CB3460, 36963309069548208, 231317932, 231317939, 7, 640x360 
0x12CB3460, 36963309069864664, 231317963, 231317969, 6, 640x360 
0x12CB3460, 36963309070185952, 231317994, 231317998, 4, 640x360 
0x12CB3460, 36963309070504256, 231318025, 231318028, 3, 640x360 
0x12CB3460, 36963309070827528, 231318063, 231318068, 5, 640x360 
0x12CB3460, 36963309071144048, 231318094, 231318097, 3, 640x360 
0x12CB3460, 36963309071466352, 231318124, 231318127, 3, 640x360 
0x12CB3460, 36963309071947336, 231318174, 231318178, 4, 640x360 
0x12CB3460, 36963309072263448, 231318203, 231318206, 3, 640x360 
0x12CB3460, 36963309072582864, 231318234, 231318237, 3, 640x360 
0x12CB3460, 36963309072904336, 231318274, 231318276, 2, 640x360 
0x12CB3460, 36963309073224248, 231318302, 231318306, 4, 640x360 
0x12CB3460, 36963309073544064, 231318333, 231318336, 3, 640x360 
0x12CB3460, 36963309073863840, 231318363, 231318366, 3, 640x360 
0x12CB3460, 36963309074184304, 231318393, 231318397, 4, 640x360 
0x12CB3460, 36963309074504504, 231318433, 231318436, 3, 640x360 
0x12CB3460, 36963309074823752, 231318463, 231318465, 2, 640x360 
0x12CB3460, 36963309075143904, 231318493, 231318496, 3, 640x360 
0x12CB3460, 36963309075623160, 231318542, 231318545, 3, 640x360 
0x12CB3460, 36963309075943376, 231318573, 231318576, 3, 640x360 
0x12CB3460, 36963309076262944, 231318602, 231318605, 3, 640x360 
0x12CB3460, 36963309076584224, 231318633, 231318635, 2, 640x360 
0x12CB3460, 36963309076904352, 231318663, 231318666, 3, 640x360 
0x12CB3460, 36963309077223288, 231318703, 231318706, 3, 640x360 
0x12CB3460, 36963309077544584, 231318733, 231318736, 3, 640x360 
0x12CB3460, 36963309077862752, 231318763, 231318766, 3, 640x360 
0x12CB3460, 36963309078184256, 231318792, 231318795, 3, 640x360 
0x12CB3460, 36963309078505648, 231318823, 231318827, 4, 640x360 
0x12CB3460, 36963309078825120, 231318876, 231318879, 3, 640x360 
0x12CB3460, 36963309079145576, 231318893, 231318895, 2, 640x360 
0x12CB3460, 36963309079623144, 231318943, 231318946, 3, 640x360 
0x12CB3460, 36963309079943208, 231318973, 231318976, 3, 640x360 
0x12CB3460, 36963309080265864, 231319002, 231319005, 3, 640x360 
0x12CB3460, 36963309080585696, 231319033, 231319037, 4, 640x360 
0x12CB3460, 36963309080904400, 231319073, 231319076, 3, 640x360 
0x12CB3460, 36963309081224168, 231319103, 231319106, 3, 640x360 
0x12CB3460, 36963309081543696, 231319133, 231319136, 3, 640x360 
0x12CB3460, 36963309081863960, 231319163, 231319166, 3, 640x360 
0x12CB3460, 36963309082186072, 231319192, 231319195, 3, 640x360 
0x12CB3460, 36963309082509856, 231319226, 231319229, 3, 640x360 
0x12CB3460, 36963309082824120, 231319263, 231319266, 3, 640x360 
0x12CB3460, 36963309083303232, 231319303, 231319306, 3, 640x360 
0x12CB3460, 36963309083622912, 231319343, 231319346, 3, 640x360 
0x12CB3460, 36963309083943312, 231319375, 231319379, 4, 640x360 
0x12CB3460, 36963309084263064, 231319403, 231319406, 3, 640x360 
0x12CB3460, 36963309084584488, 231319432, 231319435, 3, 640x360 
0x12CB3460, 36963309084903760, 231319463, 231319466, 3, 640x360 
0x12CB3460, 36963309085224264, 231319503, 231319505, 2, 640x360 
0x12CB3460, 36963309085543976, 231319534, 231319536, 2, 640x360 
0x12CB3460, 36963309085865480, 231319563, 231319566, 3, 640x360 
0x12CB3460, 36963309086184728, 231319592, 231319595, 3, 640x360 
0x12CB3460, 36963309086507016, 231319633, 231319636, 3, 640x360 
0x12CB3460, 36963309086824368, 231319664, 231319667, 3, 640x360 
0x12CB3460, 36963309087304984, 231319714, 231319718, 4, 640x360 
0x12CB3460, 36963309087623752, 231319743, 231319747, 4, 640x360 
0x12CB3460, 36963309087942816, 231319773, 231319775, 2, 640x360 
0x12CB3460, 36963309088262816, 231319803, 231319806, 3, 640x360 
0x12CB3460, 36963309088583448, 231319833, 231319835, 2, 640x360 
0x12CB3460, 36963309088904984, 231319874, 231319876, 2, 640x360 
0x12CB3460, 36963309089224872, 231319904, 231319906, 2, 640x360 
0x12CB3460, 36963309089544600, 231319932, 231319935, 3, 640x360 
0x12CB3460, 36963309089863976, 231319963, 231319966, 3, 640x360 
0x12CB3460, 36963309090184648, 231319994, 231319997, 3, 640x360 
0x12CB3460, 36963309090506056, 231320025, 231320028, 3, 640x360 
0x12CB3460, 36963309090824480, 231320063, 231320066, 3, 640x360 
0x12CB3460, 36963309091302368, 231320103, 231320105, 2, 640x360 
0x12CB3460, 36963309091622888, 231320143, 231320146, 3, 640x360 
0x12CB3460, 36963309091945040, 231320167, 231320170, 3, 640x360 
0x12CB3460, 36963309092263144, 231320204, 231320207, 3, 640x360 
0x12CB3460, 36963309092583000, 231320232, 231320235, 3, 640x360 
0x12CB3460, 36963309092903528, 231320272, 231320275, 3, 640x360 
0x12CB3460, 36963309093224616, 231320303, 231320306, 3, 640x360 
0x12CB3460, 36963309093546904, 231320332, 231320335, 3, 640x360 
0x12CB3460, 36963309093865200, 231320380, 231320383, 3, 640x360 
0x12CB3460, 36963309094184952, 231320392, 231320395, 3, 640x360 
0x12CB3460, 36963309094504856, 231320424, 231320427, 3, 640x360 
0x12CB3460, 36963309094982384, 231320472, 231320475, 3, 640x360 
0x12CB3460, 36963309095303072, 231320503, 231320507, 4, 640x360 
0x12CB3460, 36963309095624320, 231320543, 231320547, 4, 640x360 
0x12CB3460, 36963309095944416, 231320573, 231320591, 18, 640x360 
0x12CB3460, 36963309096264568, 231320603, 231320606, 3, 640x360 
0x12CB3460, 36963309096584544, 231320633, 231320635, 2, 640x360 
0x12CB3460, 36963309096904592, 231320673, 231320676, 3, 640x360 
0x12CB3460, 36963309097223640, 231320703, 231320705, 2, 640x360 
0x12CB3460, 36963309097542752, 231320733, 231320735, 2, 640x360 
0x12CB3460, 36963309097863672, 231320763, 231320766, 3, 640x360 
0x12CB3460, 36963309098184256, 231320793, 231320796, 3, 640x360 
0x12CB3460, 36963309098505288, 231320833, 231320836, 3, 640x360 
0x12CB3460, 36963309098984344, 231320882, 231320886, 4, 640x360 
0x12CB3460, 36963309099302296, 231320903, 231320906, 3, 640x360 
0x12CB3460, 36963309099624360, 231320943, 231320946, 3, 640x360 
0x12CB3460, 36963309099944464, 231320972, 231320975, 3, 640x360 
0x12CB3460, 36963309100264984, 231321003, 231321007, 4, 640x360 
0x12CB3460, 36963309100586176, 231321034, 231321037, 3, 640x360 
0x12CB3460, 36963309100902952, 231321063, 231321066, 3, 640x360 
0x12CB3460, 36963309101222528, 231321102, 231321105, 3, 640x360 
0x12CB3460, 36963309101543728, 231321133, 231321136, 3, 640x360 
0x12CB3460, 36963309101863344, 231321162, 231321165, 3, 640x360 
0x12CB3460, 36963309102184976, 231321193, 231321196, 3, 640x360 
0x12CB3460, 36963309102504600, 231321223, 231321226, 3, 640x360 
0x12CB3460, 36963309102984784, 231321274, 231321277, 3, 640x360 
0x12CB3460, 36963309103304000, 231321303, 231321306, 3, 640x360 
0x12CB3460, 36963309103622872, 231321343, 231321346, 3, 640x360 
0x12CB3460, 36963309103944704, 231321373, 231321376, 3, 640x360 
0x12CB3460, 36963309104263296, 231321403, 231321406, 3, 640x360 
0x12CB3460, 36963309104584056, 231321432, 231321435, 3, 640x360 
0x12CB3460, 36963309104903256, 231321463, 231321466, 3, 640x360 
0x12CB3460, 36963309105224176, 231321504, 231321507, 3, 640x360 
0x12CB3460, 36963309105543512, 231321532, 231321535, 3, 640x360 
0x12CB3460, 36963309105862928, 231321563, 231321566, 3, 640x360 
0x12CB3460, 36963309106183032, 231321592, 231321596, 4, 640x360 
0x12CB3460, 36963309106663424, 231321643, 231321647, 4, 640x360 
0x12CB3460, 36963309106990872, 231321673, 231321676, 3, 640x360 
0x12CB3460, 36963309107303976, 231321704, 231321707, 3, 640x360 
0x12CB3460, 36963309107623560, 231321743, 231321747, 4, 640x360 
0x12CB3460, 36963309107943752, 231321773, 231321776, 3, 640x360 
0x12CB3460, 36963309108263528, 231321803, 231321806, 3, 640x360 
0x12CB3460, 36963309108582792, 231321832, 231321836, 4, 640x360 
0x12CB3460, 36963309108905952, 231321863, 231321867, 4, 640x360 
0x12CB3460, 36963309109223072, 231321903, 231321906, 3, 640x360 
0x12CB3460, 36963309109543704, 231321932, 231321936, 4, 640x360 
0x12CB3460, 36963309109863280, 231321963, 231321966, 3, 640x360 
0x12CB3460, 36963309110184232, 231321993, 231321996, 3, 640x360 
0x12CB3460, 36963309110663648, 231322044, 231322048, 4, 640x360 
0x12CB3460, 36963309110984784, 231322073, 231322076, 3, 640x360 
0x12CB3460, 36963309111305416, 231322103, 231322106, 3, 640x360 
0x12CB3460, 36963309111624088, 231322143, 231322146, 3, 640x360 
0x12CB3460, 36963309111944088, 231322173, 231322177, 4, 640x360 
0x12CB3460, 36963309112262936, 231322203, 231322206, 3, 640x360 
0x12CB3460, 36963309112584264, 231322232, 231322236, 4, 640x360 
0x12CB3460, 36963309112903000, 231322263, 231322265, 2, 640x360 
0x12CB3460, 36963309113224424, 231322303, 231322306, 3, 640x360 
0x12CB3460, 36963309113544400, 231322334, 231322336, 2, 640x360 
0x12CB3460, 36963309113865152, 231322375, 231322378, 3, 640x360 
0x12CB3460, 36963309114183536, 231322392, 231322395, 3, 640x360 
0x12CB3460, 36963309114663192, 231322443, 231322450, 7, 640x360 
0x12CB3460, 36963309114987944, 231322473, 231322477, 4, 640x360 
0x12CB3460, 36963309115302552, 231322504, 231322506, 2, 640x360 
0x12CB3460, 36963309115622936, 231322543, 231322547, 4, 640x360 
0x12CB3460, 36963309115943928, 231322572, 231322576, 4, 640x360 
0x12CB3460, 36963309116262472, 231322603, 231322606, 3, 640x360 
0x12CB3460, 36963309116582360, 231322634, 231322637, 3, 640x360 
0x12CB3460, 36963309116902552, 231322663, 231322666, 3, 640x360 
0x12CB3460, 36963309117223776, 231322703, 231322707, 4, 640x360 
0x12CB3460, 36963309117543808, 231322733, 231322736, 3, 640x360 
0x12CB3460, 36963309117864800, 231322763, 231322766, 3, 640x360 
0x12CB3460, 36963309118344632, 231322813, 231322816, 3, 640x360 
0x12CB3460, 36963309118663824, 231322842, 231322846, 4, 640x360 
0x12CB3460, 36963309118984232, 231322874, 231322878, 4, 640x360 
0x12CB3460, 36963309119302944, 231322903, 231322906, 3, 640x360 
0x12CB3460, 36963309119623856, 231322943, 231322946, 3, 640x360 
0x12CB3460, 36963309119943168, 231322973, 231322976, 3, 640x360 
0x12CB3460, 36963309120262904, 231323003, 231323006, 3, 640x360 
0x12CB3460, 36963309120582680, 231323034, 231323037, 3, 640x360 
0x12CB3460, 36963309120905368, 231323074, 231323078, 4, 640x360 
0x12CB3460, 36963309121225368, 231323103, 231323106, 3, 640x360 
0x12CB3460, 36963309121542976, 231323133, 231323136, 3, 640x360 
0x12CB3460, 36963309121863840, 231323163, 231323166, 3, 640x360 
0x12CB3460, 36963309122344536, 231323214, 231323217, 3, 640x360 
0x12CB3460, 36963309122662600, 231323243, 231323246, 3, 640x360 
0x12CB3460, 36963309122984208, 231323272, 231323275, 3, 640x360 
0x12CB3460, 36963309123306624, 231323303, 231323306, 3, 640x360 
0x12CB3460, 36963309123624464, 231323344, 231323348, 4, 640x360 
0x12CB3460, 36963309123944600, 231323369, 231323372, 3, 640x360 
0x12CB3460, 36963309124263344, 231323402, 231323405, 3, 640x360 
0x12CB3460, 36963309124582680, 231323433, 231323435, 2, 640x360 
0x12CB3460, 36963309124902856, 231323474, 231323477, 3, 640x360 
0x12CB3460, 36963309125224472, 231323503, 231323505, 2, 640x360 
0x12CB3460, 36963309125546976, 231323533, 231323536, 3, 640x360 
0x12CB3460, 36963309126024280, 231323582, 231323585, 3, 640x360 
0x12CB3460, 36963309126342568, 231323613, 231323616, 3, 640x360 
0x12CB3460, 36963309126661960, 231323642, 231323645, 3, 640x360 
0x12CB3460, 36963309126984552, 231323673, 231323676, 3, 640x360 
0x12CB3460, 36963309127304176, 231323703, 231323706, 3, 640x360 
0x12CB3460, 36963309127622816, 231323744, 231323747, 3, 640x360 
0x12CB3460, 36963309127945840, 231323773, 231323776, 3, 640x360 
0x12CB3460, 36963309128263400, 231323804, 231323806, 2, 640x360 
0x12CB3460, 36963309128583256, 231323833, 231323835, 2, 640x360 
0x12CB3460, 36963309128905088, 231323876, 231323880, 4, 640x360 
0x12CB3460, 36963309129223112, 231323903, 231323905, 2, 640x360 
0x12CB3460, 36963309129545256, 231323932, 231323935, 3, 640x360 
0x12CB3460, 36963309130022584, 231323983, 231323985, 2, 640x360 
0x12CB3460, 36963309130343024, 231324013, 231324016, 3, 640x360 
0x12CB3460, 36963309130662544, 231324042, 231324046, 4, 640x360 
0x12CB3460, 36963309130984744, 231324073, 231324076, 3, 640x360 
0x12CB3460, 36963309131304328, 231324113, 231324116, 3, 640x360 
0x12CB3460, 36963309131623200, 231324142, 231324145, 3, 640x360 
0x12CB3460, 36963309131942840, 231324174, 231324177, 3, 640x360 
0x12CB3460, 36963309132263136, 231324203, 231324206, 3, 640x360 
0x12CB3460, 36963309132582584, 231324233, 231324236, 3, 640x360 
0x12CB3460, 36963309132903296, 231324263, 231324266, 3, 640x360 
0x12CB3460, 36963309133225040, 231324302, 231324306, 4, 640x360 
0x12CB3460, 36963309133544688, 231324333, 231324336, 3, 640x360 
0x12CB3460, 36963309134022464, 231324383, 231324386, 3, 640x360 
0x12CB3460, 36963309134342552, 231324413, 231324415, 2, 640x360 
0x12CB3460, 36963309134663640, 231324442, 231324445, 3, 640x360 
0x12CB3460, 36963309134984184, 231324473, 231324476, 3, 640x360 
0x12CB3460, 36963309135303104, 231324504, 231324506, 2, 640x360 
0x12CB3460, 36963309135622920, 231324542, 231324560, 18, 640x360 
0x12CB3460, 36963309135945024, 231324573, 231324576, 3, 640x360 
0x12CB3460, 36963309136263552, 231324603, 231324605, 2, 640x360 
0x12CB3460, 36963309136585128, 231324633, 231324636, 3, 640x360 
0x12CB3460, 36963309136906624, 231324672, 231324676, 4, 640x360 
0x12CB3460, 36963309137225848, 231324704, 231324706, 2, 640x360 
0x12CB3460, 36963309137704216, 231324743, 231324746, 3, 640x360 
0x12CB3460, 36963309138024744, 231324783, 231324786, 3, 640x360 
0x12CB3460, 36963309138342792, 231324813, 231324816, 3, 640x360 
0x12CB3460, 36963309138664288, 231324843, 231324847, 4, 640x360 
0x12CB3460, 36963309138988616, 231324894, 231324897, 3, 640x360 
0x12CB3460, 36963309139302544, 231324903, 231324906, 3, 640x360 
0x12CB3460, 36963309139622912, 231324942, 231324945, 3, 640x360 
0x12CB3460, 36963309139943552, 231324973, 231324976, 3, 640x360 
0x12CB3460, 36963309140262304, 231325002, 231325005, 3, 640x360 
0x12CB3460, 36963309140583712, 231325033, 231325036, 3, 640x360 
0x12CB3460, 36963309140902976, 231325073, 231325076, 3, 640x360 
0x12CB3460, 36963309141223152, 231325103, 231325106, 3, 640x360 
0x12CB3460, 36963309141704408, 231325153, 231325156, 3, 640x360 
0x12CB3460, 36963309142024160, 231325183, 231325186, 3, 640x360 
0x12CB3460, 36963309142343592, 231325213, 231325216, 3, 640x360 
0x12CB3460, 36963309142663424, 231325243, 231325246, 3, 640x360 
0x12CB3460, 36963309142983312, 231325274, 231325276, 2, 640x360 
0x12CB3460, 36963309143305232, 231325312, 231325315, 3, 640x360 
0x12CB3460, 36963309143623432, 231325343, 231325346, 3, 640x360 
0x12CB3460, 36963309143944336, 231325377, 231325380, 3, 640x360 
0x12CB3460, 36963309144262808, 231325404, 231325406, 2, 640x360 
0x12CB3460, 36963309144583624, 231325432, 231325435, 3, 640x360 
0x12CB3460, 36963309144904936, 231325473, 231325476, 3, 640x360 
0x12CB3460, 36963309145225984, 231325503, 231325506, 3, 640x360 
0x12CB3460, 36963309145703960, 231325554, 231325556, 2, 640x360 
0x12CB3460, 36963309146023480, 231325583, 231325586, 3, 640x360 
0x12CB3460, 36963309146345488, 231325613, 231325616, 3, 640x360 
0x12CB3460, 36963309146666976, 231325643, 231325646, 3, 640x360 
0x12CB3460, 36963309146985392, 231325686, 231325691, 5, 640x360 
0x12CB3460, 36963309147306160, 231325715, 231325719, 4, 640x360 
0x12CB3460, 36963309147625416, 231325743, 231325746, 3, 640x360 
0x12CB3460, 36963309147943392, 231325773, 231325776, 3, 640x360 
0x12CB3460, 36963309148263040, 231325803, 231325821, 18, 640x360 
0x12CB3460, 36963309148583640, 231325834, 231325837, 3, 640x360 
0x12CB3460, 36963309148904584, 231325876, 231325880, 4, 640x360 
0x12CB3460, 36963309149381912, 231325913, 231325916, 3, 640x360 
0x12CB3460, 36963309149701848, 231325943, 231325946, 3, 640x360 
0x12CB3460, 36963309150023448, 231325983, 231325986, 3, 640x360 
0x12CB3460, 36963309150344736, 231326013, 231326016, 3, 640x360 
0x12CB3460, 36963309150662216, 231326044, 231326047, 3, 640x360 
0x12CB3460, 36963309150984256, 231326073, 231326076, 3, 640x360 
0x12CB3460, 36963309151304640, 231326113, 231326116, 3, 640x360 
0x12CB3460, 36963309151623360, 231326143, 231326146, 3, 640x360 
0x12CB3460, 36963309151942728, 231326173, 231326176, 3, 640x360 
0x12CB3460, 36963309152262256, 231326202, 231326206, 4, 640x360 
0x12CB3460, 36963309152583384, 231326233, 231326236, 3, 640x360 
0x12CB3460, 36963309152904712, 231326263, 231326266, 3, 640x360 
0x12CB3460, 36963309153381864, 231326312, 231326315, 3, 640x360 
0x12CB3460, 36963309153701856, 231326343, 231326347, 4, 640x360 
0x12CB3460, 36963309154022976, 231326382, 231326385, 3, 640x360 
0x12CB3460, 36963309154342600, 231326412, 231326415, 3, 640x360 
0x12CB3460, 36963309154663880, 231326443, 231326447, 4, 640x360 
0x12CB3460, 36963309154982728, 231326474, 231326477, 3, 640x360 
0x12CB3460, 36963309155303568, 231326504, 231326506, 2, 640x360 
0x12CB3460, 36963309155622760, 231326542, 231326545, 3, 640x360 
0x12CB3460, 36963309155943008, 231326573, 231326576, 3, 640x360 
0x12CB3460, 36963309156262344, 231326602, 231326605, 3, 640x360 
0x12CB3460, 36963309156584976, 231326633, 231326637, 4, 640x360 
0x12CB3460, 36963309156903656, 231326663, 231326666, 3, 640x360 
0x12CB3460, 36963309157382408, 231326713, 231326717, 4, 640x360 
0x12CB3460, 36963309157703304, 231326743, 231326747, 4, 640x360 
0x12CB3460, 36963309158026088, 231326783, 231326785, 2, 640x360 
0x12CB3460, 36963309158343096, 231326813, 231326816, 3, 640x360 
0x12CB3460, 36963309158663344, 231326843, 231326848, 5, 640x360 
0x12CB3460, 36963309158985280, 231326879, 231326882, 3, 640x360 
0x12CB3460, 36963309159302528, 231326903, 231326906, 3, 640x360 
0x12CB3460, 36963309159623184, 231326943, 231326946, 3, 640x360 
0x12CB3460, 36963309159943352, 231326973, 231326976, 3, 640x360 
0x12CB3460, 36963309160263248, 231327003, 231327005, 2, 640x360 
0x12CB3460, 36963309160582664, 231327033, 231327036, 3, 640x360 
0x12CB3460, 36963309161063760, 231327082, 231327085, 3, 640x360 
0x12CB3460, 36963309161382616, 231327113, 231327115, 2, 640x360 
0x12CB3460, 36963309161704592, 231327153, 231327156, 3, 640x360 
0x12CB3460, 36963309162024320, 231327183, 231327186, 3, 640x360 
0x12CB3460, 36963309162346072, 231327212, 231327216, 4, 640x360 
0x12CB3460, 36963309162663704, 231327243, 231327246, 3, 640x360 
0x12CB3460, 36963309162983104, 231327272, 231327276, 4, 640x360 
0x12CB3460, 36963309163301984, 231327304, 231327307, 3, 640x360 
0x12CB3460, 36963309163622352, 231327343, 231327348, 5, 640x360 
0x12CB3460, 36963309163944480, 231327377, 231327380, 3, 640x360 
0x12CB3460, 36963309164264080, 231327402, 231327405, 3, 640x360 
0x12CB3460, 36963309164584536, 231327433, 231327436, 3, 640x360 
0x12CB3460, 36963309165063944, 231327482, 231327486, 4, 640x360 
0x12CB3460, 36963309165384472, 231327513, 231327516, 3, 640x360 
0x12CB3460, 36963309165702304, 231327554, 231327557, 3, 640x360 
0x12CB3460, 36963309166023688, 231327575, 231327578, 3, 640x360 
0x12CB3460, 36963309166343280, 231327613, 231327617, 4, 640x360 
0x12CB3460, 36963309166665560, 231327643, 231327646, 3, 640x360 
0x12CB3460, 36963309166987432, 231327674, 231327677, 3, 640x360 
0x12CB3460, 36963309167306992, 231327704, 231327707, 3, 640x360 
0x12CB3460, 36963309167623568, 231327743, 231327747, 4, 640x360 
0x12CB3460, 36963309167944024, 231327772, 231327776, 4, 640x360 
0x12CB3460, 36963309168262560, 231327803, 231327806, 3, 640x360 
0x12CB3460, 36963309168742296, 231327852, 231327869, 17, 640x360 
0x12CB3460, 36963309169065304, 231327880, 231327883, 3, 640x360 
0x12CB3460, 36963309169383480, 231327913, 231327915, 2, 640x360 
0x12CB3460, 36963309169704120, 231327943, 231327961, 18, 640x360 
0x12CB3460, 36963309170024048, 231327983, 231327986, 3, 640x360 
0x12CB3460, 36963309170344136, 231328013, 231328015, 2, 640x360 
0x12CB3460, 36963309170664440, 231328042, 231328045, 3, 640x360 
0x12CB3460, 36963309170986232, 231328074, 231328077, 3, 640x360 
0x12CB3460, 36963309171302424, 231328102, 231328105, 3, 640x360 
0x12CB3460, 36963309171624016, 231328142, 231328147, 5, 640x360 
0x12CB3460, 36963309171944032, 231328173, 231328176, 3, 640x360 
0x12CB3460, 36963309172263400, 231328203, 231328207, 4, 640x360 
0x12CB3460, 36963309172746616, 231328253, 231328256, 3, 640x360 
0x12CB3460, 36963309173061936, 231328283, 231328287, 4, 640x360 
0x12CB3460, 36963309173382096, 231328313, 231328316, 3, 640x360 
0x12CB3460, 36963309173703408, 231328343, 231328348, 5, 640x360 
0x12CB3460, 36963309174023904, 231328375, 231328378, 3, 640x360 
0x12CB3460, 36963309174343752, 231328413, 231328416, 3, 640x360 
0x12CB3460, 36963309174663464, 231328443, 231328448, 5, 640x360 
0x12CB3460, 36963309174987192, 231328473, 231328477, 4, 640x360 
0x12CB3460, 36963309175303064, 231328503, 231328506, 3, 640x360 
0x12CB3460, 36963309175623368, 231328543, 231328547, 4, 640x360 
0x12CB3460, 36963309175944424, 231328572, 231328576, 4, 640x360 
0x12CB3460, 36963309176263848, 231328603, 231328605, 2, 640x360 
0x12CB3460, 36963309176744744, 231328653, 231328656, 3, 640x360 
0x12CB3460, 36963309177065848, 231328684, 231328688, 4, 640x360 
0x12CB3460, 36963309177388376, 231328714, 231328717, 3, 640x360 
0x12CB3460, 36963309177704280, 231328753, 231328755, 2, 640x360 
0x12CB3460, 36963309178022952, 231328782, 231328785, 3, 640x360 
0x12CB3460, 36963309178344744, 231328813, 231328816, 3, 640x360 
0x12CB3460, 36963309178665656, 231328843, 231328872, 29, 640x360 
0x12CB3460, 36963309178984088, 231328880, 231328883, 3, 640x360 
0x12CB3460, 36963309179303080, 231328913, 231328931, 18, 640x360 
0x12CB3460, 36963309179622704, 231328943, 231328945, 2, 640x360 
0x12CB3460, 36963309179945832, 231328973, 231328976, 3, 640x360 
0x12CB3460, 36963309180426928, 231329024, 231329027, 3, 640x360 
0x12CB3460, 36963309180744824, 231329053, 231329065, 12, 640x360 
0x12CB3460, 36963309181062200, 231329083, 231329086, 3, 640x360 
0x12CB3460, 36963309181383856, 231329113, 231329116, 3, 640x360 
0x12CB3460, 36963309181704000, 231329143, 231329146, 3, 640x360 
0x12CB3460, 36963309182022864, 231329183, 231329186, 3, 640x360 
0x12CB3460, 36963309182345176, 231329213, 231329216, 3, 640x360 
0x12CB3460, 36963309182663712, 231329242, 231329245, 3, 640x360 
0x12CB3460, 36963309182982272, 231329273, 231329275, 2, 640x360 
0x12CB3460, 36963309183303832, 231329303, 231329306, 3, 640x360 
0x12CB3460, 36963309183624616, 231329344, 231329347, 3, 640x360 
0x12CB3460, 36963309183951456, 231329386, 231329388, 2, 640x360 
0x12CB3460, 36963309184422000, 231329423, 231329426, 3, 640x360 
0x12CB3460, 36963309184743904, 231329453, 231329456, 3, 640x360 
0x12CB3460, 36963309185063272, 231329483, 231329485, 2, 640x360 
0x12CB3460, 36963309185384584, 231329513, 231329516, 3, 640x360 
0x12CB3460, 36963309185703448, 231329543, 231329548, 5, 640x360 
0x12CB3460, 36963309186025904, 231329583, 231329587, 4, 640x360 
0x12CB3460, 36963309186342592, 231329612, 231329614, 2, 640x360 
0x12CB3460, 36963309186662512, 231329643, 231329661, 18, 640x360 
0x12CB3460, 36963309186984304, 231329673, 231329676, 3, 640x360 
0x12CB3460, 36963309187303480, 231329703, 231329706, 3, 640x360 
0x12CB3460, 36963309187623544, 231329743, 231329746, 3, 640x360 
0x12CB3460, 36963309187943928, 231329773, 231329776, 3, 640x360 
0x12CB3460, 36963309188422248, 231329824, 231329827, 3, 640x360 
0x12CB3460, 36963309188743952, 231329890, 231329893, 3, 640x360 
0x12CB3460, 36963309189382624, 231329913, 231329915, 2, 640x360 
0x12CB3460, 36963309189704696, 231329954, 231329957, 3, 640x360 
0x12CB3460, 36963309190023392, 231329984, 231329987, 3, 640x360 
0x12CB3460, 36963309190342960, 231330013, 231330016, 3, 640x360 
0x12CB3460, 36963309190662856, 231330043, 231330046, 3, 640x360 
0x12CB3460, 36963309190982776, 231330073, 231330075, 2, 640x360 
0x12CB3460, 36963309191303192, 231330103, 231330106, 3, 640x360 
0x12CB3460, 36963309191623400, 231330143, 231330146, 3, 640x360 
0x12CB3460, 36963309192102816, 231330193, 231330197, 4, 640x360 
0x12CB3460, 36963309192423344, 231330224, 231330227, 3, 640x360 
0x12CB3460, 36963309192743840, 231330253, 231330255, 2, 640x360 
0x12CB3460, 36963309193064208, 231330283, 231330285, 2, 640x360 
0x12CB3460, 36963309193383520, 231330314, 231330316, 2, 640x360 
0x12CB3460, 36963309193704872, 231330371, 231330375, 4, 640x360 
0x12CB3460, 36963309194024504, 231330376, 231330379, 3, 640x360 
0x12CB3460, 36963309194342800, 231330412, 231330415, 3, 640x360 
0x12CB3460, 36963309194663560, 231330443, 231330446, 3, 640x360 
0x12CB3460, 36963309194983152, 231330472, 231330475, 3, 640x360 
0x12CB3460, 36963309195303384, 231330513, 231330516, 3, 640x360 
0x12CB3460, 36963309195626288, 231330543, 231330546, 3, 640x360 
0x12CB3460, 36963309196109016, 231330594, 231330600, 6, 640x360 
0x12CB3460, 36963309196424712, 231330622, 231330625, 3, 640x360 
0x12CB3460, 36963309196742736, 231330653, 231330655, 2, 640x360 
0x12CB3460, 36963309197065152, 231330683, 231330686, 3, 640x360 
0x12CB3460, 36963309197384648, 231330713, 231330717, 4, 640x360 
0x12CB3460, 36963309197703120, 231330753, 231330755, 2, 640x360 
0x12CB3460, 36963309198024424, 231330782, 231330786, 4, 640x360 
0x12CB3460, 36963309198342296, 231330813, 231330816, 3, 640x360 
0x12CB3460, 36963309198662464, 231330842, 231330845, 3, 640x360 
0x12CB3460, 36963309198983312, 231330873, 231330876, 3, 640x360 
0x12CB3460, 36963309199303880, 231330903, 231330906, 3, 640x360 
0x12CB3460, 36963309199785104, 231330953, 231330956, 3, 640x360 
0x12CB3460, 36963309200102984, 231330993, 231330997, 4, 640x360 
0x12CB3460, 36963309200422720, 231331025, 231331027, 2, 640x360 
0x12CB3460, 36963309200744224, 231331053, 231331058, 5, 640x360 
0x12CB3460, 36963309201063832, 231331084, 231331089, 5, 640x360 
0x12CB3460, 36963309201383968, 231331113, 231331116, 3, 640x360 
0x12CB3460, 36963309201704104, 231331143, 231331147, 4, 640x360 
0x12CB3460, 36963309202022664, 231331183, 231331186, 3, 640x360 
0x12CB3460, 36963309202343168, 231331214, 231331218, 4, 640x360 
0x12CB3460, 36963309202666976, 231331242, 231331246, 4, 640x360 
0x12CB3460, 36963309202982976, 231331273, 231331275, 2, 640x360 
0x12CB3460, 36963309203304000, 231331313, 231331315, 2, 640x360 
0x12CB3460, 36963309203784984, 231331357, 231331367, 10, 640x360 
0x12CB3460, 36963309204103152, 231331383, 231331395, 12, 640x360 
0x12CB3460, 36963309204424592, 231331423, 231331427, 4, 640x360 
0x12CB3460, 36963309204744128, 231331453, 231331456, 3, 640x360 
0x12CB3460, 36963309205064112, 231331482, 231331485, 3, 640x360 
0x12CB3460, 36963309205384760, 231331513, 231331516, 3, 640x360 
0x12CB3460, 36963309205705912, 231331553, 231331556, 3, 640x360 
0x12CB3460, 36963309206027232, 231331583, 231331586, 3, 640x360 
0x12CB3460, 36963309206345976, 231331613, 231331617, 4, 640x360 
0x12CB3460, 36963309206663808, 231331642, 231331646, 4, 640x360 
0x12CB3460, 36963309206984760, 231331674, 231331676, 2, 640x360 
0x12CB3460, 36963309207304384, 231331714, 231331717, 3, 640x360 
0x12CB3460, 36963309207784992, 231331753, 231331756, 3, 640x360 
0x12CB3460, 36963309208104232, 231331794, 231331797, 3, 640x360 
0x12CB3460, 36963309208422056, 231331823, 231331825, 2, 640x360 
0x12CB3460, 36963309208744040, 231331871, 231331874, 3, 640x360 
0x12CB3460, 36963309209062120, 231331883, 231331886, 3, 640x360 
0x12CB3460, 36963309209382232, 231331913, 231331915, 2, 640x360 
0x12CB3460, 36963309209704144, 231331943, 231331946, 3, 640x360 
0x12CB3460, 36963309210024200, 231331983, 231331986, 3, 640x360 
0x12CB3460, 36963309210343880, 231332013, 231332016, 3, 640x360 
0x12CB3460, 36963309210663112, 231332042, 231332045, 3, 640x360 
0x12CB3460, 36963309210983016, 231332073, 231332076, 3, 640x360 
0x12CB3460, 36963309211463784, 231332123, 231332126, 3, 640x360 
0x12CB3460, 36963309211785008, 231332153, 231332156, 3, 640x360 
0x12CB3460, 36963309212103808, 231332193, 231332197, 4, 640x360 
0x12CB3460, 36963309212425296, 231332223, 231332226, 3, 640x360 
0x12CB3460, 36963309212743424, 231332253, 231332256, 3, 640x360 
0x12CB3460, 36963309213063656, 231332283, 231332285, 2, 640x360 
0x12CB3460, 36963309213382856, 231332313, 231332316, 3, 640x360 
0x12CB3460, 36963309213704992, 231332381, 231332385, 4, 640x360 
0x12CB3460, 36963309214342984, 231332413, 231332415, 2, 640x360 
0x12CB3460, 36963309214663632, 231332443, 231332446, 3, 640x360 
0x12CB3460, 36963309214984672, 231332473, 231332476, 3, 640x360 
0x12CB3460, 36963309215466112, 231332523, 231332526, 3, 640x360 
0x12CB3460, 36963309215786584, 231332554, 231332557, 3, 640x360 
0x12CB3460, 36963309216105496, 231332593, 231332596, 3, 640x360 
0x12CB3460, 36963309216424048, 231332624, 231332627, 3, 640x360 
0x12CB3460, 36963309216745984, 231332654, 231332657, 3, 640x360 
0x12CB3460, 36963309217065784, 231332683, 231332686, 3, 640x360 
0x12CB3460, 36963309217388000, 231332715, 231332718, 3, 640x360 
0x12CB3460, 36963309217702024, 231332753, 231332756, 3, 640x360 
0x12CB3460, 36963309218023696, 231332782, 231332785, 3, 640x360 
0x12CB3460, 36963309218342264, 231332813, 231332816, 3, 640x360 
0x12CB3460, 36963309218664264, 231332842, 231332845, 3, 640x360 
0x12CB3460, 36963309218986368, 231332877, 231332880, 3, 640x360 
0x12CB3460, 36963309219463952, 231332923, 231332926, 3, 640x360 
0x12CB3460, 36963309219783728, 231332953, 231332956, 3, 640x360 
0x12CB3460, 36963309220104144, 231332993, 231332996, 3, 640x360 
0x12CB3460, 36963309220424864, 231333024, 231333027, 3, 640x360 
0x12CB3460, 36963309220743888, 231333053, 231333056, 3, 640x360 
0x12CB3460, 36963309221063112, 231333082, 231333100, 18, 640x360 
0x12CB3460, 36963309221382456, 231333113, 231333115, 2, 640x360 
0x12CB3460, 36963309221703600, 231333143, 231333146, 3, 640x360 
0x12CB3460, 36963309222023624, 231333182, 231333185, 3, 640x360 
0x12CB3460, 36963309222344744, 231333213, 231333216, 3, 640x360 
0x12CB3460, 36963309222663160, 231333243, 231333246, 3, 640x360 
0x12CB3460, 36963309223142520, 231333293, 231333296, 3, 640x360 
0x12CB3460, 36963309223463776, 231333322, 231333325, 3, 640x360 
0x12CB3460, 36963309223783744, 231333371, 231333374, 3, 640x360 
0x12CB3460, 36963309224101752, 231333383, 231333386, 3, 640x360 
0x12CB3460, 36963309224422704, 231333423, 231333426, 3, 640x360 
0x12CB3460, 36963309224743720, 231333453, 231333456, 3, 640x360 
0x12CB3460, 36963309225063136, 231333483, 231333486, 3, 640x360 
0x12CB3460, 36963309225382368, 231333513, 231333516, 3, 640x360 
0x12CB3460, 36963309225704024, 231333553, 231333556, 3, 640x360 
0x12CB3460, 36963309226026152, 231333582, 231333586, 4, 640x360 
0x12CB3460, 36963309226343872, 231333613, 231333616, 3, 640x360 
0x12CB3460, 36963309226668408, 231333644, 231333647, 3, 640x360 
0x12CB3460, 36963309227146120, 231333695, 231333698, 3, 640x360 
0x12CB3460, 36963309227466664, 231333723, 231333726, 3, 640x360 
0x12CB3460, 36963309227781752, 231333753, 231333755, 2, 640x360 
0x12CB3460, 36963309228104080, 231333793, 231333796, 3, 640x360 
0x12CB3460, 36963309228425000, 231333823, 231333826, 3, 640x360 
0x12CB3460, 36963309228746160, 231333853, 231333856, 3, 640x360 
0x12CB3460, 36963309229065728, 231333888, 231333891, 3, 640x360 
0x12CB3460, 36963309229381792, 231333913, 231333916, 3, 640x360 
0x12CB3460, 36963309229703280, 231333943, 231333945, 2, 640x360 
0x12CB3460, 36963309230023744, 231333983, 231333985, 2, 640x360 
0x12CB3460, 36963309230345176, 231334013, 231334016, 3, 640x360 
0x12CB3460, 36963309230664712, 231334043, 231334047, 4, 640x360 
0x12CB3460, 36963309231141664, 231334093, 231334095, 2, 640x360 
0x12CB3460, 36963309231462304, 231334123, 231334126, 3, 640x360 
0x12CB3460, 36963309231783064, 231334153, 231334155, 2, 640x360 
0x12CB3460, 36963309232103440, 231334193, 231334195, 2, 640x360 
0x12CB3460, 36963309232422624, 231334216, 231334220, 4, 640x360 
0x12CB3460, 36963309232743336, 231334253, 231334256, 3, 640x360 
0x12CB3460, 36963309233062464, 231334283, 231334285, 2, 640x360 
0x12CB3460, 36963309233382072, 231334313, 231334316, 3, 640x360 
0x12CB3460, 36963309233703528, 231334376, 231334380, 4, 640x360 
0x12CB3460, 36963309234343464, 231334412, 231334415, 3, 640x360 
0x12CB3460, 36963309234823584, 231334464, 231334466, 2, 640x360 
0x12CB3460, 36963309235142368, 231334493, 231334496, 3, 640x360 
0x12CB3460, 36963309235464080, 231334524, 231334527, 3, 640x360 
0x12CB3460, 36963309235784200, 231334554, 231334557, 3, 640x360 
0x12CB3460, 36963309236101936, 231334593, 231334595, 2, 640x360 
0x12CB3460, 36963309236422480, 231334624, 231334626, 2, 640x360 
0x12CB3460, 36963309236745248, 231334653, 231334656, 3, 640x360 
0x12CB3460, 36963309237063480, 231334682, 231334685, 3, 640x360 
0x12CB3460, 36963309237383176, 231334714, 231334717, 3, 640x360 
0x12CB3460, 36963309237702944, 231334744, 231334747, 3, 640x360 
0x12CB3460, 36963309238023256, 231334783, 231334786, 3, 640x360 
0x12CB3460, 36963309238342368, 231334812, 231334816, 4, 640x360 
0x12CB3460, 36963309238822664, 231334874, 231334893, 19, 640x360 
0x12CB3460, 36963309239143688, 231334893, 231334896, 3, 640x360 
0x12CB3460, 36963309239461792, 231334923, 231334926, 3, 640x360 
0x12CB3460, 36963309239781960, 231334953, 231334956, 3, 640x360 
0x12CB3460, 36963309240102712, 231334993, 231334996, 3, 640x360 
0x12CB3460, 36963309240422056, 231335022, 231335025, 3, 640x360 
0x12CB3460, 36963309240743816, 231335053, 231335056, 3, 640x360 
0x12CB3460, 36963309241062904, 231335082, 231335085, 3, 640x360 
0x12CB3460, 36963309241381760, 231335113, 231335116, 3, 640x360 
0x12CB3460, 36963309241703160, 231335153, 231335155, 2, 640x360 
0x12CB3460, 36963309242021976, 231335183, 231335186, 3, 640x360 
0x12CB3460, 36963309242502880, 231335224, 231335227, 3, 640x360 
0x12CB3460, 36963309242821696, 231335264, 231335267, 3, 640x360 
0x12CB3460, 36963309243143440, 231335292, 231335295, 3, 640x360 
0x12CB3460, 36963309243463504, 231335323, 231335326, 3, 640x360 
0x12CB3460, 36963309243783728, 231335382, 231335405, 23, 640x360 
0x12CB3460, 36963309244470088, 231335427, 231335431, 4, 640x360 
0x12CB3460, 36963309244745520, 231335453, 231335455, 2, 640x360 
0x12CB3460, 36963309245065480, 231335483, 231335486, 3, 640x360 
0x12CB3460, 36963309245382488, 231335512, 231335515, 3, 640x360 
0x12CB3460, 36963309245703256, 231335543, 231335546, 3, 640x360 
0x12CB3460, 36963309246026624, 231335583, 231335586, 3, 640x360 
0x12CB3460, 36963309246502056, 231335623, 231335627, 4, 640x360 
0x12CB3460, 36963309246824240, 231335664, 231335667, 3, 640x360 
0x12CB3460, 36963309247146200, 231335693, 231335696, 3, 640x360 
0x12CB3460, 36963309247472912, 231335724, 231335729, 5, 640x360 
0x12CB3460, 36963309247784224, 231335753, 231335756, 3, 640x360 
0x12CB3460, 36963309248103600, 231335783, 231335786, 3, 640x360 
0x12CB3460, 36963309248428736, 231335823, 231335827, 4, 640x360 
0x12CB3460, 36963309248742008, 231335883, 231335886, 3, 640x360 
0x12CB3460, 36963309249382560, 231335912, 231335915, 3, 640x360 
0x12CB3460, 36963309249703232, 231335952, 231335955, 3, 640x360 
0x12CB3460, 36963309250022888, 231335983, 231335986, 3, 640x360 
0x12CB3460, 36963309250502064, 231336033, 231336036, 3, 640x360 
0x12CB3460, 36963309250821960, 231336062, 231336065, 3, 640x360 
0x12CB3460, 36963309251141960, 231336093, 231336096, 3, 640x360 
0x12CB3460, 36963309251462968, 231336123, 231336125, 2, 640x360 
0x12CB3460, 36963309251781760, 231336153, 231336155, 2, 640x360 
0x12CB3460, 36963309252101408, 231336193, 231336196, 3, 640x360 
0x12CB3460, 36963309252425008, 231336222, 231336226, 4, 640x360 
0x12CB3460, 36963309252742608, 231336253, 231336256, 3, 640x360 
0x12CB3460, 36963309253062416, 231336283, 231336286, 3, 640x360 
0x12CB3460, 36963309253382696, 231336312, 231336316, 4, 640x360 
0x12CB3460, 36963309253702976, 231336343, 231336367, 24, 640x360 
0x12CB3460, 36963309254182176, 231336393, 231336396, 3, 640x360 
0x12CB3460, 36963309254502032, 231336423, 231336426, 3, 640x360 
0x12CB3460, 36963309254821872, 231336463, 231336466, 3, 640x360 
0x12CB3460, 36963309255141312, 231336493, 231336496, 3, 640x360 
0x12CB3460, 36963309255463480, 231336524, 231336530, 6, 640x360 
0x12CB3460, 36963309255782560, 231336553, 231336556, 3, 640x360 
0x12CB3460, 36963309256103736, 231336583, 231336586, 3, 640x360 
0x12CB3460, 36963309256422464, 231336625, 231336628, 3, 640x360 
0x12CB3460, 36963309256742232, 231336652, 231336655, 3, 640x360 
0x12CB3460, 36963309257062936, 231336683, 231336686, 3, 640x360 
0x12CB3460, 36963309257384096, 231336713, 231336716, 3, 640x360 
0x12CB3460, 36963309257703736, 231336744, 231336748, 4, 640x360 
0x12CB3460, 36963309258181424, 231336793, 231336796, 3, 640x360 
0x12CB3460, 36963309258501488, 231336833, 231336836, 3, 640x360 
0x12CB3460, 36963309259042872, 231336883, 231336886, 3, 640x360 
0x12CB3460, 36963309259143144, 231336893, 231336897, 4, 640x360 
0x12CB3460, 36963309259462416, 231336922, 231336925, 3, 640x360 
0x12CB3460, 36963309259783000, 231336953, 231336956, 3, 640x360 
0x12CB3460, 36963309260102176, 231336993, 231336995, 2, 640x360 
0x12CB3460, 36963309260421952, 231337023, 231337026, 3, 640x360 
0x12CB3460, 36963309260743024, 231337053, 231337057, 4, 640x360 
0x12CB3460, 36963309261062680, 231337083, 231337086, 3, 640x360 
0x12CB3460, 36963309261383272, 231337113, 231337115, 2, 640x360 
0x12CB3460, 36963309262183368, 231337193, 231337196, 3, 640x360 
0x12CB3460, 36963309262503600, 231337233, 231337236, 3, 640x360 
0x12CB3460, 36963309262821640, 231337263, 231337266, 3, 640x360 
0x12CB3460, 36963309263141824, 231337292, 231337295, 3, 640x360 
0x12CB3460, 36963309263462928, 231337323, 231337325, 2, 640x360 
0x12CB3460, 36963309263907912, 231337374, 231337376, 2, 640x360 
0x12CB3460, 36963309264103000, 231337383, 231337386, 3, 640x360 
0x12CB3460, 36963309264422768, 231337423, 231337426, 3, 640x360 
0x12CB3460, 36963309264743784, 231337452, 231337455, 3, 640x360 
0x12CB3460, 36963309265064112, 231337483, 231337486, 3, 640x360 
0x12CB3460, 36963309265384656, 231337513, 231337516, 3, 640x360 
0x12CB3460, 36963309265863472, 231337563, 231337567, 4, 640x360 
0x12CB3460, 36963309266182272, 231337593, 231337596, 3, 640x360 
0x12CB3460, 36963309266503424, 231337633, 231337636, 3, 640x360 
0x12CB3460, 36963309266822912, 231337663, 231337666, 3, 640x360 
0x12CB3460, 36963309267145760, 231337693, 231337697, 4, 640x360 
0x12CB3460, 36963309267466936, 231337723, 231337726, 3, 640x360 
0x12CB3460, 36963309267783848, 231337754, 231337756, 2, 640x360 
0x12CB3460, 36963309268102856, 231337793, 231337795, 2, 640x360 
0x12CB3460, 36963309268424400, 231337823, 231337825, 2, 640x360 
0x12CB3460, 36963309269067264, 231337883, 231337885, 2, 640x360 
0x12CB3460, 36963309269382128, 231337913, 231337917, 4, 640x360 
0x12CB3460, 36963309269863208, 231337963, 231337965, 2, 640x360 
0x12CB3460, 36963309270184208, 231337993, 231337995, 2, 640x360 
0x12CB3460, 36963309270503184, 231338033, 231338036, 3, 640x360 
0x12CB3460, 36963309270821808, 231338062, 231338065, 3, 640x360 
0x12CB3460, 36963309271142616, 231338093, 231338095, 2, 640x360 
0x12CB3460, 36963309271461640, 231338123, 231338127, 4, 640x360 
0x12CB3460, 36963309271782768, 231338153, 231338155, 2, 640x360 
0x12CB3460, 36963309272102536, 231338193, 231338197, 4, 640x360 
0x12CB3460, 36963309272427704, 231338217, 231338220, 3, 640x360 
0x12CB3460, 36963309272741872, 231338253, 231338257, 4, 640x360 
0x12CB3460, 36963309273061944, 231338283, 231338286, 3, 640x360 
0x12CB3460, 36963309273382728, 231338312, 231338316, 4, 640x360 
0x12CB3460, 36963309273867736, 231338376, 231338383, 7, 640x360 
0x12CB3460, 36963309274181968, 231338393, 231338396, 3, 640x360 
0x12CB3460, 36963309274502472, 231338423, 231338431, 8, 640x360 
0x12CB3460, 36963309274824824, 231338463, 231338466, 3, 640x360 
0x12CB3460, 36963309275144048, 231338492, 231338496, 4, 640x360 
0x12CB3460, 36963309275462280, 231338522, 231338525, 3, 640x360 
0x12CB3460, 36963309275785088, 231338553, 231338556, 3, 640x360 
0x12CB3460, 36963309276101856, 231338584, 231338587, 3, 640x360 
0x12CB3460, 36963309276421576, 231338622, 231338626, 4, 640x360 
0x12CB3460, 36963309276742032, 231338653, 231338656, 3, 640x360 
0x12CB3460, 36963309277062936, 231338682, 231338685, 3, 640x360 
0x12CB3460, 36963309277542504, 231338734, 231338736, 2, 640x360 
0x12CB3460, 36963309277862880, 231338762, 231338765, 3, 640x360 
0x12CB3460, 36963309278182856, 231338793, 231338796, 3, 640x360 
0x12CB3460, 36963309278503080, 231338833, 231338836, 3, 640x360 
0x12CB3460, 36963309278822312, 231338888, 231338891, 3, 640x360 
0x12CB3460, 36963309279462864, 231338924, 231338928, 4, 640x360 
0x12CB3460, 36963309279783752, 231338953, 231338956, 3, 640x360 
0x12CB3460, 36963309280103632, 231338993, 231338996, 3, 640x360 
0x12CB3460, 36963309280422408, 231339023, 231339026, 3, 640x360 
0x12CB3460, 36963309280743128, 231339052, 231339055, 3, 640x360 
0x12CB3460, 36963309281062856, 231339083, 231339085, 2, 640x360 
0x12CB3460, 36963309281541528, 231339133, 231339135, 2, 640x360 
0x12CB3460, 36963309281861056, 231339163, 231339165, 2, 640x360 
0x12CB3460, 36963309282182864, 231339193, 231339196, 3, 640x360 
0x12CB3460, 36963309282503200, 231339224, 231339227, 3, 640x360 
0x12CB3460, 36963309282822528, 231339263, 231339266, 3, 640x360 
0x12CB3460, 36963309283143224, 231339292, 231339295, 3, 640x360 
0x12CB3460, 36963309283462104, 231339323, 231339326, 3, 640x360 
0x12CB3460, 36963309283783056, 231339378, 231339381, 3, 640x360 
0x12CB3460, 36963309284102768, 231339383, 231339386, 3, 640x360 
0x12CB3460, 36963309284421912, 231339424, 231339427, 3, 640x360 
0x12CB3460, 36963309284742448, 231339453, 231339455, 2, 640x360 
0x12CB3460, 36963309285223248, 231339503, 231339506, 3, 640x360 
0x12CB3460, 36963309285543944, 231339533, 231339536, 3, 640x360 
0x12CB3460, 36963309285863464, 231339562, 231339565, 3, 640x360 
0x12CB3460, 36963309286184672, 231339593, 231339596, 3, 640x360 
0x12CB3460, 36963309286502680, 231339624, 231339626, 2, 640x360 
0x12CB3460, 36963309286821840, 231339663, 231339666, 3, 640x360 
0x12CB3460, 36963309287143264, 231339693, 231339696, 3, 640x360 
0x12CB3460, 36963309287461776, 231339724, 231339727, 3, 640x360 
0x12CB3460, 36963309287781608, 231339754, 231339757, 3, 640x360 
0x12CB3460, 36963309288102672, 231339793, 231339796, 3, 640x360 
0x12CB3460, 36963309288424112, 231339823, 231339826, 3, 640x360 
0x12CB3460, 36963309288743880, 231339852, 231339875, 23, 640x360 
0x12CB3460, 36963309289222272, 231339903, 231339906, 3, 640x360 
0x12CB3460, 36963309289543056, 231339933, 231339937, 4, 640x360 
0x12CB3460, 36963309289862456, 231339962, 231339965, 3, 640x360 
0x12CB3460, 36963309290182952, 231339992, 231339995, 3, 640x360 
0x12CB3460, 36963309290503760, 231340034, 231340051, 17, 640x360 
0x12CB3460, 36963309290822304, 231340056, 231340059, 3, 640x360 
0x12CB3460, 36963309291141744, 231340093, 231340099, 6, 640x360 
0x12CB3460, 36963309291460984, 231340122, 231340125, 3, 640x360 
0x12CB3460, 36963309291783216, 231340152, 231340156, 4, 640x360 
0x12CB3460, 36963309292102080, 231340193, 231340196, 3, 640x360 
0x12CB3460, 36963309292427784, 231340217, 231340221, 4, 640x360 
0x12CB3460, 36963309292741872, 231340253, 231340256, 3, 640x360 
0x12CB3460, 36963309293222880, 231340302, 231340306, 4, 640x360 
0x12CB3460, 36963309293543040, 231340333, 231340335, 2, 640x360 
0x12CB3460, 36963309293864624, 231340381, 231340384, 3, 640x360 
0x12CB3460, 36963309294183872, 231340393, 231340396, 3, 640x360 
0x12CB3460, 36963309294502544, 231340423, 231340426, 3, 640x360 
0x12CB3460, 36963309294822104, 231340462, 231340465, 3, 640x360 
0x12CB3460, 36963309295142808, 231340493, 231340496, 3, 640x360 
0x12CB3460, 36963309295461696, 231340523, 231340526, 3, 640x360 
0x12CB3460, 36963309295783176, 231340552, 231340555, 3, 640x360 
0x12CB3460, 36963309296101784, 231340583, 231340586, 3, 640x360 
0x12CB3460, 36963309296421968, 231340623, 231340627, 4, 640x360 
0x12CB3460, 36963309296902672, 231340663, 231340665, 2, 640x360 
0x12CB3460, 36963309297221648, 231340704, 231340707, 3, 640x360 
0x12CB3460, 36963309297541136, 231340733, 231340735, 2, 640x360 
0x12CB3460, 36963309297863000, 231340763, 231340766, 3, 640x360 
0x12CB3460, 36963309298183480, 231340793, 231340795, 2, 640x360 
0x12CB3460, 36963309298504168, 231340833, 231340836, 3, 640x360 
0x12CB3460, 36963309298822776, 231340873, 231340876, 3, 640x360 
0x12CB3460, 36963309299142296, 231340893, 231340895, 2, 640x360 
0x12CB3460, 36963309299461056, 231340922, 231340926, 4, 640x360 
0x12CB3460, 36963309299783704, 231340953, 231340956, 3, 640x360 
0x12CB3460, 36963309300102072, 231340984, 231340988, 4, 640x360 
0x12CB3460, 36963309300421912, 231341022, 231341027, 5, 640x360 
0x12CB3460, 36963309300908312, 231341066, 231341069, 3, 640x360 
0x12CB3460, 36963309301221336, 231341102, 231341106, 4, 640x360 
0x12CB3460, 36963309301544032, 231341132, 231341135, 3, 640x360 
0x12CB3460, 36963309301863304, 231341163, 231341166, 3, 640x360 
0x12CB3460, 36963309302181584, 231341193, 231341195, 2, 640x360 
0x12CB3460, 36963309302502432, 231341223, 231341227, 4, 640x360 
0x12CB3460, 36963309302822184, 231341263, 231341267, 4, 640x360 
0x12CB3460, 36963309303142008, 231341292, 231341295, 3, 640x360 
0x12CB3460, 36963309303462416, 231341322, 231341327, 5, 640x360 
0x12CB3460, 36963309303785032, 231341386, 231341389, 3, 640x360 
0x12CB3460, 36963309304424856, 231341422, 231341426, 4, 640x360 
0x12CB3460, 36963309304902976, 231341464, 231341467, 3, 640x360 
0x12CB3460, 36963309305228240, 231341503, 231341506, 3, 640x360 
0x12CB3460, 36963309305542672, 231341533, 231341535, 2, 640x360 
0x12CB3460, 36963309305862832, 231341563, 231341568, 5, 640x360 
0x12CB3460, 36963309306182424, 231341593, 231341595, 2, 640x360 
0x12CB3460, 36963309306502976, 231341632, 231341635, 3, 640x360 
0x12CB3460, 36963309306823336, 231341663, 231341666, 3, 640x360 
0x12CB3460, 36963309307143920, 231341692, 231341696, 4, 640x360 
0x12CB3460, 36963309307466368, 231341725, 231341728, 3, 640x360 
0x12CB3460, 36963309307782048, 231341754, 231341757, 3, 640x360 
0x12CB3460, 36963309308103600, 231341793, 231341796, 3, 640x360 
0x12CB3460, 36963309308583264, 231341834, 231341837, 3, 640x360 
0x12CB3460, 36963309308902864, 231341884, 231341887, 3, 640x360 
0x12CB3460, 36963309309221000, 231341903, 231341906, 3, 640x360 
0x12CB3460, 36963309309541640, 231341933, 231341936, 3, 640x360 
0x12CB3460, 36963309309862152, 231341963, 231341965, 2, 640x360 
0x12CB3460, 36963309310182472, 231341992, 231341996, 4, 640x360 
0x12CB3460, 36963309310501792, 231342024, 231342028, 4, 640x360 
0x12CB3460, 36963309310821400, 231342063, 231342066, 3, 640x360 
0x12CB3460, 36963309311142824, 231342092, 231342098, 6, 640x360 
0x12CB3460, 36963309311461592, 231342123, 231342141, 18, 640x360 
0x12CB3460, 36963309311782768, 231342152, 231342155, 3, 640x360 
0x12CB3460, 36963309312102616, 231342183, 231342187, 4, 640x360 
0x12CB3460, 36963309312582360, 231342233, 231342236, 3, 640x360 
0x12CB3460, 36963309312902280, 231342264, 231342269, 5, 640x360 
0x12CB3460, 36963309313223248, 231342302, 231342305, 3, 640x360 
0x12CB3460, 36963309313542160, 231342333, 231342335, 2, 640x360 
0x12CB3460, 36963309313862368, 231342367, 231342370, 3, 640x360 
0x12CB3460, 36963309314182592, 231342393, 231342397, 4, 640x360 
0x12CB3460, 36963309314502080, 231342423, 231342427, 4, 640x360 
0x12CB3460, 36963309314823984, 231342463, 231342467, 4, 640x360 
0x12CB3460, 36963309315141408, 231342492, 231342495, 3, 640x360 
0x12CB3460, 36963309315463200, 231342522, 231342526, 4, 640x360 
0x12CB3460, 36963309315782416, 231342553, 231342556, 3, 640x360 
0x12CB3460, 36963309316264256, 231342603, 231342605, 2, 640x360 
0x12CB3460, 36963309316582496, 231342633, 231342636, 3, 640x360 
0x12CB3460, 36963309316904416, 231342664, 231342666, 2, 640x360 
0x12CB3460, 36963309317221688, 231342702, 231342705, 3, 640x360 
0x12CB3460, 36963309317542312, 231342733, 231342735, 2, 640x360 
0x12CB3460, 36963309317863488, 231342763, 231342767, 4, 640x360 
0x12CB3460, 36963309318181944, 231342792, 231342796, 4, 640x360 
0x12CB3460, 36963309318501728, 231342824, 231342827, 3, 640x360 
0x12CB3460, 36963309318823592, 231342878, 231342882, 4, 640x360 
0x12CB3460, 36963309319141592, 231342893, 231342895, 2, 640x360 
0x12CB3460, 36963309319461456, 231342923, 231342927, 4, 640x360 
0x12CB3460, 36963309319785456, 231342952, 231342956, 4, 640x360 
0x12CB3460, 36963309320262000, 231343004, 231343007, 3, 640x360 
0x12CB3460, 36963309320583528, 231343034, 231343037, 3, 640x360 
0x12CB3460, 36963309320903216, 231343073, 231343076, 3, 640x360 
0x12CB3460, 36963309321222008, 231343102, 231343105, 3, 640x360 
0x12CB3460, 36963309321542920, 231343133, 231343149, 16, 640x360 
0x12CB3460, 36963309321862880, 231343162, 231343165, 3, 640x360 
0x12CB3460, 36963309322182832, 231343193, 231343195, 2, 640x360 
0x12CB3460, 36963309322503400, 231343224, 231343228, 4, 640x360 
0x12CB3460, 36963309322822808, 231343263, 231343266, 3, 640x360 
0x12CB3460, 36963309323143056, 231343293, 231343296, 3, 640x360 
0x12CB3460, 36963309323461552, 231343323, 231343326, 3, 640x360 
0x12CB3460, 36963309323785072, 231343376, 231343379, 3, 640x360 
0x12CB3460, 36963309324263808, 231343402, 231343405, 3, 640x360 
0x12CB3460, 36963309324583056, 231343434, 231343437, 3, 640x360 
0x12CB3460, 36963309324903504, 231343464, 231343467, 3, 640x360 
0x12CB3460, 36963309325222648, 231343502, 231343505, 3, 640x360 
0x12CB3460, 36963309325545928, 231343533, 231343536, 3, 640x360 
0x12CB3460, 36963309325867208, 231343563, 231343567, 4, 640x360 
0x12CB3460, 36963309326183488, 231343593, 231343600, 7, 640x360 
0x12CB3460, 36963309326502728, 231343624, 231343628, 4, 640x360 
0x12CB3460, 36963309326823320, 231343664, 231343667, 3, 640x360 
0x12CB3460, 36963309327142584, 231343692, 231343695, 3, 640x360 
0x12CB3460, 36963309327465312, 231343724, 231343728, 4, 640x360 
0x12CB3460, 36963309327941424, 231343773, 231343778, 5, 640x360 
0x12CB3460, 36963309328261480, 231343803, 231343810, 7, 640x360 
0x12CB3460, 36963309328581544, 231343833, 231343839, 6, 640x360 
0x12CB3460, 36963309328902032, 231343875, 231343878, 3, 640x360 
0x12CB3460, 36963309329221648, 231343902, 231343905, 3, 640x360 
0x12CB3460, 36963309329543488, 231343933, 231343936, 3, 640x360 
0x12CB3460, 36963309329862528, 231343963, 231343967, 4, 640x360 
0x12CB3460, 36963309330181648, 231343993, 231343995, 2, 640x360 
0x12CB3460, 36963309330502104, 231344023, 231344026, 3, 640x360 
0x12CB3460, 36963309330822592, 231344063, 231344066, 3, 640x360 
0x12CB3460, 36963309331143232, 231344093, 231344096, 3, 640x360 
0x12CB3460, 36963309331463384, 231344123, 231344125, 2, 640x360 
0x12CB3460, 36963309331941008, 231344173, 231344190, 17, 640x360 
0x12CB3460, 36963309332263632, 231344202, 231344205, 3, 640x360 
0x12CB3460, 36963309332582488, 231344233, 231344236, 3, 640x360 
0x12CB3460, 36963309332902320, 231344263, 231344266, 3, 640x360 
0x12CB3460, 36963309333222872, 231344303, 231344306, 3, 640x360 
0x12CB3460, 36963309333543016, 231344332, 231344345, 13, 640x360 
0x12CB3460, 36963309333865096, 231344384, 231344386, 2, 640x360 
0x12CB3460, 36963309334181920, 231344393, 231344395, 2, 640x360 
0x12CB3460, 36963309334503240, 231344423, 231344426, 3, 640x360 
0x12CB3460, 36963309334821880, 231344463, 231344466, 3, 640x360 
0x12CB3460, 36963309335141992, 231344493, 231344496, 3, 640x360 
0x12CB3460, 36963309335462440, 231344522, 231344525, 3, 640x360 
0x12CB3460, 36963309335941040, 231344573, 231344576, 3, 640x360 
0x12CB3460, 36963309336261264, 231344603, 231344606, 3, 640x360 
0x12CB3460, 36963309336582424, 231344632, 231344636, 4, 640x360 
0x12CB3460, 36963309336905784, 231344664, 231344667, 3, 640x360 
0x12CB3460, 36963309337222384, 231344703, 231344706, 3, 640x360 
0x12CB3460, 36963309337542264, 231344733, 231344735, 2, 640x360 
0x12CB3460, 36963309337862264, 231344763, 231344765, 2, 640x360 
0x12CB3460, 36963309338181040, 231344792, 231344795, 3, 640x360 
0x12CB3460, 36963309338502928, 231344824, 231344828, 4, 640x360 
0x12CB3460, 36963309338824528, 231344877, 231344881, 4, 640x360 
0x12CB3460, 36963309339142392, 231344892, 231344895, 3, 640x360 
0x12CB3460, 36963309339621136, 231344943, 231344946, 3, 640x360 
0x12CB3460, 36963309339942056, 231344973, 231344976, 3, 640x360 
0x12CB3460, 36963309340261672, 231345002, 231345020, 18, 640x360 
0x12CB3460, 36963309340584560, 231345033, 231345037, 4, 640x360 
0x12CB3460, 36963309340901576, 231345063, 231345067, 4, 640x360 
0x12CB3460, 36963309341221456, 231345103, 231345107, 4, 640x360 
0x12CB3460, 36963309341542864, 231345132, 231345135, 3, 640x360 
0x12CB3460, 36963309341864064, 231345163, 231345165, 2, 640x360 
0x12CB3460, 36963309342183520, 231345192, 231345196, 4, 640x360 
0x12CB3460, 36963309342506488, 231345225, 231345229, 4, 640x360 
0x12CB3460, 36963309342822328, 231345263, 231345266, 3, 640x360 
0x12CB3460, 36963309343145160, 231345292, 231345295, 3, 640x360 
0x12CB3460, 36963309343622408, 231345343, 231345346, 3, 640x360 
0x12CB3460, 36963309343941568, 231345371, 231345375, 4, 640x360 
0x12CB3460, 36963309344262720, 231345403, 231345405, 2, 640x360 
0x12CB3460, 36963309344582400, 231345432, 231345435, 3, 640x360 
0x12CB3460, 36963309344902872, 231345463, 231345466, 3, 640x360 
0x12CB3460, 36963309345221888, 231345503, 231345505, 2, 640x360 
0x12CB3460, 36963309345541376, 231345532, 231345535, 3, 640x360 
0x12CB3460, 36963309345861208, 231345563, 231345565, 2, 640x360 
0x12CB3460, 36963309346182168, 231345593, 231345597, 4, 640x360 
0x12CB3460, 36963309346501256, 231345623, 231345627, 4, 640x360 
0x12CB3460, 36963309346823192, 231345663, 231345665, 2, 640x360 
0x12CB3460, 36963309347142832, 231345693, 231345695, 2, 640x360 
0x12CB3460, 36963309347620784, 231345743, 231345746, 3, 640x360 
0x12CB3460, 36963309347941768, 231345773, 231345775, 2, 640x360 
0x12CB3460, 36963309348262224, 231345803, 231345806, 3, 640x360 
0x12CB3460, 36963309348584000, 231345834, 231345837, 3, 640x360 
0x12CB3460, 36963309348904928, 231345868, 231345870, 2, 640x360 
0x12CB3460, 36963309349221976, 231345902, 231345905, 3, 640x360 
0x12CB3460, 36963309349542976, 231345933, 231345937, 4, 640x360 
0x12CB3460, 36963309349861760, 231345963, 231345966, 3, 640x360 
0x12CB3460, 36963309350182968, 231345994, 231345997, 3, 640x360 
0x12CB3460, 36963309350506568, 231346033, 231346036, 3, 640x360 
0x12CB3460, 36963309350822808, 231346063, 231346066, 3, 640x360 
0x12CB3460, 36963309351302168, 231346104, 231346107, 3, 640x360 
0x12CB3460, 36963309351622120, 231346143, 231346150, 7, 640x360 
0x12CB3460, 36963309351942968, 231346173, 231346176, 3, 640x360 
0x12CB3460, 36963309352261920, 231346203, 231346206, 3, 640x360 
0x12CB3460, 36963309352582768, 231346234, 231346236, 2, 640x360 
0x12CB3460, 36963309352901216, 231346263, 231346267, 4, 640x360 
0x12CB3460, 36963309353222640, 231346302, 231346305, 3, 640x360 
0x12CB3460, 36963309353542008, 231346333, 231346336, 3, 640x360 
0x12CB3460, 36963309353864520, 231346375, 231346378, 3, 640x360 
0x12CB3460, 36963309354181240, 231346394, 231346397, 3, 640x360 
0x12CB3460, 36963309354502704, 231346424, 231346428, 4, 640x360 
0x12CB3460, 36963309354822840, 231346463, 231346467, 4, 640x360 
0x12CB3460, 36963309355304592, 231346513, 231346525, 12, 640x360 
0x12CB3460, 36963309355623472, 231346543, 231346548, 5, 640x360 
0x12CB3460, 36963309355943920, 231346574, 231346578, 4, 640x360 
0x12CB3460, 36963309356263608, 231346603, 231346606, 3, 640x360 
0x12CB3460, 36963309356583896, 231346633, 231346636, 3, 640x360 
0x12CB3460, 36963309356904480, 231346673, 231346676, 3, 640x360 
0x12CB3460, 36963309357224832, 231346702, 231346705, 3, 640x360 
0x12CB3460, 36963309357542920, 231346733, 231346735, 2, 640x360 
0x12CB3460, 36963309357863248, 231346762, 231346765, 3, 640x360 
0x12CB3460, 36963309358182664, 231346793, 231346796, 3, 640x360 
0x12CB3460, 36963309358502368, 231346824, 231346828, 4, 640x360 
0x12CB3460, 36963309358980568, 231346874, 231346878, 4, 640x360 
0x12CB3460, 36963309359302264, 231346914, 231346917, 3, 640x360 
0x12CB3460, 36963309359624216, 231346943, 231346945, 2, 640x360 
0x12CB3460, 36963309359942392, 231346972, 231346975, 3, 640x360 
0x12CB3460, 36963309360262200, 231347002, 231347005, 3, 640x360 
0x12CB3460, 36963309360582696, 231347032, 231347035, 3, 640x360 
0x12CB3460, 36963309360901728, 231347063, 231347067, 4, 640x360 
0x12CB3460, 36963309361221776, 231347103, 231347106, 3, 640x360 
0x12CB3460, 36963309361540952, 231347132, 231347135, 3, 640x360 
0x12CB3460, 36963309361862280, 231347163, 231347166, 3, 640x360 
0x12CB3460, 36963309362182768, 231347192, 231347196, 4, 640x360 
0x12CB3460, 36963309362502160, 231347224, 231347228, 4, 640x360 
0x12CB3460, 36963309362984704, 231347273, 231347278, 5, 640x360 
0x12CB3460, 36963309363301312, 231347303, 231347307, 4, 640x360 
0x12CB3460, 36963309363622272, 231347343, 231347346, 3, 640x360 
0x12CB3460, 36963309363942736, 231347383, 231347387, 4, 640x360 
0x12CB3460, 36963309364260664, 231347402, 231347404, 2, 640x360 
0x12CB3460, 36963309364582376, 231347433, 231347436, 3, 640x360 
0x12CB3460, 36963309364904128, 231347473, 231347476, 3, 640x360 
0x12CB3460, 36963309365221792, 231347503, 231347506, 3, 640x360 
0x12CB3460, 36963309365542624, 231347533, 231347536, 3, 640x360 
0x12CB3460, 36963309365861088, 231347563, 231347566, 3, 640x360 
0x12CB3460, 36963309366181696, 231347593, 231347596, 3, 640x360 
0x12CB3460, 36963309366502336, 231347633, 231347636, 3, 640x360 
0x12CB3460, 36963309366983056, 231347673, 231347676, 3, 640x360 
0x12CB3460, 36963309367302776, 231347713, 231347716, 3, 640x360 
0x12CB3460, 36963309367622208, 231347736, 231347740, 4, 640x360 
0x12CB3460, 36963309367942472, 231347773, 231347776, 3, 640x360 
0x12CB3460, 36963309368262280, 231347803, 231347806, 3, 640x360 
0x12CB3460, 36963309368581648, 231347834, 231347836, 2, 640x360 
0x12CB3460, 36963309368902920, 231347875, 231347894, 19, 640x360 
0x12CB3460, 36963309369222096, 231347903, 231347905, 2, 640x360 
0x12CB3460, 36963309369542288, 231347933, 231347935, 2, 640x360 
0x12CB3460, 36963309369861192, 231347962, 231347965, 3, 640x360 
0x12CB3460, 36963309370182424, 231347993, 231347996, 3, 640x360 
0x12CB3460, 36963309370660768, 231348042, 231348046, 4, 640x360 
0x12CB3460, 36963309370981960, 231348073, 231348076, 3, 640x360 
0x12CB3460, 36963309371303512, 231348103, 231348107, 4, 640x360 
0x12CB3460, 36963309371621304, 231348143, 231348146, 3, 640x360 
0x12CB3460, 36963309371942400, 231348172, 231348176, 4, 640x360 
0x12CB3460, 36963309372262160, 231348203, 231348206, 3, 640x360 
0x12CB3460, 36963309372581968, 231348232, 231348235, 3, 640x360 
0x12CB3460, 36963309372901952, 231348264, 231348267, 3, 640x360 
0x12CB3460, 36963309373221504, 231348303, 231348305, 2, 640x360 
0x12CB3460, 36963309373542520, 231348333, 231348336, 3, 640x360 
0x12CB3460, 36963309373864024, 231348376, 231348381, 5, 640x360 
0x12CB3460, 36963309374183464, 231348393, 231348396, 3, 640x360 
0x12CB3460, 36963309374664984, 231348443, 231348445, 2, 640x360 
0x12CB3460, 36963309374980584, 231348473, 231348477, 4, 640x360 
0x12CB3460, 36963309375302144, 231348513, 231348516, 3, 640x360 
0x12CB3460, 36963309375622440, 231348542, 231348547, 5, 640x360 
0x12CB3460, 36963309375941600, 231348573, 231348577, 4, 640x360 
0x12CB3460, 36963309376262152, 231348602, 231348605, 3, 640x360 
0x12CB3460, 36963309376581672, 231348633, 231348635, 2, 640x360 
0x12CB3460, 36963309376902040, 231348673, 231348676, 3, 640x360 
0x12CB3460, 36963309377222504, 231348703, 231348707, 4, 640x360 
0x12CB3460, 36963309377541344, 231348733, 231348736, 3, 640x360 
0x12CB3460, 36963309377861272, 231348763, 231348766, 3, 640x360 
0x12CB3460, 36963309378183032, 231348793, 231348796, 3, 640x360 
0x12CB3460, 36963309378661480, 231348842, 231348845, 3, 640x360 
0x12CB3460, 36963309378982336, 231348874, 231348876, 2, 640x360 
0x12CB3460, 36963309379301232, 231348903, 231348905, 2, 640x360 
0x12CB3460, 36963309379622136, 231348942, 231348945, 3, 640x360 
0x12CB3460, 36963309379943144, 231348973, 231348976, 3, 640x360 
0x12CB3460, 36963309380261448, 231349003, 231349005, 2, 640x360 
0x12CB3460, 36963309380583992, 231349032, 231349036, 4, 640x360 
0x12CB3460, 36963309380901544, 231349063, 231349066, 3, 640x360 
0x12CB3460, 36963309381222344, 231349102, 231349105, 3, 640x360 
0x12CB3460, 36963309381541720, 231349132, 231349135, 3, 640x360 
0x12CB3460, 36963309381861200, 231349163, 231349168, 5, 640x360 
0x12CB3460, 36963309382340504, 231349213, 231349216, 3, 640x360 
0x12CB3460, 36963309382660336, 231349243, 231349246, 3, 640x360 
0x12CB3460, 36963309382981992, 231349272, 231349275, 3, 640x360 
0x12CB3460, 36963309383303392, 231349303, 231349306, 3, 640x360 
0x12CB3460, 36963309383621320, 231349343, 231349347, 4, 640x360 
0x12CB3460, 36963309383941576, 231349370, 231349374, 4, 640x360 
0x12CB3460, 36963309384262496, 231349403, 231349412, 9, 640x360 
0x12CB3460, 36963309384581872, 231349433, 231349437, 4, 640x360 
0x12CB3460, 36963309384902448, 231349473, 231349477, 4, 640x360 
0x12CB3460, 36963309385221120, 231349502, 231349505, 3, 640x360 
0x12CB3460, 36963309385544760, 231349533, 231349536, 3, 640x360 
0x12CB3460, 36963309385863272, 231349563, 231349566, 3, 640x360 
0x12CB3460, 36963309386342600, 231349612, 231349615, 3, 640x360 
0x12CB3460, 36963309386663744, 231349643, 231349645, 2, 640x360 
0x12CB3460, 36963309386983888, 231349673, 231349676, 3, 640x360 
0x12CB3460, 36963309387303424, 231349713, 231349716, 3, 640x360 
0x12CB3460, 36963309387621976, 231349742, 231349745, 3, 640x360 
0x12CB3460, 36963309387942448, 231349772, 231349776, 4, 640x360 
0x12CB3460, 36963309388262520, 231349803, 231349805, 2, 640x360 
0x12CB3460, 36963309388583848, 231349832, 231349836, 4, 640x360 
0x12CB3460, 36963309388903160, 231349871, 231349875, 4, 640x360 
0x12CB3460, 36963309389222416, 231349903, 231349906, 3, 640x360 
0x12CB3460, 36963309389542456, 231349932, 231349935, 3, 640x360 
0x12CB3460, 36963309389862296, 231349962, 231349965, 3, 640x360 
0x12CB3460, 36963309390343120, 231350012, 231350015, 3, 640x360 
0x12CB3460, 36963309390661912, 231350043, 231350046, 3, 640x360 
0x12CB3460, 36963309390981768, 231350073, 231350077, 4, 640x360 
0x12CB3460, 36963309391304072, 231350103, 231350106, 3, 640x360 
0x12CB3460, 36963309391622008, 231350142, 231350145, 3, 640x360 
0x12CB3460, 36963309391942560, 231350173, 231350176, 3, 640x360 
0x12CB3460, 36963309392260792, 231350202, 231350205, 3, 640x360 
0x12CB3460, 36963309392581280, 231350233, 231350236, 3, 640x360 
0x12CB3460, 36963309392901544, 231350263, 231350266, 3, 640x360 
0x12CB3460, 36963309393222328, 231350303, 231350305, 2, 640x360 
0x12CB3460, 36963309393542888, 231350333, 231350336, 3, 640x360 
0x12CB3460, 36963309394026776, 231350376, 231350380, 4, 640x360 
0x12CB3460, 36963309394341920, 231350413, 231350416, 3, 640x360 
0x12CB3460, 36963309394666576, 231350443, 231350446, 3, 640x360 
0x12CB3460, 36963309394981256, 231350474, 231350476, 2, 640x360 
0x12CB3460, 36963309395303024, 231350513, 231350520, 7, 640x360 
0x12CB3460, 36963309395623344, 231350542, 231350546, 4, 640x360 
0x12CB3460, 36963309395943488, 231350573, 231350576, 3, 640x360 
0x12CB3460, 36963309396264640, 231350603, 231350606, 3, 640x360 
0x12CB3460, 36963309396582768, 231350633, 231350636, 3, 640x360 
0x12CB3460, 36963309396903104, 231350673, 231350677, 4, 640x360 
0x12CB3460, 36963309397222848, 231350703, 231350721, 18, 640x360 
0x12CB3460, 36963309397541952, 231350732, 231350735, 3, 640x360 
0x12CB3460, 36963309398021744, 231350776, 231350779, 3, 640x360 
0x12CB3460, 36963309398343432, 231350812, 231350815, 3, 640x360 
0x12CB3460, 36963309398662904, 231350843, 231350846, 3, 640x360 
0x12CB3460, 36963309398982544, 231350876, 231350880, 4, 640x360 
0x12CB3460, 36963309399300864, 231350903, 231350907, 4, 640x360 
0x12CB3460, 36963309399622016, 231350943, 231350946, 3, 640x360 
0x12CB3460, 36963309399941200, 231350972, 231350976, 4, 640x360 
0x12CB3460, 36963309400261288, 231351003, 231351006, 3, 640x360 
0x12CB3460, 36963309400581976, 231351032, 231351036, 4, 640x360 
0x12CB3460, 36963309400901600, 231351063, 231351068, 5, 640x360 
0x12CB3460, 36963309401221216, 231351104, 231351109, 5, 640x360 
0x12CB3460, 36963309401700088, 231351143, 231351146, 3, 640x360 
0x12CB3460, 36963309402020256, 231351183, 231351186, 3, 640x360 
0x12CB3460, 36963309402342008, 231351212, 231351215, 3, 640x360 
0x12CB3460, 36963309402660408, 231351242, 231351246, 4, 640x360 
0x12CB3460, 36963309402981136, 231351273, 231351276, 3, 640x360 
0x12CB3460, 36963309403303472, 231351303, 231351307, 4, 640x360 
0x12CB3460, 36963309403620736, 231351343, 231351346, 3, 640x360 
0x12CB3460, 36963309403942008, 231351376, 231351380, 4, 640x360 
0x12CB3460, 36963309404261616, 231351403, 231351405, 2, 640x360 
0x12CB3460, 36963309404582208, 231351433, 231351436, 3, 640x360 
0x12CB3460, 36963309404901016, 231351463, 231351466, 3, 640x360 
0x12CB3460, 36963309405222288, 231351503, 231351505, 2, 640x360 
0x12CB3460, 36963309405703024, 231351554, 231351557, 3, 640x360 
0x12CB3460, 36963309406021592, 231351577, 231351581, 4, 640x360 
0x12CB3460, 36963309406340360, 231351613, 231351615, 2, 640x360 
0x12CB3460, 36963309406661944, 231351642, 231351645, 3, 640x360 
0x12CB3460, 36963309406982720, 231351677, 231351680, 3, 640x360 
0x12CB3460, 36963309407302088, 231351714, 231351716, 2, 640x360 
0x12CB3460, 36963309407621240, 231351743, 231351746, 3, 640x360 
0x12CB3460, 36963309407940496, 231351773, 231351776, 3, 640x360 
0x12CB3460, 36963309408261792, 231351803, 231351806, 3, 640x360 
0x12CB3460, 36963309408581680, 231351833, 231351836, 3, 640x360 
0x12CB3460, 36963309408903488, 231351883, 231351886, 3, 640x360 
0x12CB3460, 36963309409221424, 231351903, 231351906, 3, 640x360 
0x12CB3460, 36963309409701880, 231351943, 231351947, 4, 640x360 
0x12CB3460, 36963309410020568, 231351983, 231351985, 2, 640x360 
0x12CB3460, 36963309410341032, 231352013, 231352016, 3, 640x360 
0x12CB3460, 36963309410662384, 231352043, 231352046, 3, 640x360 
0x12CB3460, 36963309410981960, 231352074, 231352077, 3, 640x360 
0x12CB3460, 36963309411301656, 231352103, 231352105, 2, 640x360 
0x12CB3460, 36963309411622680, 231352143, 231352145, 2, 640x360 
0x12CB3460, 36963309411941376, 231352172, 231352175, 3, 640x360 
0x12CB3460, 36963309412261624, 231352203, 231352205, 2, 640x360 
0x12CB3460, 36963309412581152, 231352233, 231352236, 3, 640x360 
0x12CB3460, 36963309412902424, 231352263, 231352267, 4, 640x360 
0x12CB3460, 36963309413383200, 231352312, 231352316, 4, 640x360 
0x12CB3460, 36963309413704208, 231352370, 231352374, 4, 640x360 
0x12CB3460, 36963309414026592, 231352375, 231352380, 5, 640x360 
0x12CB3460, 36963309414342736, 231352413, 231352415, 2, 640x360 
0x12CB3460, 36963309414661352, 231352443, 231352446, 3, 640x360 
0x12CB3460, 36963309414981320, 231352472, 231352476, 4, 640x360 
0x12CB3460, 36963309415303296, 231352503, 231352507, 4, 640x360 
0x12CB3460, 36963309415625288, 231352544, 231352549, 5, 640x360 
0x12CB3460, 36963309415942416, 231352573, 231352576, 3, 640x360 
0x12CB3460, 36963309416263712, 231352603, 231352606, 3, 640x360 
0x12CB3460, 36963309416582696, 231352633, 231352636, 3, 640x360 
0x12CB3460, 36963309416902864, 231352664, 231352667, 3, 640x360 
0x12CB3460, 36963309417381808, 231352714, 231352717, 3, 640x360 
0x12CB3460, 36963309417702488, 231352753, 231352756, 3, 640x360 
0x12CB3460, 36963309418023952, 231352782, 231352785, 3, 640x360 
0x12CB3460, 36963309418340712, 231352813, 231352818, 5, 640x360 
0x12CB3460, 36963309418662184, 231352843, 231352846, 3, 640x360 
0x12CB3460, 36963309418982392, 231352874, 231352892, 18, 640x360 
0x12CB3460, 36963309419302328, 231352914, 231352916, 2, 640x360 
0x12CB3460, 36963309419621488, 231352942, 231352945, 3, 640x360 
0x12CB3460, 36963309419941816, 231352974, 231352980, 6, 640x360 
0x12CB3460, 36963309420262384, 231353002, 231353005, 3, 640x360 
0x12CB3460, 36963309420583176, 231353032, 231353036, 4, 640x360 
0x12CB3460, 36963309420901048, 231353063, 231353074, 11, 640x360 
0x12CB3460, 36963309421381376, 231353112, 231353115, 3, 640x360 
0x12CB3460, 36963309421702680, 231353152, 231353155, 3, 640x360 
0x12CB3460, 36963309422023784, 231353182, 231353185, 3, 640x360 
0x12CB3460, 36963309422344184, 231353212, 231353216, 4, 640x360 
0x12CB3460, 36963309422661560, 231353243, 231353246, 3, 640x360 
0x12CB3460, 36963309422982592, 231353272, 231353276, 4, 640x360 
0x12CB3460, 36963309423303064, 231353304, 231353308, 4, 640x360 
0x12CB3460, 36963309423622544, 231353344, 231353347, 3, 640x360 
0x12CB3460, 36963309423945032, 231353393, 231353396, 3, 640x360 
0x12CB3460, 36963309424261664, 231353403, 231353405, 2, 640x360 
0x12CB3460, 36963309424581600, 231353433, 231353436, 3, 640x360 
0x12CB3460, 36963309425063368, 231353482, 231353486, 4, 640x360 
0x12CB3460, 36963309425381448, 231353513, 231353516, 3, 640x360 
0x12CB3460, 36963309425704000, 231353552, 231353555, 3, 640x360 
0x12CB3460, 36963309426022952, 231353584, 231353587, 3, 640x360 
0x12CB3460, 36963309426342544, 231353613, 231353616, 3, 640x360 
0x12CB3460, 36963309426660808, 231353643, 231353646, 3, 640x360 
0x12CB3460, 36963309426981384, 231353673, 231353676, 3, 640x360 
0x12CB3460, 36963309427302000, 231353704, 231353708, 4, 640x360 
0x12CB3460, 36963309427621440, 231353743, 231353745, 2, 640x360 
0x12CB3460, 36963309427941304, 231353773, 231353776, 3, 640x360 
0x12CB3460, 36963309428260776, 231353802, 231353805, 3, 640x360 
0x12CB3460, 36963309428582720, 231353833, 231353836, 3, 640x360 
0x12CB3460, 36963309429060808, 231353882, 231353885, 3, 640x360 
0x12CB3460, 36963309429382000, 231353914, 231353916, 2, 640x360 
0x12CB3460, 36963309429702328, 231353953, 231353956, 3, 640x360 
0x12CB3460, 36963309430021440, 231353982, 231353985, 3, 640x360 
0x12CB3460, 36963309430340528, 231354013, 231354015, 2, 640x360 
0x12CB3460, 36963309430660912, 231354042, 231354050, 8, 640x360 
0x12CB3460, 36963309430981352, 231354073, 231354076, 3, 640x360 
0x12CB3460, 36963309431300720, 231354113, 231354116, 3, 640x360 
0x12CB3460, 36963309431621408, 231354142, 231354145, 3, 640x360 
0x12CB3460, 36963309431942528, 231354173, 231354176, 3, 640x360 
0x12CB3460, 36963309432262312, 231354202, 231354205, 3, 640x360 
0x12CB3460, 36963309432742160, 231354253, 231354256, 3, 640x360 
0x12CB3460, 36963309433062888, 231354282, 231354286, 4, 640x360 
0x12CB3460, 36963309433381576, 231354313, 231354316, 3, 640x360 
0x12CB3460, 36963309433705288, 231354372, 231354376, 4, 640x360 
0x12CB3460, 36963309434022720, 231354383, 231354386, 3, 640x360 
0x12CB3460, 36963309434342512, 231354412, 231354415, 3, 640x360 
0x12CB3460, 36963309434661592, 231354443, 231354446, 3, 640x360 
0x12CB3460, 36963309434982488, 231354473, 231354477, 4, 640x360 
0x12CB3460, 36963309435301680, 231354504, 231354523, 19, 640x360 
0x12CB3460, 36963309435625920, 231354542, 231354545, 3, 640x360 
0x12CB3460, 36963309435941920, 231354574, 231354577, 3, 640x360 
0x12CB3460, 36963309436263096, 231354603, 231354605, 2, 640x360 
0x12CB3460, 36963309436742152, 231354653, 231354655, 2, 640x360 
0x12CB3460, 36963309437062624, 231354683, 231354685, 2, 640x360 
0x12CB3460, 36963309437382504, 231354713, 231354716, 3, 640x360 
0x12CB3460, 36963309437702048, 231354743, 231354747, 4, 640x360 
0x12CB3460, 36963309438023872, 231354782, 231354785, 3, 640x360 
0x12CB3460, 36963309438341752, 231354813, 231354815, 2, 640x360 
0x12CB3460, 36963309438661192, 231354842, 231354846, 4, 640x360 
0x12CB3460, 36963309438981816, 231354880, 231354884, 4, 640x360 
0x12CB3460, 36963309439301904, 231354903, 231354907, 4, 640x360 
0x12CB3460, 36963309439622560, 231354943, 231354946, 3, 640x360 
0x12CB3460, 36963309439941400, 231354972, 231354975, 3, 640x360 
0x12CB3460, 36963309440262360, 231355002, 231355005, 3, 640x360 
0x12CB3460, 36963309440743304, 231355053, 231355055, 2, 640x360 
0x12CB3460, 36963309441061120, 231355083, 231355086, 3, 640x360 
0x12CB3460, 36963309441382328, 231355115, 231355118, 3, 640x360 
0x12CB3460, 36963309441703400, 231355143, 231355147, 4, 640x360 
0x12CB3460, 36963309442022280, 231355183, 231355186, 3, 640x360 
0x12CB3460, 36963309442345040, 231355213, 231355216, 3, 640x360 
0x12CB3460, 36963309442662264, 231355244, 231355247, 3, 640x360 
0x12CB3460, 36963309442981216, 231355273, 231355277, 4, 640x360 
0x12CB3460, 36963309443302064, 231355303, 231355307, 4, 640x360 
0x12CB3460, 36963309443621856, 231355342, 231355345, 3, 640x360 
0x12CB3460, 36963309443942112, 231355372, 231355375, 3, 640x360 
0x12CB3460, 36963309444423920, 231355423, 231355426, 3, 640x360 
0x12CB3460, 36963309444742528, 231355453, 231355456, 3, 640x360 
0x12CB3460, 36963309445061608, 231355482, 231355486, 4, 640x360 
0x12CB3460, 36963309445384584, 231355512, 231355525, 13, 640x360 
0x12CB3460, 36963309445703696, 231355552, 231355555, 3, 640x360 
0x12CB3460, 36963309446022016, 231355584, 231355587, 3, 640x360 
0x12CB3460, 36963309446344528, 231355613, 231355616, 3, 640x360 
0x12CB3460, 36963309446663272, 231355644, 231355647, 3, 640x360 
0x12CB3460, 36963309446982728, 231355674, 231355677, 3, 640x360 
0x12CB3460, 36963309447303168, 231355713, 231355716, 3, 640x360 
0x12CB3460, 36963309447622520, 231355742, 231355744, 2, 640x360 
0x12CB3460, 36963309447942864, 231355773, 231355776, 3, 640x360 
0x12CB3460, 36963309448423088, 231355824, 231355827, 3, 640x360 
0x12CB3460, 36963309448741632, 231355871, 231355875, 4, 640x360 
0x12CB3460, 36963309449062688, 231355883, 231355885, 2, 640x360 
0x12CB3460, 36963309449382000, 231355913, 231355925, 12, 640x360 
0x12CB3460, 36963309449701136, 231355944, 231355947, 3, 640x360 
0x12CB3460, 36963309450021936, 231355977, 231355980, 3, 640x360 
0x12CB3460, 36963309450343272, 231356013, 231356016, 3, 640x360 
0x12CB3460, 36963309450665448, 231356043, 231356047, 4, 640x360 
0x12CB3460, 36963309450981520, 231356073, 231356076, 3, 640x360 
0x12CB3460, 36963309451301472, 231356104, 231356108, 4, 640x360 
0x12CB3460, 36963309451621976, 231356143, 231356146, 3, 640x360 
0x12CB3460, 36963309451941672, 231356172, 231356175, 3, 640x360 
0x12CB3460, 36963309452420784, 231356224, 231356228, 4, 640x360 
0x12CB3460, 36963309452742080, 231356253, 231356256, 3, 640x360 
0x12CB3460, 36963309453065040, 231356283, 231356286, 3, 640x360 
0x12CB3460, 36963309453380376, 231356312, 231356315, 3, 640x360 
0x12CB3460, 36963309453702096, 231356343, 231356348, 5, 640x360 
0x12CB3460, 36963309454021832, 231356375, 231356379, 4, 640x360 
0x12CB3460, 36963309454341944, 231356412, 231356415, 3, 640x360 
0x12CB3460, 36963309454660944, 231356443, 231356446, 3, 640x360 
0x12CB3460, 36963309454980904, 231356474, 231356477, 3, 640x360 
0x12CB3460, 36963309455302352, 231356504, 231356507, 3, 640x360 
0x12CB3460, 36963309455623568, 231356542, 231356548, 6, 640x360 
0x12CB3460, 36963309456102528, 231356593, 231356596, 3, 640x360 
0x12CB3460, 36963309456421544, 231356623, 231356626, 3, 640x360 
0x12CB3460, 36963309456742424, 231356653, 231356656, 3, 640x360 
0x12CB3460, 36963309457061408, 231356683, 231356686, 3, 640x360 
0x12CB3460, 36963309457383568, 231356712, 231356715, 3, 640x360 
0x12CB3460, 36963309457703920, 231356745, 231356749, 4, 640x360 
0x12CB3460, 36963309458022384, 231356782, 231356800, 18, 640x360 
0x12CB3460, 36963309458340744, 231356813, 231356815, 2, 640x360 
0x12CB3460, 36963309458661680, 231356843, 231356856, 13, 640x360 
0x12CB3460, 36963309458982752, 231356873, 231356877, 4, 640x360 
0x12CB3460, 36963309459302128, 231356903, 231356907, 4, 640x360 
0x12CB3460, 36963309459622752, 231356943, 231356946, 3, 640x360 
0x12CB3460, 36963309460101664, 231356983, 231357000, 17, 640x360 
0x12CB3460, 36963309460422144, 231357023, 231357026, 3, 640x360 
0x12CB3460, 36963309460742024, 231357053, 231357056, 3, 640x360 
0x12CB3460, 36963309461061664, 231357082, 231357085, 3, 640x360 
0x12CB3460, 36963309461381888, 231357113, 231357116, 3, 640x360 
0x12CB3460, 36963309461702416, 231357144, 231357148, 4, 640x360 
0x12CB3460, 36963309462022912, 231357183, 231357186, 3, 640x360 
0x12CB3460, 36963309462342288, 231357212, 231357215, 3, 640x360 
0x12CB3460, 36963309462660856, 231357243, 231357245, 2, 640x360 
0x12CB3460, 36963309462981384, 231357274, 231357279, 5, 640x360 
0x12CB3460, 36963309463302424, 231357303, 231357307, 4, 640x360 
0x12CB3460, 36963309463624368, 231357343, 231357358, 15, 640x360 
0x12CB3460, 36963309464101496, 231357383, 231357386, 3, 640x360 
0x12CB3460, 36963309464420616, 231357422, 231357426, 4, 640x360 
0x12CB3460, 36963309464741272, 231357453, 231357456, 3, 640x360 
0x12CB3460, 36963309465062448, 231357482, 231357485, 3, 640x360 
0x12CB3460, 36963309465382312, 231357512, 231357515, 3, 640x360 
0x12CB3460, 36963309465702344, 231357552, 231357555, 3, 640x360 
0x12CB3460, 36963309466022832, 231357583, 231357587, 4, 640x360 
0x12CB3460, 36963309466341552, 231357612, 231357615, 3, 640x360 
0x12CB3460, 36963309466662000, 231357643, 231357645, 2, 640x360 
0x12CB3460, 36963309466982712, 231357672, 231357676, 4, 640x360 
0x12CB3460, 36963309467304336, 231357713, 231357716, 3, 640x360 
0x12CB3460, 36963309467780304, 231357753, 231357756, 3, 640x360 
0x12CB3460, 36963309468103392, 231357793, 231357796, 3, 640x360 
0x12CB3460, 36963309468420608, 231357822, 231357826, 4, 640x360 
0x12CB3460, 36963309468742680, 231357853, 231357872, 19, 640x360 
0x12CB3460, 36963309469061080, 231357884, 231357887, 3, 640x360 
0x12CB3460, 36963309469382000, 231357913, 231357915, 2, 640x360 
0x12CB3460, 36963309469702464, 231357953, 231357956, 3, 640x360 
0x12CB3460, 36963309470022800, 231357976, 231357978, 2, 640x360 
0x12CB3460, 36963309470340672, 231358013, 231358015, 2, 640x360 
0x12CB3460, 36963309470663480, 231358043, 231358046, 3, 640x360 
0x12CB3460, 36963309470980848, 231358072, 231358075, 3, 640x360 
0x12CB3460, 36963309471300952, 231358102, 231358106, 4, 640x360 
0x12CB3460, 36963309471781392, 231358153, 231358155, 2, 640x360 
0x12CB3460, 36963309472102200, 231358193, 231358195, 2, 640x360 
0x12CB3460, 36963309472421656, 231358223, 231358226, 3, 640x360 
0x12CB3460, 36963309472741432, 231358253, 231358256, 3, 640x360 
0x12CB3460, 36963309473060680, 231358282, 231358286, 4, 640x360 
0x12CB3460, 36963309473381752, 231358313, 231358316, 3, 640x360 
0x12CB3460, 36963309473701992, 231358370, 231358375, 5, 640x360 
0x12CB3460, 36963309474024168, 231358376, 231358380, 4, 640x360 
0x12CB3460, 36963309474341808, 231358413, 231358416, 3, 640x360 
0x12CB3460, 36963309474662328, 231358443, 231358446, 3, 640x360 
0x12CB3460, 36963309474981504, 231358472, 231358476, 4, 640x360 
0x12CB3460, 36963309475463880, 231358523, 231358527, 4, 640x360 
0x12CB3460, 36963309475781880, 231358553, 231358557, 4, 640x360 
0x12CB3460, 36963309476106160, 231358594, 231358598, 4, 640x360 
0x12CB3460, 36963309476422080, 231358622, 231358625, 3, 640x360 
0x12CB3460, 36963309476741480, 231358653, 231358655, 2, 640x360 
0x12CB3460, 36963309477064888, 231358683, 231358687, 4, 640x360 
0x12CB3460, 36963309477383392, 231358725, 231358728, 3, 640x360 
0x12CB3460, 36963309477700728, 231358743, 231358747, 4, 640x360 
0x12CB3460, 36963309478020848, 231358784, 231358787, 3, 640x360 
0x12CB3460, 36963309478340760, 231358812, 231358825, 13, 640x360 
0x12CB3460, 36963309478662672, 231358843, 231358846, 3, 640x360 
0x12CB3460, 36963309478981576, 231358883, 231358886, 3, 640x360 
0x12CB3460, 36963309479460288, 231358923, 231358926, 3, 640x360 
0x12CB3460, 36963309479781008, 231358953, 231358956, 3, 640x360 
0x12CB3460, 36963309480101400, 231358983, 231358987, 4, 640x360 
0x12CB3460, 36963309480422008, 231359023, 231359027, 4, 640x360 
0x12CB3460, 36963309480742864, 231359053, 231359056, 3, 640x360 
0x12CB3460, 36963309481061472, 231359082, 231359085, 3, 640x360 
0x12CB3460, 36963309481382200, 231359113, 231359118, 5, 640x360 
0x12CB3460, 36963309481700368, 231359152, 231359155, 3, 640x360 
0x12CB3460, 36963309482021928, 231359183, 231359186, 3, 640x360 
0x12CB3460, 36963309482343456, 231359212, 231359215, 3, 640x360 
0x12CB3460, 36963309482660384, 231359242, 231359245, 3, 640x360 
0x12CB3460, 36963309482982168, 231359273, 231359277, 4, 640x360 
0x12CB3460, 36963309483462704, 231359322, 231359325, 3, 640x360 
0x12CB3460, 36963309483781584, 231359356, 231359375, 19, 640x360 
0x12CB3460, 36963309484100088, 231359385, 231359388, 3, 640x360 
0x12CB3460, 36963309484421256, 231359423, 231359426, 3, 640x360 
0x12CB3460, 36963309484741424, 231359453, 231359456, 3, 640x360 
0x12CB3460, 36963309485063872, 231359483, 231359487, 4, 640x360 
0x12CB3460, 36963309485383952, 231359513, 231359517, 4, 640x360 
0x12CB3460, 36963309485703136, 231359554, 231359558, 4, 640x360 
0x12CB3460, 36963309486023704, 231359585, 231359588, 3, 640x360 
0x12CB3460, 36963309486343696, 231359614, 231359616, 2, 640x360 
0x12CB3460, 36963309486662936, 231359643, 231359647, 4, 640x360 
0x12CB3460, 36963309487141760, 231359693, 231359695, 2, 640x360 
0x12CB3460, 36963309487462360, 231359722, 231359725, 3, 640x360 
0x12CB3460, 36963309487781584, 231359752, 231359755, 3, 640x360 
0x12CB3460, 36963309488102160, 231359783, 231359787, 4, 640x360 
0x12CB3460, 36963309488422632, 231359824, 231359827, 3, 640x360 
0x12CB3460, 36963309488741968, 231359861, 231359864, 3, 640x360 
0x12CB3460, 36963309489061128, 231359882, 231359885, 3, 640x360 
0x12CB3460, 36963309489380872, 231359914, 231359916, 2, 640x360 
0x12CB3460, 36963309489702192, 231359944, 231359948, 4, 640x360 
0x12CB3460, 36963309490021568, 231359983, 231359986, 3, 640x360 
0x12CB3460, 36963309490342232, 231360012, 231360015, 3, 640x360 
0x12CB3460, 36963309490663328, 231360042, 231360045, 3, 640x360 
0x12CB3460, 36963309491140792, 231360093, 231360096, 3, 640x360 
0x12CB3460, 36963309491461312, 231360122, 231360126, 4, 640x360 
0x12CB3460, 36963309491780216, 231360153, 231360156, 3, 640x360 
0x12CB3460, 36963309492101688, 231360183, 231360187, 4, 640x360 
0x12CB3460, 36963309492421768, 231360222, 231360225, 3, 640x360 
0x12CB3460, 36963309492742328, 231360252, 231360255, 3, 640x360 
0x12CB3460, 36963309493062944, 231360282, 231360285, 3, 640x360 
0x12CB3460, 36963309493381912, 231360313, 231360316, 3, 640x360 
0x12CB3460, 36963309493701512, 231360371, 231360375, 4, 640x360 
0x12CB3460, 36963309494024168, 231360376, 231360380, 4, 640x360 
0x12CB3460, 36963309494341736, 231360413, 231360416, 3, 640x360 
0x12CB3460, 36963309494662384, 231360442, 231360445, 3, 640x360 
0x12CB3460, 36963309495142512, 231360492, 231360495, 3, 640x360 
0x12CB3460, 36963309495463712, 231360524, 231360528, 4, 640x360 
0x12CB3460, 36963309495784592, 231360554, 231360557, 3, 640x360 
0x12CB3460, 36963309496105752, 231360594, 231360598, 4, 640x360 
0x12CB3460, 36963309496421536, 231360623, 231360626, 3, 640x360 
0x12CB3460, 36963309496742128, 231360652, 231360655, 3, 640x360 
0x12CB3460, 36963309497061704, 231360682, 231360700, 18, 640x360 
0x12CB3460, 36963309497381712, 231360713, 231360716, 3, 640x360 
0x12CB3460, 36963309497701088, 231360753, 231360756, 3, 640x360 
0x12CB3460, 36963309498022464, 231360782, 231360800, 18, 640x360 
0x12CB3460, 36963309498340472, 231360812, 231360815, 3, 640x360 
0x12CB3460, 36963309498820864, 231360869, 231360872, 3, 640x360 
0x12CB3460, 36963309499139696, 231360892, 231360895, 3, 640x360 
0x12CB3460, 36963309499460152, 231360924, 231360927, 3, 640x360 
0x12CB3460, 36963309499780456, 231360953, 231360957, 4, 640x360 
0x12CB3460, 36963309500101744, 231360983, 231360987, 4, 640x360 
0x12CB3460, 36963309500420936, 231361023, 231361027, 4, 640x360 
0x12CB3460, 36963309500743528, 231361053, 231361056, 3, 640x360 
0x12CB3460, 36963309501060472, 231361082, 231361085, 3, 640x360 
0x12CB3460, 36963309501382400, 231361114, 231361117, 3, 640x360 
0x12CB3460, 36963309501702392, 231361153, 231361156, 3, 640x360 
0x12CB3460, 36963309502021320, 231361183, 231361186, 3, 640x360 
0x12CB3460, 36963309502343608, 231361212, 231361215, 3, 640x360 
0x12CB3460, 36963309502819672, 231361263, 231361266, 3, 640x360 
0x12CB3460, 36963309503142184, 231361292, 231361295, 3, 640x360 
0x12CB3460, 36963309503460936, 231361323, 231361327, 4, 640x360 
0x12CB3460, 36963309503782960, 231361372, 231361376, 4, 640x360 
0x12CB3460, 36963309504101752, 231361392, 231361401, 9, 640x360 
0x12CB3460, 36963309504421952, 231361423, 231361426, 3, 640x360 
0x12CB3460, 36963309504742488, 231361453, 231361455, 2, 640x360 
0x12CB3460, 36963309505060872, 231361483, 231361485, 2, 640x360 
0x12CB3460, 36963309505380376, 231361512, 231361515, 3, 640x360 
0x12CB3460, 36963309505701008, 231361543, 231361547, 4, 640x360 
0x12CB3460, 36963309506021304, 231361583, 231361586, 3, 640x360 
0x12CB3460, 36963309506343064, 231361612, 231361615, 3, 640x360 
0x12CB3460, 36963309506822072, 231361663, 231361666, 3, 640x360 
0x12CB3460, 36963309507143408, 231361693, 231361697, 4, 640x360 
0x12CB3460, 36963309507464560, 231361723, 231361727, 4, 640x360 
0x12CB3460, 36963309507780136, 231361753, 231361756, 3, 640x360 
0x12CB3460, 36963309508102056, 231361784, 231361788, 4, 640x360 
0x12CB3460, 36963309508420984, 231361822, 231361826, 4, 640x360 
0x12CB3460, 36963309508740704, 231361872, 231361876, 4, 640x360 
0x12CB3460, 36963309509060344, 231361883, 231361886, 3, 640x360 
0x12CB3460, 36963309509380608, 231361913, 231361915, 2, 640x360 
0x12CB3460, 36963309509702344, 231361943, 231361948, 5, 640x360 
0x12CB3460, 36963309510021184, 231361975, 231361979, 4, 640x360 
0x12CB3460, 36963309510500296, 231362033, 231362036, 3, 640x360 
0x12CB3460, 36963309510820376, 231362062, 231362066, 4, 640x360 
0x12CB3460, 36963309511141160, 231362092, 231362095, 3, 640x360 
0x12CB3460, 36963309511462000, 231362123, 231362126, 3, 640x360 
0x12CB3460, 36963309511780664, 231362153, 231362156, 3, 640x360 
0x12CB3460, 36963309512100968, 231362193, 231362196, 3, 640x360 
0x12CB3460, 36963309512421328, 231362223, 231362225, 2, 640x360 
0x12CB3460, 36963309512741456, 231362252, 231362255, 3, 640x360 
0x12CB3460, 36963309513060856, 231362282, 231362285, 3, 640x360 
0x12CB3460, 36963309513380376, 231362312, 231362315, 3, 640x360 
0x12CB3460, 36963309513701256, 231362343, 231362351, 8, 640x360 
0x12CB3460, 36963309514021776, 231362383, 231362386, 3, 640x360 
0x12CB3460, 36963309514501680, 231362424, 231362427, 3, 640x360 
0x12CB3460, 36963309514822376, 231362465, 231362468, 3, 640x360 
0x12CB3460, 36963309515142288, 231362493, 231362496, 3, 640x360 
0x12CB3460, 36963309515462264, 231362522, 231362525, 3, 640x360 
0x12CB3460, 36963309515782032, 231362553, 231362557, 4, 640x360 
0x12CB3460, 36963309516103344, 231362584, 231362588, 4, 640x360 
0x12CB3460, 36963309516422376, 231362623, 231362626, 3, 640x360 
0x12CB3460, 36963309516741392, 231362652, 231362654, 2, 640x360 
0x12CB3460, 36963309517062104, 231362682, 231362685, 3, 640x360 
0x12CB3460, 36963309517382936, 231362712, 231362715, 3, 640x360 
0x12CB3460, 36963309517703136, 231362744, 231362748, 4, 640x360 
0x12CB3460, 36963309518181848, 231362792, 231362795, 3, 640x360 
0x12CB3460, 36963309518501664, 231362823, 231362828, 5, 640x360 
0x12CB3460, 36963309518821344, 231362869, 231362872, 3, 640x360 
0x12CB3460, 36963309519140016, 231362893, 231362895, 2, 640x360 
0x12CB3460, 36963309519462240, 231362923, 231362926, 3, 640x360 
0x12CB3460, 36963309519781480, 231362953, 231362956, 3, 640x360 
0x12CB3460, 36963309520100176, 231362983, 231362986, 3, 640x360 
0x12CB3460, 36963309520420336, 231363022, 231363025, 3, 640x360 
0x12CB3460, 36963309520741512, 231363052, 231363055, 3, 640x360 
0x12CB3460, 36963309521060904, 231363083, 231363085, 2, 640x360 
0x12CB3460, 36963309521382024, 231363113, 231363117, 4, 640x360 
0x12CB3460, 36963309521701712, 231363153, 231363156, 3, 640x360 
0x12CB3460, 36963309522180336, 231363193, 231363196, 3, 640x360 
0x12CB3460, 36963309522501320, 231363224, 231363229, 5, 640x360 
0x12CB3460, 36963309522821752, 231363263, 231363266, 3, 640x360 
0x12CB3460, 36963309523142800, 231363294, 231363297, 3, 640x360 
0x12CB3460, 36963309523460360, 231363322, 231363325, 3, 640x360 
0x12CB3460, 36963309523781080, 231363370, 231363373, 3, 640x360 
0x12CB3460, 36963309524100408, 231363383, 231363387, 4, 640x360 
0x12CB3460, 36963309524422168, 231363423, 231363425, 2, 640x360 
0x12CB3460, 36963309524741760, 231363453, 231363456, 3, 640x360 
0x12CB3460, 36963309525060480, 231363482, 231363485, 3, 640x360 
0x12CB3460, 36963309525382192, 231363513, 231363516, 3, 640x360 
0x12CB3460, 36963309525702464, 231363554, 231363557, 3, 640x360 
0x12CB3460, 36963309526185120, 231363593, 231363596, 3, 640x360 
0x12CB3460, 36963309526502760, 231363624, 231363627, 3, 640x360 
0x12CB3460, 36963309526821856, 231363662, 231363665, 3, 640x360 
0x12CB3460, 36963309527141968, 231363692, 231363696, 4, 640x360 
0x12CB3460, 36963309527461416, 231363724, 231363727, 3, 640x360 
0x12CB3460, 36963309527780472, 231363753, 231363756, 3, 640x360 
0x12CB3460, 36963309528101992, 231363784, 231363788, 4, 640x360 
0x12CB3460, 36963309528421440, 231363823, 231363826, 3, 640x360 
0x12CB3460, 36963309528741256, 231363877, 231363880, 3, 640x360 
0x12CB3460, 36963309529062672, 231363882, 231363885, 3, 640x360 
0x12CB3460, 36963309529380480, 231363914, 231363917, 3, 640x360 
0x12CB3460, 36963309529862304, 231363964, 231363967, 3, 640x360 
0x12CB3460, 36963309530181424, 231363993, 231363995, 2, 640x360 
0x12CB3460, 36963309530502216, 231364032, 231364035, 3, 640x360 
0x12CB3460, 36963309530820728, 231364062, 231364066, 4, 640x360 
0x12CB3460, 36963309531141112, 231364093, 231364096, 3, 640x360 
0x12CB3460, 36963309531461760, 231364122, 231364127, 5, 640x360 
0x12CB3460, 36963309531780320, 231364153, 231364156, 3, 640x360 
0x12CB3460, 36963309532100032, 231364193, 231364196, 3, 640x360 
0x12CB3460, 36963309532421928, 231364223, 231364226, 3, 640x360 
0x12CB3460, 36963309532741472, 231364253, 231364255, 2, 640x360 
0x12CB3460, 36963309533061144, 231364283, 231364286, 3, 640x360 
0x12CB3460, 36963309533381208, 231364313, 231364315, 2, 640x360 
0x12CB3460, 36963309533861984, 231364370, 231364373, 3, 640x360 
0x12CB3460, 36963309534179760, 231364392, 231364395, 3, 640x360 
0x12CB3460, 36963309534501672, 231364432, 231364435, 3, 640x360 
0x12CB3460, 36963309534820576, 231364463, 231364467, 4, 640x360 
0x12CB3460, 36963309535142760, 231364493, 231364495, 2, 640x360 
0x12CB3460, 36963309535462240, 231364523, 231364526, 3, 640x360 
0x12CB3460, 36963309535781744, 231364553, 231364557, 4, 640x360 
0x12CB3460, 36963309536105016, 231364593, 231364596, 3, 640x360 
0x12CB3460, 36963309536420848, 231364623, 231364626, 3, 640x360 
0x12CB3460, 36963309536741904, 231364652, 231364655, 3, 640x360 
0x12CB3460, 36963309537061992, 231364682, 231364685, 3, 640x360 
0x12CB3460, 36963309537381360, 231364713, 231364716, 3, 640x360 
0x12CB3460, 36963309537860480, 231364762, 231364765, 3, 640x360 
0x12CB3460, 36963309538184576, 231364793, 231364796, 3, 640x360 
0x12CB3460, 36963309538502320, 231364833, 231364836, 3, 640x360 
0x12CB3460, 36963309538821648, 231364863, 231364866, 3, 640x360 
0x12CB3460, 36963309539140872, 231364892, 231364894, 2, 640x360 
0x12CB3460, 36963309539461536, 231364923, 231364925, 2, 640x360 
0x12CB3460, 36963309539781504, 231364952, 231364956, 4, 640x360 
0x12CB3460, 36963309540101800, 231364992, 231364995, 3, 640x360 
0x12CB3460, 36963309540420296, 231365022, 231365025, 3, 640x360 
0x12CB3460, 36963309540742080, 231365052, 231365055, 3, 640x360 
0x12CB3460, 36963309541060432, 231365083, 231365086, 3, 640x360 
0x12CB3460, 36963309541543608, 231365132, 231365135, 3, 640x360 
0x12CB3460, 36963309541861944, 231365163, 231365176, 13, 640x360 
0x12CB3460, 36963309542182632, 231365192, 231365196, 4, 640x360 
0x12CB3460, 36963309542501456, 231365226, 231365230, 4, 640x360 
0x12CB3460, 36963309542820544, 231365262, 231365265, 3, 640x360 
0x12CB3460, 36963309543142208, 231365293, 231365296, 3, 640x360 
0x12CB3460, 36963309543461680, 231365322, 231365326, 4, 640x360 
0x12CB3460, 36963309543780800, 231365354, 231365357, 3, 640x360 
0x12CB3460, 36963309544100536, 231365383, 231365387, 4, 640x360 
0x12CB3460, 36963309544420056, 231365423, 231365425, 2, 640x360 
0x12CB3460, 36963309544740992, 231365453, 231365456, 3, 640x360 
0x12CB3460, 36963309545061128, 231365483, 231365485, 2, 640x360 
0x12CB3460, 36963309545540968, 231365532, 231365534, 2, 640x360 
0x12CB3460, 36963309545861344, 231365562, 231365565, 3, 640x360 
0x12CB3460, 36963309546182480, 231365593, 231365596, 3, 640x360 
0x12CB3460, 36963309546502200, 231365623, 231365627, 4, 640x360 
0x12CB3460, 36963309546819928, 231365662, 231365664, 2, 640x360 
0x12CB3460, 36963309547141424, 231365693, 231365696, 3, 640x360 
0x12CB3460, 36963309547461728, 231365723, 231365726, 3, 640x360 
0x12CB3460, 36963309547780456, 231365752, 231365755, 3, 640x360 
0x12CB3460, 36963309548101432, 231365784, 231365788, 4, 640x360 
0x12CB3460, 36963309548420288, 231365822, 231365825, 3, 640x360 
0x12CB3460, 36963309548741584, 231365875, 231365878, 3, 640x360 
0x12CB3460, 36963309549220936, 231365902, 231365920, 18, 640x360 
0x12CB3460, 36963309549542208, 231365933, 231365950, 17, 640x360 
0x12CB3460, 36963309549861344, 231365962, 231365965, 3, 640x360 
0x12CB3460, 36963309550181512, 231365993, 231365995, 2, 640x360 
0x12CB3460, 36963309550502008, 231366023, 231366027, 4, 640x360 
0x12CB3460, 36963309550820984, 231366062, 231366065, 3, 640x360 
0x12CB3460, 36963309551140088, 231366093, 231366095, 2, 640x360 
0x12CB3460, 36963309551460904, 231366122, 231366126, 4, 640x360 
0x12CB3460, 36963309551781888, 231366152, 231366156, 4, 640x360 
0x12CB3460, 36963309552102456, 231366193, 231366196, 3, 640x360 
0x12CB3460, 36963309552422216, 231366224, 231366227, 3, 640x360 
0x12CB3460, 36963309552741640, 231366252, 231366255, 3, 640x360 
0x12CB3460, 36963309553221328, 231366302, 231366306, 4, 640x360 
0x12CB3460, 36963309553540824, 231366332, 231366334, 2, 640x360 
0x12CB3460, 36963309553862672, 231366373, 231366377, 4, 640x360 
0x12CB3460, 36963309554180744, 231366392, 231366395, 3, 640x360 
0x12CB3460, 36963309554501584, 231366432, 231366435, 3, 640x360 
0x12CB3460, 36963309554820784, 231366464, 231366467, 3, 640x360 
0x12CB3460, 36963309555140184, 231366492, 231366495, 3, 640x360 
0x12CB3460, 36963309555461304, 231366523, 231366525, 2, 640x360 
0x12CB3460, 36963309555780040, 231366553, 231366556, 3, 640x360 
0x12CB3460, 36963309556101952, 231366593, 231366596, 3, 640x360 
0x12CB3460, 36963309556422560, 231366622, 231366625, 3, 640x360 
0x12CB3460, 36963309556742648, 231366653, 231366657, 4, 640x360 
0x12CB3460, 36963309557219872, 231366702, 231366705, 3, 640x360 
0x12CB3460, 36963309557540240, 231366733, 231366735, 2, 640x360 
0x12CB3460, 36963309557861568, 231366762, 231366764, 2, 640x360 
0x12CB3460, 36963309558181408, 231366793, 231366796, 3, 640x360 
0x12CB3460, 36963309558500816, 231366833, 231366835, 2, 640x360 
0x12CB3460, 36963309558822416, 231366875, 231366879, 4, 640x360 
0x12CB3460, 36963309559140904, 231366893, 231366895, 2, 640x360 
0x12CB3460, 36963309559461008, 231366922, 231366925, 3, 640x360 
0x12CB3460, 36963309559781168, 231366953, 231366957, 4, 640x360 
0x12CB3460, 36963309560100544, 231366992, 231366995, 3, 640x360 
0x12CB3460, 36963309560420448, 231367022, 231367025, 3, 640x360 
0x12CB3460, 36963309560900848, 231367063, 231367068, 5, 640x360 
0x12CB3460, 36963309561220992, 231367098, 231367103, 5, 640x360 
0x12CB3460, 36963309561555640, 231367132, 231367135, 3, 640x360 
0x12CB3460, 36963309561862672, 231367163, 231367167, 4, 640x360 
0x12CB3460, 36963309562180744, 231367192, 231367195, 3, 640x360 
0x12CB3460, 36963309562502368, 231367224, 231367228, 4, 640x360 
0x12CB3460, 36963309562819816, 231367263, 231367265, 2, 640x360 
0x12CB3460, 36963309563141976, 231367292, 231367295, 3, 640x360 
0x12CB3460, 36963309563459952, 231367323, 231367326, 3, 640x360 
0x12CB3460, 36963309563781848, 231367376, 231367380, 4, 640x360 
0x12CB3460, 36963309564101168, 231367383, 231367387, 4, 640x360 
0x12CB3460, 36963309564420968, 231367423, 231367425, 2, 640x360 
0x12CB3460, 36963309564902200, 231367473, 231367476, 3, 640x360 
0x12CB3460, 36963309565220464, 231367503, 231367521, 18, 640x360 
0x12CB3460, 36963309565541632, 231367533, 231367536, 3, 640x360 
0x12CB3460, 36963309565860232, 231367564, 231367567, 3, 640x360 
0x12CB3460, 36963309566180800, 231367593, 231367596, 3, 640x360 
0x12CB3460, 36963309566502488, 231367627, 231367630, 3, 640x360 
0x12CB3460, 36963309566820576, 231367662, 231367665, 3, 640x360 
0x12CB3460, 36963309567140880, 231367692, 231367695, 3, 640x360 
0x12CB3460, 36963309567463264, 231367724, 231367727, 3, 640x360 
0x12CB3460, 36963309567779656, 231367753, 231367756, 3, 640x360 
0x12CB3460, 36963309568101904, 231367784, 231367788, 4, 640x360 
0x12CB3460, 36963309568420080, 231367823, 231367826, 3, 640x360 
0x12CB3460, 36963309568901472, 231367873, 231367876, 3, 640x360 
0x12CB3460, 36963309569221176, 231367902, 231367905, 3, 640x360 
0x12CB3460, 36963309569541496, 231367932, 231367935, 3, 640x360 
0x12CB3460, 36963309569861960, 231367963, 231367966, 3, 640x360 
0x12CB3460, 36963309570180864, 231367992, 231367995, 3, 640x360 
0x12CB3460, 36963309570500752, 231368034, 231368037, 3, 640x360 
0x12CB3460, 36963309570820496, 231368063, 231368066, 3, 640x360 
0x12CB3460, 36963309571140456, 231368092, 231368095, 3, 640x360 
0x12CB3460, 36963309571459832, 231368123, 231368128, 5, 640x360 
0x12CB3460, 36963309571780720, 231368153, 231368171, 18, 640x360 
0x12CB3460, 36963309572101352, 231368183, 231368187, 4, 640x360 
0x12CB3460, 36963309572580840, 231368232, 231368235, 3, 640x360 
0x12CB3460, 36963309572900992, 231368265, 231368268, 3, 640x360 
0x12CB3460, 36963309573220880, 231368302, 231368306, 4, 640x360 
0x12CB3460, 36963309573542992, 231368332, 231368335, 3, 640x360 
0x12CB3460, 36963309573862000, 231368378, 231368381, 3, 640x360 
0x12CB3460, 36963309574180048, 231368393, 231368397, 4, 640x360 
0x12CB3460, 36963309574501104, 231368423, 231368427, 4, 640x360 
0x12CB3460, 36963309574822184, 231368463, 231368465, 2, 640x360 
0x12CB3460, 36963309575141808, 231368492, 231368495, 3, 640x360 
0x12CB3460, 36963309575461552, 231368523, 231368526, 3, 640x360 
0x12CB3460, 36963309575787488, 231368552, 231368556, 4, 640x360 
0x12CB3460, 36963309576101632, 231368583, 231368587, 4, 640x360 
0x12CB3460, 36963309576581312, 231368633, 231368636, 3, 640x360 
0x12CB3460, 36963309576901608, 231368663, 231368667, 4, 640x360 
0x12CB3460, 36963309577221440, 231368703, 231368706, 3, 640x360 
0x12CB3460, 36963309577541888, 231368733, 231368750, 17, 640x360 
0x12CB3460, 36963309577860792, 231368762, 231368765, 3, 640x360 
0x12CB3460, 36963309578181496, 231368794, 231368796, 2, 640x360 
0x12CB3460, 36963309578499928, 231368833, 231368836, 3, 640x360 
0x12CB3460, 36963309578821144, 231368878, 231368882, 4, 640x360 
0x12CB3460, 36963309579139888, 231368893, 231368895, 2, 640x360 
0x12CB3460, 36963309579461264, 231368922, 231368925, 3, 640x360 
0x12CB3460, 36963309579782576, 231368953, 231368955, 2, 640x360 
0x12CB3460, 36963309580102216, 231368992, 231368995, 3, 640x360 
0x12CB3460, 36963309580580704, 231369033, 231369035, 2, 640x360 
0x12CB3460, 36963309580899480, 231369062, 231369066, 4, 640x360 
0x12CB3460, 36963309581221016, 231369103, 231369106, 3, 640x360 
0x12CB3460, 36963309581543608, 231369132, 231369135, 3, 640x360 
0x12CB3460, 36963309581861376, 231369163, 231369166, 3, 640x360 
0x12CB3460, 36963309582182208, 231369193, 231369196, 3, 640x360 
0x12CB3460, 36963309582502136, 231369226, 231369229, 3, 640x360 
0x12CB3460, 36963309582820240, 231369263, 231369265, 2, 640x360 
0x12CB3460, 36963309583140992, 231369292, 231369297, 5, 640x360 
0x12CB3460, 36963309583461248, 231369322, 231369325, 3, 640x360 
0x12CB3460, 36963309583781512, 231369377, 231369380, 3, 640x360 
0x12CB3460, 36963309584259336, 231369403, 231369407, 4, 640x360 
0x12CB3460, 36963309584581216, 231369433, 231369436, 3, 640x360 
0x12CB3460, 36963309584901824, 231369473, 231369476, 3, 640x360 
0x12CB3460, 36963309585219664, 231369503, 231369521, 18, 640x360 
0x12CB3460, 36963309585540016, 231369533, 231369536, 3, 640x360 
0x12CB3460, 36963309585862000, 231369563, 231369566, 3, 640x360 
0x12CB3460, 36963309586179936, 231369592, 231369596, 4, 640x360 
0x12CB3460, 36963309586500416, 231369623, 231369626, 3, 640x360 
0x12CB3460, 36963309586819848, 231369663, 231369665, 2, 640x360 
0x12CB3460, 36963309587141752, 231369693, 231369696, 3, 640x360 
0x12CB3460, 36963309587461712, 231369723, 231369727, 4, 640x360 
0x12CB3460, 36963309587780480, 231369753, 231369771, 18, 640x360 
0x12CB3460, 36963309588262048, 231369803, 231369805, 2, 640x360 
0x12CB3460, 36963309588581384, 231369832, 231369836, 4, 640x360 
0x12CB3460, 36963309588903064, 231369881, 231369883, 2, 640x360 
0x12CB3460, 36963309589220576, 231369903, 231369905, 2, 640x360 
0x12CB3460, 36963309589541288, 231369933, 231369935, 2, 640x360 
0x12CB3460, 36963309589860472, 231369964, 231369967, 3, 640x360 
0x12CB3460, 36963309590180480, 231369993, 231369995, 2, 640x360 
0x12CB3460, 36963309590501224, 231370023, 231370027, 4, 640x360 
0x12CB3460, 36963309590820264, 231370062, 231370065, 3, 640x360 
0x12CB3460, 36963309591141120, 231370093, 231370096, 3, 640x360 
0x12CB3460, 36963309591460200, 231370123, 231370125, 2, 640x360 
0x12CB3460, 36963309591939336, 231370172, 231370175, 3, 640x360 
0x12CB3460, 36963309592259968, 231370202, 231370205, 3, 640x360 
0x12CB3460, 36963309592580608, 231370233, 231370236, 3, 640x360 
0x12CB3460, 36963309592901032, 231370264, 231370267, 3, 640x360 
0x12CB3460, 36963309593224352, 231370303, 231370305, 2, 640x360 
0x12CB3460, 36963309593540104, 231370332, 231370335, 3, 640x360 
0x12CB3460, 36963309593862408, 231370372, 231370375, 3, 640x360 
0x12CB3460, 36963309594180080, 231370392, 231370395, 3, 640x360 
0x12CB3460, 36963309594500056, 231370424, 231370428, 4, 640x360 
0x12CB3460, 36963309594821848, 231370463, 231370466, 3, 640x360 
0x12CB3460, 36963309595141488, 231370492, 231370494, 2, 640x360 
0x12CB3460, 36963309595461688, 231370522, 231370525, 3, 640x360 
0x12CB3460, 36963309595942440, 231370572, 231370575, 3, 640x360 
0x12CB3460, 36963309596261784, 231370604, 231370607, 3, 640x360 
0x12CB3460, 36963309596581024, 231370633, 231370636, 3, 640x360 
0x12CB3460, 36963309596899552, 231370673, 231370677, 4, 640x360 
0x12CB3460, 36963309597219776, 231370704, 231370706, 2, 640x360 
0x12CB3460, 36963309597541832, 231370732, 231370735, 3, 640x360 
0x12CB3460, 36963309597860936, 231370763, 231370766, 3, 640x360 
0x12CB3460, 36963309598179792, 231370793, 231370796, 3, 640x360 
0x12CB3460, 36963309598500688, 231370823, 231370830, 7, 640x360 
0x12CB3460, 36963309598821264, 231370871, 231370874, 3, 640x360 
0x12CB3460, 36963309599140560, 231370892, 231370896, 4, 640x360 
0x12CB3460, 36963309599462688, 231370924, 231370928, 4, 640x360 
0x12CB3460, 36963309599941688, 231370973, 231370977, 4, 640x360 
0x12CB3460, 36963309600261368, 231371003, 231371005, 2, 640x360 
0x12CB3460, 36963309600581736, 231371034, 231371037, 3, 640x360 
0x12CB3460, 36963309600902424, 231371064, 231371069, 5, 640x360 
0x12CB3460, 36963309601219928, 231371102, 231371105, 3, 640x360 
0x12CB3460, 36963309601541168, 231371133, 231371136, 3, 640x360 
0x12CB3460, 36963309601861248, 231371162, 231371165, 3, 640x360 
0x12CB3460, 36963309602182176, 231371193, 231371196, 3, 640x360 
0x12CB3460, 36963309602501464, 231371225, 231371230, 5, 640x360 
0x12CB3460, 36963309602820432, 231371263, 231371265, 2, 640x360 
0x12CB3460, 36963309603140896, 231371292, 231371295, 3, 640x360 
0x12CB3460, 36963309603620536, 231371342, 231371345, 3, 640x360 
0x12CB3460, 36963309603942856, 231371380, 231371383, 3, 640x360 
0x12CB3460, 36963309604260784, 231371402, 231371405, 3, 640x360 
0x12CB3460, 36963309604580376, 231371434, 231371436, 2, 640x360 
0x12CB3460, 36963309604900104, 231371472, 231371477, 5, 640x360 
0x12CB3460, 36963309605222136, 231371503, 231371506, 3, 640x360 
0x12CB3460, 36963309605540704, 231371532, 231371535, 3, 640x360 
0x12CB3460, 36963309605859360, 231371563, 231371566, 3, 640x360 
0x12CB3460, 36963309606180512, 231371592, 231371595, 3, 640x360 
0x12CB3460, 36963309606500464, 231371624, 231371627, 3, 640x360 
0x12CB3460, 36963309606820856, 231371662, 231371665, 3, 640x360 
0x12CB3460, 36963309607142800, 231371692, 231371695, 3, 640x360 
0x12CB3460, 36963309607619736, 231371743, 231371746, 3, 640x360 
0x12CB3460, 36963309607940176, 231371772, 231371774, 2, 640x360 
0x12CB3460, 36963309608259688, 231371803, 231371807, 4, 640x360 
0x12CB3460, 36963309608579832, 231371832, 231371836, 4, 640x360 
0x12CB3460, 36963309608901136, 231371876, 231371879, 3, 640x360 
0x12CB3460, 36963309609221040, 231371903, 231371906, 3, 640x360 
0x12CB3460, 36963309609540784, 231371933, 231371936, 3, 640x360 
0x12CB3460, 36963309609859936, 231371962, 231371965, 3, 640x360 
0x12CB3460, 36963309610180200, 231371992, 231371995, 3, 640x360 
0x12CB3460, 36963309610500584, 231372033, 231372036, 3, 640x360 
0x12CB3460, 36963309610821376, 231372062, 231372066, 4, 640x360 
0x12CB3460, 36963309611141152, 231372093, 231372096, 3, 640x360 
0x12CB3460, 36963309611621000, 231372142, 231372145, 3, 640x360 
0x12CB3460, 36963309611939288, 231372172, 231372175, 3, 640x360 
0x12CB3460, 36963309612259896, 231372202, 231372205, 3, 640x360 
0x12CB3460, 36963309612582688, 231372233, 231372236, 3, 640x360 
0x12CB3460, 36963309612900984, 231372264, 231372267, 3, 640x360 
0x12CB3460, 36963309613221152, 231372302, 231372305, 3, 640x360 
0x12CB3460, 36963309613540384, 231372332, 231372335, 3, 640x360 
0x12CB3460, 36963309613861664, 231372371, 231372374, 3, 640x360 
0x12CB3460, 36963309614180432, 231372392, 231372395, 3, 640x360 
0x12CB3460, 36963309614499712, 231372423, 231372427, 4, 640x360 
0x12CB3460, 36963309614820720, 231372462, 231372465, 3, 640x360 
0x12CB3460, 36963309615305232, 231372513, 231372516, 3, 640x360 
0x12CB3460, 36963309615621224, 231372543, 231372545, 2, 640x360 
0x12CB3460, 36963309615940208, 231372572, 231372575, 3, 640x360 
0x12CB3460, 36963309616259808, 231372603, 231372606, 3, 640x360 
0x12CB3460, 36963309616580248, 231372632, 231372636, 4, 640x360 
0x12CB3460, 36963309616900536, 231372663, 231372666, 3, 640x360 
0x12CB3460, 36963309617220544, 231372702, 231372705, 3, 640x360 
0x12CB3460, 36963309617542400, 231372733, 231372736, 3, 640x360 
0x12CB3460, 36963309617860064, 231372762, 231372765, 3, 640x360 
0x12CB3460, 36963309618180632, 231372793, 231372796, 3, 640x360 
0x12CB3460, 36963309618503008, 231372833, 231372836, 3, 640x360 
0x12CB3460, 36963309618822272, 231372873, 231372876, 3, 640x360 
0x12CB3460, 36963309619301056, 231372913, 231372916, 3, 640x360 
0x12CB3460, 36963309619619144, 231372942, 231372945, 3, 640x360 
0x12CB3460, 36963309619940720, 231372973, 231372976, 3, 640x360 
0x12CB3460, 36963309620266784, 231373003, 231373006, 3, 640x360 
0x12CB3460, 36963309620579904, 231373033, 231373036, 3, 640x360 
0x12CB3460, 36963309620899600, 231373063, 231373067, 4, 640x360 
0x12CB3460, 36963309621221168, 231373102, 231373105, 3, 640x360 
0x12CB3460, 36963309621539272, 231373133, 231373135, 2, 640x360 
0x12CB3460, 36963309621860168, 231373163, 231373166, 3, 640x360 
0x12CB3460, 36963309622181832, 231373193, 231373195, 2, 640x360 
0x12CB3460, 36963309622499432, 231373232, 231373235, 3, 640x360 
0x12CB3460, 36963309622820416, 231373262, 231373266, 4, 640x360 
0x12CB3460, 36963309623298792, 231373303, 231373307, 4, 640x360 
0x12CB3460, 36963309623620568, 231373343, 231373345, 2, 640x360 
0x12CB3460, 36963309623941640, 231373377, 231373380, 3, 640x360 
0x12CB3460, 36963309624260400, 231373402, 231373404, 2, 640x360 
0x12CB3460, 36963309624581000, 231373433, 231373436, 3, 640x360 
0x12CB3460, 36963309624901912, 231373464, 231373467, 3, 640x360 
0x12CB3460, 36963309625219928, 231373502, 231373504, 2, 640x360 
0x12CB3460, 36963309625539840, 231373532, 231373535, 3, 640x360 
0x12CB3460, 36963309625859104, 231373562, 231373564, 2, 640x360 
0x12CB3460, 36963309626180656, 231373593, 231373595, 2, 640x360 
0x12CB3460, 36963309626499768, 231373623, 231373627, 4, 640x360 
0x12CB3460, 36963309626980840, 231373672, 231373676, 4, 640x360 
0x12CB3460, 36963309627300928, 231373703, 231373707, 4, 640x360 
0x12CB3460, 36963309627622056, 231373743, 231373746, 3, 640x360 
0x12CB3460, 36963309627939392, 231373772, 231373775, 3, 640x360 
0x12CB3460, 36963309628259936, 231373802, 231373805, 3, 640x360 
0x12CB3460, 36963309628580736, 231373832, 231373836, 4, 640x360 
0x12CB3460, 36963309628901232, 231373870, 231373873, 3, 640x360 
0x12CB3460, 36963309629219432, 231373903, 231373906, 3, 640x360 
0x12CB3460, 36963309629540232, 231373933, 231373936, 3, 640x360 
0x12CB3460, 36963309629864336, 231373964, 231373968, 4, 640x360 
0x12CB3460, 36963309630182480, 231373994, 231374000, 6, 640x360 
0x12CB3460, 36963309630502600, 231374023, 231374029, 6, 640x360 
0x12CB3460, 36963309630982656, 231374074, 231374080, 6, 640x360 
0x12CB3460, 36963309631302688, 231374113, 231374117, 4, 640x360 
0x12CB3460, 36963309631619552, 231374143, 231374149, 6, 640x360 
0x12CB3460, 36963309631940512, 231374172, 231374175, 3, 640x360 
0x12CB3460, 36963309632260592, 231374203, 231374206, 3, 640x360 
0x12CB3460, 36963309632580880, 231374233, 231374235, 2, 640x360 
0x12CB3460, 36963309632900840, 231374263, 231374267, 4, 640x360 
0x12CB3460, 36963309633221960, 231374303, 231374305, 2, 640x360 
0x12CB3460, 36963309633540288, 231374332, 231374335, 3, 640x360 
0x12CB3460, 36963309633861904, 231374378, 231374381, 3, 640x360 
0x12CB3460, 36963309634179984, 231374393, 231374395, 2, 640x360 
0x12CB3460, 36963309634661120, 231374442, 231374445, 3, 640x360 
0x12CB3460, 36963309634980480, 231374473, 231374476, 3, 640x360 
0x12CB3460, 36963309635300432, 231374503, 231374507, 4, 640x360 
0x12CB3460, 36963309635619664, 231374542, 231374545, 3, 640x360 
0x12CB3460, 36963309635939424, 231374573, 231374575, 2, 640x360 
0x12CB3460, 36963309636262160, 231374603, 231374605, 2, 640x360 
0x12CB3460, 36963309636580872, 231374633, 231374637, 4, 640x360 
0x12CB3460, 36963309636900296, 231374673, 231374675, 2, 640x360 
0x12CB3460, 36963309637220552, 231374703, 231374706, 3, 640x360 
0x12CB3460, 36963309637540496, 231374733, 231374736, 3, 640x360 
0x12CB3460, 36963309637861624, 231374762, 231374766, 4, 640x360 
0x12CB3460, 36963309638180512, 231374794, 231374797, 3, 640x360 
0x12CB3460, 36963309638659344, 231374843, 231374845, 2, 640x360 
0x12CB3460, 36963309638981104, 231374877, 231374880, 3, 640x360 
0x12CB3460, 36963309639300952, 231374903, 231374908, 5, 640x360 
0x12CB3460, 36963309639620288, 231374943, 231374946, 3, 640x360 
0x12CB3460, 36963309639941664, 231374972, 231374975, 3, 640x360 
0x12CB3460, 36963309640259568, 231375003, 231375006, 3, 640x360 
0x12CB3460, 36963309640581240, 231375033, 231375036, 3, 640x360 
0x12CB3460, 36963309640899224, 231375073, 231375076, 3, 640x360 
0x12CB3460, 36963309641219192, 231375102, 231375105, 3, 640x360 
0x12CB3460, 36963309641540984, 231375133, 231375136, 3, 640x360 
0x12CB3460, 36963309641861392, 231375162, 231375165, 3, 640x360 
0x12CB3460, 36963309642179936, 231375193, 231375196, 3, 640x360 
0x12CB3460, 36963309642662304, 231375243, 231375245, 2, 640x360 
0x12CB3460, 36963309642979344, 231375274, 231375277, 3, 640x360 
0x12CB3460, 36963309643301280, 231375304, 231375308, 4, 640x360 
0x12CB3460, 36963309643619856, 231375342, 231375345, 3, 640x360 
0x12CB3460, 36963309643940352, 231375371, 231375374, 3, 640x360 
0x12CB3460, 36963309644260832, 231375402, 231375405, 3, 640x360 
0x12CB3460, 36963309644581216, 231375432, 231375435, 3, 640x360 
0x12CB3460, 36963309644902248, 231375472, 231375475, 3, 640x360 
0x12CB3460, 36963309645221232, 231375504, 231375506, 2, 640x360 
0x12CB3460, 36963309645541984, 231375532, 231375535, 3, 640x360 
0x12CB3460, 36963309645862000, 231375563, 231375566, 3, 640x360 
0x12CB3460, 36963309646341688, 231375613, 231375616, 3, 640x360 
0x12CB3460, 36963309646663008, 231375643, 231375646, 3, 640x360 
0x12CB3460, 36963309646981600, 231375673, 231375677, 4, 640x360 
0x12CB3460, 36963309647302752, 231375713, 231375716, 3, 640x360 
0x12CB3460, 36963309647621776, 231375742, 231375746, 4, 640x360 
0x12CB3460, 36963309647939616, 231375772, 231375775, 3, 640x360 
0x12CB3460, 36963309648261944, 231375804, 231375807, 3, 640x360 
0x12CB3460, 36963309648582176, 231375833, 231375836, 3, 640x360 
0x12CB3460, 36963309648904920, 231375887, 231375890, 3, 640x360 
0x12CB3460, 36963309649221168, 231375895, 231375899, 4, 640x360 
0x12CB3460, 36963309649541192, 231375933, 231375951, 18, 640x360 
0x12CB3460, 36963309649860088, 231375963, 231375966, 3, 640x360 
0x12CB3460, 36963309650340312, 231376012, 231376014, 2, 640x360 
0x12CB3460, 36963309650661296, 231376042, 231376046, 4, 640x360 
0x12CB3460, 36963309650979632, 231376072, 231376075, 3, 640x360 
0x12CB3460, 36963309651300168, 231376103, 231376107, 4, 640x360 
0x12CB3460, 36963309651620528, 231376143, 231376145, 2, 640x360 
0x12CB3460, 36963309651940120, 231376172, 231376175, 3, 640x360 
0x12CB3460, 36963309652261112, 231376204, 231376222, 18, 640x360 
0x12CB3460, 36963309652581576, 231376233, 231376237, 4, 640x360 
0x12CB3460, 36963309652900480, 231376264, 231376276, 12, 640x360 
0x12CB3460, 36963309653220752, 231376303, 231376305, 2, 640x360 
0x12CB3460, 36963309653541096, 231376332, 231376336, 4, 640x360 
0x12CB3460, 36963309653861456, 231376371, 231376375, 4, 640x360 
0x12CB3460, 36963309654338808, 231376413, 231376415, 2, 640x360 
0x12CB3460, 36963309654660168, 231376443, 231376445, 2, 640x360 
0x12CB3460, 36963309654980784, 231376472, 231376479, 7, 640x360 
0x12CB3460, 36963309655306040, 231376503, 231376508, 5, 640x360 
0x12CB3460, 36963309655620584, 231376543, 231376546, 3, 640x360 
0x12CB3460, 36963309655942064, 231376572, 231376575, 3, 640x360 
0x12CB3460, 36963309656259136, 231376603, 231376606, 3, 640x360 
0x12CB3460, 36963309656578920, 231376632, 231376634, 2, 640x360 
0x12CB3460, 36963309656899800, 231376672, 231376675, 3, 640x360 
0x12CB3460, 36963309657219848, 231376703, 231376705, 2, 640x360 
0x12CB3460, 36963309657540792, 231376732, 231376750, 18, 640x360 
0x12CB3460, 36963309658020648, 231376783, 231376785, 2, 640x360 
0x12CB3460, 36963309658339800, 231376812, 231376815, 3, 640x360 
0x12CB3460, 36963309658661600, 231376843, 231376847, 4, 640x360 
0x12CB3460, 36963309658979680, 231376875, 231376879, 4, 640x360 
0x12CB3460, 36963309659299008, 231376903, 231376907, 4, 640x360 
0x12CB3460, 36963309659621304, 231376943, 231376946, 3, 640x360 
0x12CB3460, 36963309659940864, 231376972, 231376975, 3, 640x360 
0x12CB3460, 36963309660262192, 231377003, 231377022, 19, 640x360 
0x12CB3460, 36963309660580536, 231377032, 231377035, 3, 640x360 
0x12CB3460, 36963309660900504, 231377063, 231377068, 5, 640x360 
0x12CB3460, 36963309661221800, 231377102, 231377105, 3, 640x360 
0x12CB3460, 36963309661540008, 231377132, 231377135, 3, 640x360 
0x12CB3460, 36963309662019096, 231377183, 231377186, 3, 640x360 
0x12CB3460, 36963309662338968, 231377213, 231377215, 2, 640x360 
0x12CB3460, 36963309662659144, 231377242, 231377246, 4, 640x360 
0x12CB3460, 36963309662979896, 231377273, 231377276, 3, 640x360 
0x12CB3460, 36963309663301248, 231377314, 231377318, 4, 640x360 
0x12CB3460, 36963309663620504, 231377342, 231377345, 3, 640x360 
0x12CB3460, 36963309663941680, 231377376, 231377380, 4, 640x360 
0x12CB3460, 36963309664258872, 231377402, 231377405, 3, 640x360 
0x12CB3460, 36963309664579368, 231377433, 231377436, 3, 640x360 
0x12CB3460, 36963309664905112, 231377472, 231377475, 3, 640x360 
0x12CB3460, 36963309665221624, 231377503, 231377506, 3, 640x360 
0x12CB3460, 36963309665700088, 231377552, 231377555, 3, 640x360 
0x12CB3460, 36963309666019184, 231377583, 231377585, 2, 640x360 
0x12CB3460, 36963309666341112, 231377612, 231377615, 3, 640x360 
0x12CB3460, 36963309666661896, 231377643, 231377646, 3, 640x360 
0x12CB3460, 36963309666980968, 231377673, 231377676, 3, 640x360 
0x12CB3460, 36963309667301496, 231377713, 231377716, 3, 640x360 
0x12CB3460, 36963309667621128, 231377742, 231377745, 3, 640x360 
0x12CB3460, 36963309667940448, 231377774, 231377791, 17, 640x360 
0x12CB3460, 36963309668260144, 231377804, 231377807, 3, 640x360 
0x12CB3460, 36963309668581224, 231377833, 231377836, 3, 640x360 
0x12CB3460, 36963309668902384, 231377879, 231377882, 3, 640x360 
0x12CB3460, 36963309669220376, 231377903, 231377905, 2, 640x360 
0x12CB3460, 36963309669701288, 231377953, 231377956, 3, 640x360 
0x12CB3460, 36963309670020312, 231377982, 231377985, 3, 640x360 
0x12CB3460, 36963309670342608, 231378013, 231378016, 3, 640x360 
0x12CB3460, 36963309670660688, 231378043, 231378046, 3, 640x360 
0x12CB3460, 36963309670979512, 231378072, 231378075, 3, 640x360 
0x12CB3460, 36963309671300136, 231378103, 231378107, 4, 640x360 
0x12CB3460, 36963309671620360, 231378142, 231378145, 3, 640x360 
0x12CB3460, 36963309671942392, 231378173, 231378176, 3, 640x360 
0x12CB3460, 36963309672260592, 231378202, 231378206, 4, 640x360 
0x12CB3460, 36963309672580584, 231378232, 231378236, 4, 640x360 
0x12CB3460, 36963309672900920, 231378265, 231378268, 3, 640x360 
0x12CB3460, 36963309673220168, 231378302, 231378305, 3, 640x360 
0x12CB3460, 36963309673700480, 231378368, 231378371, 3, 640x360 
0x12CB3460, 36963309674020752, 231378382, 231378384, 2, 640x360 
0x12CB3460, 36963309674340128, 231378413, 231378415, 2, 640x360 
0x12CB3460, 36963309674658880, 231378443, 231378446, 3, 640x360 
0x12CB3460, 36963309674980344, 231378473, 231378476, 3, 640x360 
0x12CB3460, 36963309675300680, 231378503, 231378508, 5, 640x360 
0x12CB3460, 36963309675620344, 231378543, 231378545, 2, 640x360 
0x12CB3460, 36963309675939120, 231378572, 231378575, 3, 640x360 
0x12CB3460, 36963309676261816, 231378603, 231378606, 3, 640x360 
0x12CB3460, 36963309676580304, 231378632, 231378636, 4, 640x360 
0x12CB3460, 36963309676906120, 231378665, 231378669, 4, 640x360 
0x12CB3460, 36963309677379960, 231378713, 231378715, 2, 640x360 
0x12CB3460, 36963309677698568, 231378753, 231378756, 3, 640x360 
0x12CB3460, 36963309678018784, 231378783, 231378785, 2, 640x360 
0x12CB3460, 36963309678341080, 231378813, 231378815, 2, 640x360 
0x12CB3460, 36963309678659184, 231378843, 231378845, 2, 640x360 
0x12CB3460, 36963309678980896, 231378883, 231378886, 3, 640x360 
0x12CB3460, 36963309679301240, 231378913, 231378916, 3, 640x360 
0x12CB3460, 36963309679619280, 231378942, 231378945, 3, 640x360 
0x12CB3460, 36963309679941504, 231378972, 231378975, 3, 640x360 
0x12CB3460, 36963309680261784, 231379003, 231379007, 4, 640x360 
0x12CB3460, 36963309680579904, 231379033, 231379036, 3, 640x360 
0x12CB3460, 36963309680899832, 231379063, 231379066, 3, 640x360 
0x12CB3460, 36963309681381192, 231379113, 231379116, 3, 640x360 
0x12CB3460, 36963309681699968, 231379143, 231379146, 3, 640x360 
0x12CB3460, 36963309682019008, 231379182, 231379185, 3, 640x360 
0x12CB3460, 36963309682340752, 231379213, 231379216, 3, 640x360 
0x12CB3460, 36963309682660176, 231379242, 231379245, 3, 640x360 
0x12CB3460, 36963309682981344, 231379273, 231379277, 4, 640x360 
0x12CB3460, 36963309683303712, 231379304, 231379308, 4, 640x360 
0x12CB3460, 36963309683621152, 231379342, 231379345, 3, 640x360 
0x12CB3460, 36963309683942440, 231379377, 231379380, 3, 640x360 
0x12CB3460, 36963309684260504, 231379402, 231379405, 3, 640x360 
0x12CB3460, 36963309684581064, 231379433, 231379451, 18, 640x360 
0x12CB3460, 36963309684901008, 231379474, 231379477, 3, 640x360 
0x12CB3460, 36963309685382720, 231379513, 231379516, 3, 640x360 
0x12CB3460, 36963309685700032, 231379543, 231379547, 4, 640x360 
0x12CB3460, 36963309686020152, 231379583, 231379586, 3, 640x360 
0x12CB3460, 36963309686339680, 231379612, 231379615, 3, 640x360 
0x12CB3460, 36963309686661544, 231379644, 231379651, 7, 640x360 
0x12CB3460, 36963309686979912, 231379673, 231379677, 4, 640x360 
0x12CB3460, 36963309687304472, 231379713, 231379716, 3, 640x360 
0x12CB3460, 36963309687622456, 231379742, 231379745, 3, 640x360 
0x12CB3460, 36963309687940208, 231379772, 231379775, 3, 640x360 
0x12CB3460, 36963309688261520, 231379803, 231379806, 3, 640x360 
0x12CB3460, 36963309688580776, 231379833, 231379836, 3, 640x360 
0x12CB3460, 36963309689059880, 231379883, 231379886, 3, 640x360 
0x12CB3460, 36963309689378920, 231379912, 231379915, 3, 640x360 
0x12CB3460, 36963309689700848, 231379943, 231379947, 4, 640x360 
0x12CB3460, 36963309690021696, 231379982, 231379985, 3, 640x360 
0x12CB3460, 36963309690339360, 231380012, 231380015, 3, 640x360 
0x12CB3460, 36963309690659792, 231380042, 231380045, 3, 640x360 
0x12CB3460, 36963309690980016, 231380073, 231380076, 3, 640x360 
0x12CB3460, 36963309691300056, 231380113, 231380116, 3, 640x360 
0x12CB3460, 36963309691618880, 231380142, 231380145, 3, 640x360 
0x12CB3460, 36963309691940096, 231380173, 231380177, 4, 640x360 
0x12CB3460, 36963309692260648, 231380202, 231380205, 3, 640x360 
0x12CB3460, 36963309692581744, 231380233, 231380237, 4, 640x360 
0x12CB3460, 36963309693060512, 231380283, 231380285, 2, 640x360 
0x12CB3460, 36963309693381256, 231380313, 231380318, 5, 640x360 
0x12CB3460, 36963309693699984, 231380368, 231380371, 3, 640x360 
0x12CB3460, 36963309694020656, 231380375, 231380379, 4, 640x360 
0x12CB3460, 36963309694338904, 231380413, 231380416, 3, 640x360 
0x12CB3460, 36963309694660280, 231380442, 231380445, 3, 640x360 
0x12CB3460, 36963309694979536, 231380472, 231380476, 4, 640x360 
0x12CB3460, 36963309695299936, 231380503, 231380507, 4, 640x360 
0x12CB3460, 36963309695620000, 231380542, 231380545, 3, 640x360 
0x12CB3460, 36963309695940056, 231380571, 231380574, 3, 640x360 
0x12CB3460, 36963309696261344, 231380603, 231380605, 2, 640x360 
0x12CB3460, 36963309696581864, 231380632, 231380635, 3, 640x360 
0x12CB3460, 36963309697060656, 231380682, 231380685, 3, 640x360 
0x12CB3460, 36963309697381192, 231380712, 231380715, 3, 640x360 
0x12CB3460, 36963309697702584, 231380744, 231380748, 4, 640x360 
0x12CB3460, 36963309698021144, 231380783, 231380786, 3, 640x360 
0x12CB3460, 36963309698340936, 231380813, 231380816, 3, 640x360 
0x12CB3460, 36963309698662072, 231380842, 231380845, 3, 640x360 
0x12CB3460, 36963309698979984, 231380875, 231380878, 3, 640x360 
0x12CB3460, 36963309699299664, 231380903, 231380907, 4, 640x360 
0x12CB3460, 36963309699619528, 231380943, 231380945, 2, 640x360 
0x12CB3460, 36963309699939888, 231380972, 231380975, 3, 640x360 
0x12CB3460, 36963309700261128, 231381003, 231381005, 2, 640x360 
0x12CB3460, 36963309700739088, 231381052, 231381055, 3, 640x360 
0x12CB3460, 36963309701061312, 231381083, 231381086, 3, 640x360 
0x12CB3460, 36963309701380232, 231381113, 231381116, 3, 640x360 
0x12CB3460, 36963309701700824, 231381143, 231381147, 4, 640x360 
0x12CB3460, 36963309702018944, 231381182, 231381185, 3, 640x360 
0x12CB3460, 36963309702339848, 231381213, 231381215, 2, 640x360 
0x12CB3460, 36963309702659984, 231381242, 231381245, 3, 640x360 
0x12CB3460, 36963309702979664, 231381274, 231381276, 2, 640x360 
0x12CB3460, 36963309703300440, 231381304, 231381308, 4, 640x360 
0x12CB3460, 36963309703622656, 231381342, 231381345, 3, 640x360 
0x12CB3460, 36963309703942472, 231381388, 231381391, 3, 640x360 
0x12CB3460, 36963309704267808, 231381403, 231381406, 3, 640x360 
0x12CB3460, 36963309704738512, 231381452, 231381455, 3, 640x360 
0x12CB3460, 36963309705060000, 231381482, 231381486, 4, 640x360 
0x12CB3460, 36963309705380608, 231381513, 231381516, 3, 640x360 
0x12CB3460, 36963309705700712, 231381544, 231381547, 3, 640x360 
0x12CB3460, 36963309706020288, 231381583, 231381586, 3, 640x360 
0x12CB3460, 36963309706341048, 231381613, 231381615, 2, 640x360 
0x12CB3460, 36963309706659864, 231381643, 231381646, 3, 640x360 
0x12CB3460, 36963309706979808, 231381673, 231381676, 3, 640x360 
0x12CB3460, 36963309707302952, 231381713, 231381717, 4, 640x360 
0x12CB3460, 36963309707626312, 231381744, 231381749, 5, 640x360 
0x12CB3460, 36963309707940280, 231381773, 231381776, 3, 640x360 
0x12CB3460, 36963309708420568, 231381823, 231381826, 3, 640x360 
0x12CB3460, 36963309708740776, 231381881, 231381884, 3, 640x360 
0x12CB3460, 36963309709380552, 231381912, 231381915, 3, 640x360 
0x12CB3460, 36963309709700664, 231381944, 231381948, 4, 640x360 
0x12CB3460, 36963309710019408, 231381982, 231381985, 3, 640x360 
0x12CB3460, 36963309710339920, 231382012, 231382015, 3, 640x360 
0x12CB3460, 36963309710660256, 231382043, 231382047, 4, 640x360 
0x12CB3460, 36963309710979752, 231382073, 231382076, 3, 640x360 
0x12CB3460, 36963309711299856, 231382104, 231382108, 4, 640x360 
0x12CB3460, 36963309711620256, 231382143, 231382146, 3, 640x360 
0x12CB3460, 36963309711939920, 231382173, 231382177, 4, 640x360 
0x12CB3460, 36963309712420592, 231382223, 231382226, 3, 640x360 
0x12CB3460, 36963309712739200, 231382252, 231382255, 3, 640x360 
0x12CB3460, 36963309713060456, 231382283, 231382286, 3, 640x360 
0x12CB3460, 36963309713379640, 231382312, 231382316, 4, 640x360 
0x12CB3460, 36963309713703176, 231382358, 231382362, 4, 640x360 
0x12CB3460, 36963309714019720, 231382375, 231382381, 6, 640x360 
0x12CB3460, 36963309714340152, 231382412, 231382415, 3, 640x360 
0x12CB3460, 36963309714659696, 231382442, 231382451, 9, 640x360 
0x12CB3460, 36963309714979640, 231382473, 231382478, 5, 640x360 
0x12CB3460, 36963309715303280, 231382512, 231382515, 3, 640x360 
0x12CB3460, 36963309715619576, 231382542, 231382545, 3, 640x360 
0x12CB3460, 36963309715939776, 231382573, 231382575, 2, 640x360 
0x12CB3460, 36963309716421232, 231382622, 231382625, 3, 640x360 
0x12CB3460, 36963309716739688, 231382653, 231382655, 2, 640x360 
0x12CB3460, 36963309717061592, 231382682, 231382685, 3, 640x360 
0x12CB3460, 36963309717380456, 231382713, 231382716, 3, 640x360 
0x12CB3460, 36963309717699576, 231382743, 231382746, 3, 640x360 
0x12CB3460, 36963309718019584, 231382782, 231382785, 3, 640x360 
0x12CB3460, 36963309718339888, 231382812, 231382814, 2, 640x360 
0x12CB3460, 36963309718662688, 231382843, 231382846, 3, 640x360 
0x12CB3460, 36963309718979776, 231382875, 231382879, 4, 640x360 
0x12CB3460, 36963309719299936, 231382903, 231382906, 3, 640x360 
0x12CB3460, 36963309719620528, 231382943, 231382946, 3, 640x360 
0x12CB3460, 36963309720098400, 231382983, 231382986, 3, 640x360 
0x12CB3460, 36963309720418592, 231383023, 231383025, 2, 640x360 
0x12CB3460, 36963309720740416, 231383052, 231383055, 3, 640x360 
0x12CB3460, 36963309721061296, 231383082, 231383086, 4, 640x360 
0x12CB3460, 36963309721381088, 231383113, 231383116, 3, 640x360 
0x12CB3460, 36963309721699200, 231383153, 231383156, 3, 640x360 
0x12CB3460, 36963309722021032, 231383182, 231383185, 3, 640x360 
0x12CB3460, 36963309722340880, 231383213, 231383216, 3, 640x360 
0x12CB3460, 36963309722660096, 231383242, 231383245, 3, 640x360 
0x12CB3460, 36963309722979816, 231383273, 231383277, 4, 640x360 
0x12CB3460, 36963309723300768, 231383313, 231383318, 5, 640x360 
0x12CB3460, 36963309723621296, 231383342, 231383345, 3, 640x360 
0x12CB3460, 36963309724098816, 231383383, 231383387, 4, 640x360 
0x12CB3460, 36963309724418536, 231383423, 231383425, 2, 640x360 
0x12CB3460, 36963309724739576, 231383452, 231383455, 3, 640x360 
0x12CB3460, 36963309725058720, 231383483, 231383485, 2, 640x360 
0x12CB3460, 36963309725378888, 231383512, 231383515, 3, 640x360 
0x12CB3460, 36963309725702160, 231383552, 231383555, 3, 640x360 
0x12CB3460, 36963309726020040, 231383582, 231383585, 3, 640x360 
0x12CB3460, 36963309726339904, 231383613, 231383616, 3, 640x360 
0x12CB3460, 36963309726659008, 231383642, 231383645, 3, 640x360 
0x12CB3460, 36963309726987760, 231383673, 231383679, 6, 640x360 
0x12CB3460, 36963309727300088, 231383703, 231383708, 5, 640x360 
0x12CB3460, 36963309727620552, 231383743, 231383746, 3, 640x360 
0x12CB3460, 36963309728104808, 231383784, 231383789, 5, 640x360 
0x12CB3460, 36963309728420736, 231383822, 231383825, 3, 640x360 
0x12CB3460, 36963309728740104, 231383871, 231383874, 3, 640x360 
0x12CB3460, 36963309729059696, 231383883, 231383888, 5, 640x360 
0x12CB3460, 36963309729379488, 231383913, 231383915, 2, 640x360 
0x12CB3460, 36963309729700192, 231383943, 231383951, 8, 640x360 
0x12CB3460, 36963309730022448, 231383976, 231383980, 4, 640x360 
0x12CB3460, 36963309730338888, 231384013, 231384016, 3, 640x360 
0x12CB3460, 36963309730662104, 231384043, 231384046, 3, 640x360 
0x12CB3460, 36963309730979680, 231384072, 231384075, 3, 640x360 
0x12CB3460, 36963309731300480, 231384103, 231384107, 4, 640x360 
0x12CB3460, 36963309731780256, 231384152, 231384156, 4, 640x360 
0x12CB3460, 36963309732099120, 231384183, 231384187, 4, 640x360 
0x12CB3460, 36963309732418688, 231384222, 231384225, 3, 640x360 
0x12CB3460, 36963309732738568, 231384252, 231384254, 2, 640x360 
0x12CB3460, 36963309733059712, 231384282, 231384285, 3, 640x360 
0x12CB3460, 36963309733380848, 231384312, 231384318, 6, 640x360 
0x12CB3460, 36963309733700688, 231384342, 231384345, 3, 640x360 
0x12CB3460, 36963309734018936, 231384376, 231384381, 5, 640x360 
0x12CB3460, 36963309734340360, 231384413, 231384415, 2, 640x360 
0x12CB3460, 36963309734660856, 231384442, 231384445, 3, 640x360 
0x12CB3460, 36963309734979440, 231384473, 231384476, 3, 640x360 
0x12CB3460, 36963309735299264, 231384513, 231384515, 2, 640x360 
0x12CB3460, 36963309735778448, 231384553, 231384555, 2, 640x360 
0x12CB3460, 36963309736098480, 231384583, 231384586, 3, 640x360 
0x12CB3460, 36963309736419328, 231384622, 231384624, 2, 640x360 
0x12CB3460, 36963309736741168, 231384652, 231384655, 3, 640x360 
0x12CB3460, 36963309737061808, 231384682, 231384685, 3, 640x360 
0x12CB3460, 36963309737379048, 231384713, 231384717, 4, 640x360 
0x12CB3460, 36963309737699632, 231384753, 231384756, 3, 640x360 
0x12CB3460, 36963309738018984, 231384783, 231384787, 4, 640x360 
0x12CB3460, 36963309738339568, 231384812, 231384815, 3, 640x360 
0x12CB3460, 36963309738659232, 231384843, 231384846, 3, 640x360 
0x12CB3460, 36963309738979864, 231384882, 231384885, 3, 640x360 
0x12CB3460, 36963309739300880, 231384903, 231384907, 4, 640x360 
0x12CB3460, 36963309739780280, 231384952, 231384956, 4, 640x360 
0x12CB3460, 36963309740103936, 231384983, 231384987, 4, 640x360 
0x12CB3460, 36963309740419080, 231385022, 231385025, 3, 640x360 
0x12CB3460, 36963309740739624, 231385052, 231385055, 3, 640x360 
0x12CB3460, 36963309741059592, 231385082, 231385085, 3, 640x360 
0x12CB3460, 36963309741380384, 231385112, 231385115, 3, 640x360 
0x12CB3460, 36963309741699328, 231385152, 231385154, 2, 640x360 
0x12CB3460, 36963309742020736, 231385182, 231385185, 3, 640x360 
0x12CB3460, 36963309742339624, 231385213, 231385215, 2, 640x360 
0x12CB3460, 36963309742660896, 231385243, 231385246, 3, 640x360 
0x12CB3460, 36963309742978824, 231385273, 231385276, 3, 640x360 
0x12CB3460, 36963309743459576, 231385323, 231385326, 3, 640x360 
0x12CB3460, 36963309743780512, 231385372, 231385375, 3, 640x360 
0x12CB3460, 36963309744099784, 231385383, 231385387, 4, 640x360 
0x12CB3460, 36963309744419200, 231385422, 231385425, 3, 640x360 
0x12CB3460, 36963309744743744, 231385453, 231385457, 4, 640x360 
0x12CB3460, 36963309745060560, 231385483, 231385486, 3, 640x360 
0x12CB3460, 36963309745378784, 231385512, 231385515, 3, 640x360 
0x12CB3460, 36963309745698920, 231385542, 231385545, 3, 640x360 
0x12CB3460, 36963309746018608, 231385582, 231385585, 3, 640x360 
0x12CB3460, 36963309746339328, 231385613, 231385616, 3, 640x360 
0x12CB3460, 36963309746659424, 231385642, 231385645, 3, 640x360 
0x12CB3460, 36963309746980000, 231385673, 231385676, 3, 640x360 
0x12CB3460, 36963309747460600, 231385723, 231385726, 3, 640x360 
0x12CB3460, 36963309747779384, 231385752, 231385755, 3, 640x360 
0x12CB3460, 36963309748100144, 231385784, 231385787, 3, 640x360 
0x12CB3460, 36963309748419600, 231385823, 231385826, 3, 640x360 
0x12CB3460, 36963309748739416, 231385870, 231385872, 2, 640x360 
0x12CB3460, 36963309749059992, 231385883, 231385886, 3, 640x360 
0x12CB3460, 36963309749380040, 231385912, 231385916, 4, 640x360 
0x12CB3460, 36963309749701904, 231385954, 231385958, 4, 640x360 
0x12CB3460, 36963309750021144, 231385984, 231385988, 4, 640x360 
0x12CB3460, 36963309750339512, 231386012, 231386016, 4, 640x360 
0x12CB3460, 36963309750662912, 231386043, 231386047, 4, 640x360 
0x12CB3460, 36963309751139288, 231386093, 231386096, 3, 640x360 
0x12CB3460, 36963309751463880, 231386123, 231386126, 3, 640x360 
0x12CB3460, 36963309751778624, 231386152, 231386156, 4, 640x360 
0x12CB3460, 36963309752098424, 231386183, 231386187, 4, 640x360 
0x12CB3460, 36963309752418808, 231386223, 231386226, 3, 640x360 
0x12CB3460, 36963309752739448, 231386252, 231386254, 2, 640x360 
0x12CB3460, 36963309753060320, 231386282, 231386297, 15, 640x360 
0x12CB3460, 36963309753380144, 231386312, 231386315, 3, 640x360 
0x12CB3460, 36963309753698712, 231386343, 231386348, 5, 640x360 
0x12CB3460, 36963309754020264, 231386384, 231386387, 3, 640x360 
0x12CB3460, 36963309754339704, 231386412, 231386415, 3, 640x360 
0x12CB3460, 36963309754658592, 231386443, 231386446, 3, 640x360 
0x12CB3460, 36963309755140488, 231386492, 231386495, 3, 640x360 
0x12CB3460, 36963309755458328, 231386522, 231386525, 3, 640x360 
0x12CB3460, 36963309755778120, 231386553, 231386555, 2, 640x360 
0x12CB3460, 36963309756101648, 231386584, 231386588, 4, 640x360 
0x12CB3460, 36963309756420216, 231386622, 231386626, 4, 640x360 
0x12CB3460, 36963309756739288, 231386653, 231386655, 2, 640x360 
0x12CB3460, 36963309757059712, 231386683, 231386685, 2, 640x360 
0x12CB3460, 36963309757380312, 231386712, 231386715, 3, 640x360 
0x12CB3460, 36963309757701144, 231386744, 231386748, 4, 640x360 
0x12CB3460, 36963309758019192, 231386783, 231386786, 3, 640x360 
0x12CB3460, 36963309758338800, 231386812, 231386814, 2, 640x360 
0x12CB3460, 36963309758660360, 231386842, 231386846, 4, 640x360 
0x12CB3460, 36963309759139408, 231386892, 231386895, 3, 640x360 
0x12CB3460, 36963309759460376, 231386923, 231386925, 2, 640x360 
0x12CB3460, 36963309759780344, 231386952, 231386956, 4, 640x360 
0x12CB3460, 36963309760099008, 231386992, 231386995, 3, 640x360 
0x12CB3460, 36963309760419952, 231387023, 231387025, 2, 640x360 
0x12CB3460, 36963309760739328, 231387053, 231387056, 3, 640x360 
0x12CB3460, 36963309761060744, 231387083, 231387086, 3, 640x360 
0x12CB3460, 36963309761379640, 231387113, 231387116, 3, 640x360 
0x12CB3460, 36963309761699224, 231387143, 231387147, 4, 640x360 
0x12CB3460, 36963309762021520, 231387183, 231387185, 2, 640x360 
0x12CB3460, 36963309762340120, 231387212, 231387215, 3, 640x360 
0x12CB3460, 36963309762818496, 231387263, 231387265, 2, 640x360 
0x12CB3460, 36963309763139240, 231387292, 231387296, 4, 640x360 
0x12CB3460, 36963309763460248, 231387323, 231387329, 6, 640x360 
0x12CB3460, 36963309763781144, 231387373, 231387376, 3, 640x360 
0x12CB3460, 36963309764099872, 231387384, 231387387, 3, 640x360 
0x12CB3460, 36963309764418712, 231387422, 231387425, 3, 640x360 
0x12CB3460, 36963309764738952, 231387452, 231387454, 2, 640x360 
0x12CB3460, 36963309765060312, 231387483, 231387485, 2, 640x360 
0x12CB3460, 36963309765379328, 231387512, 231387517, 5, 640x360 
0x12CB3460, 36963309765700584, 231387553, 231387555, 2, 640x360 
0x12CB3460, 36963309766020000, 231387583, 231387585, 2, 640x360 
0x12CB3460, 36963309766340632, 231387614, 231387616, 2, 640x360 
0x12CB3460, 36963309766819424, 231387662, 231387665, 3, 640x360 
0x12CB3460, 36963309767139880, 231387692, 231387695, 3, 640x360 
0x12CB3460, 36963309767458712, 231387722, 231387725, 3, 640x360 
0x12CB3460, 36963309767778432, 231387752, 231387755, 3, 640x360 
0x12CB3460, 36963309768100600, 231387792, 231387795, 3, 640x360 
0x12CB3460, 36963309768418848, 231387823, 231387826, 3, 640x360 
0x12CB3460, 36963309768740872, 231387852, 231387855, 3, 640x360 
0x12CB3460, 36963309769060232, 231387883, 231387886, 3, 640x360 
0x12CB3460, 36963309769378584, 231387913, 231387916, 3, 640x360 
0x12CB3460, 36963309769699120, 231387953, 231387957, 4, 640x360 
0x12CB3460, 36963309770022600, 231387977, 231387981, 4, 640x360 
0x12CB3460, 36963309770338808, 231388012, 231388014, 2, 640x360 
0x12CB3460, 36963309770818496, 231388062, 231388065, 3, 640x360 
0x12CB3460, 36963309771139312, 231388092, 231388094, 2, 640x360 
0x12CB3460, 36963309771459448, 231388123, 231388126, 3, 640x360 
0x12CB3460, 36963309771779808, 231388152, 231388156, 4, 640x360 
0x12CB3460, 36963309772099416, 231388183, 231388187, 4, 640x360 
0x12CB3460, 36963309772419352, 231388222, 231388225, 3, 640x360 
0x12CB3460, 36963309772739760, 231388252, 231388255, 3, 640x360 
0x12CB3460, 36963309773062816, 231388283, 231388286, 3, 640x360 
0x12CB3460, 36963309773381832, 231388313, 231388316, 3, 640x360 
0x12CB3460, 36963309773701104, 231388353, 231388357, 4, 640x360 
0x12CB3460, 36963309774020216, 231388383, 231388386, 3, 640x360 
0x12CB3460, 36963309774500168, 231388433, 231388435, 2, 640x360 
0x12CB3460, 36963309774821184, 231388463, 231388466, 3, 640x360 
0x12CB3460, 36963309775139432, 231388493, 231388495, 2, 640x360 
0x12CB3460, 36963309775460384, 231388523, 231388525, 2, 640x360 
0x12CB3460, 36963309775781688, 231388553, 231388557, 4, 640x360 
0x12CB3460, 36963309776100344, 231388593, 231388596, 3, 640x360 
0x12CB3460, 36963309776419768, 231388622, 231388625, 3, 640x360 
0x12CB3460, 36963309776742008, 231388655, 231388659, 4, 640x360 
0x12CB3460, 36963309777063912, 231388683, 231388685, 2, 640x360 
0x12CB3460, 36963309777379888, 231388712, 231388715, 3, 640x360 
0x12CB3460, 36963309777699336, 231388743, 231388746, 3, 640x360 
0x12CB3460, 36963309778019344, 231388782, 231388785, 3, 640x360 
0x12CB3460, 36963309778500952, 231388824, 231388828, 4, 640x360 
0x12CB3460, 36963309778821240, 231388870, 231388873, 3, 640x360 
0x12CB3460, 36963309779140040, 231388892, 231388895, 3, 640x360 
0x12CB3460, 36963309779460384, 231388922, 231388925, 3, 640x360 
0x12CB3460, 36963309779778640, 231388953, 231388956, 3, 640x360 
0x12CB3460, 36963309780100112, 231388984, 231388987, 3, 640x360 
0x12CB3460, 36963309780419104, 231389023, 231389026, 3, 640x360 
0x12CB3460, 36963309780740192, 231389053, 231389056, 3, 640x360 
0x12CB3460, 36963309781059568, 231389083, 231389085, 2, 640x360 
0x12CB3460, 36963309781379864, 231389113, 231389116, 3, 640x360 
0x12CB3460, 36963309781700216, 231389144, 231389147, 3, 640x360 
0x12CB3460, 36963309782179200, 231389193, 231389196, 3, 640x360 
0x12CB3460, 36963309782500056, 231389224, 231389228, 4, 640x360 
0x12CB3460, 36963309782818512, 231389263, 231389266, 3, 640x360 
0x12CB3460, 36963309783140256, 231389293, 231389296, 3, 640x360 
0x12CB3460, 36963309783458488, 231389322, 231389325, 3, 640x360 
0x12CB3460, 36963309783780296, 231389378, 231389382, 4, 640x360 
0x12CB3460, 36963309784101416, 231389383, 231389388, 5, 640x360 
0x12CB3460, 36963309784419656, 231389422, 231389424, 2, 640x360 
0x12CB3460, 36963309784738456, 231389453, 231389456, 3, 640x360 
0x12CB3460, 36963309785059848, 231389483, 231389486, 3, 640x360 
0x12CB3460, 36963309785379048, 231389513, 231389516, 3, 640x360 
0x12CB3460, 36963309785699304, 231389543, 231389547, 4, 640x360 
0x12CB3460, 36963309786180168, 231389592, 231389595, 3, 640x360 
0x12CB3460, 36963309786500728, 231389624, 231389628, 4, 640x360 
0x12CB3460, 36963309786819400, 231389663, 231389666, 3, 640x360 
0x12CB3460, 36963309787139040, 231389692, 231389695, 3, 640x360 
0x12CB3460, 36963309787460072, 231389723, 231389726, 3, 640x360 
0x12CB3460, 36963309787778416, 231389753, 231389755, 2, 640x360 
0x12CB3460, 36963309788099888, 231389783, 231389786, 3, 640x360 
0x12CB3460, 36963309788421224, 231389822, 231389825, 3, 640x360 
0x12CB3460, 36963309788739064, 231389853, 231389855, 2, 640x360 
0x12CB3460, 36963309789060464, 231389883, 231389886, 3, 640x360 
0x12CB3460, 36963309789378368, 231389913, 231389916, 3, 640x360 
0x12CB3460, 36963309789700336, 231389953, 231389957, 4, 640x360 
0x12CB3460, 36963309790179160, 231389993, 231389997, 4, 640x360 
0x12CB3460, 36963309790499672, 231390023, 231390027, 4, 640x360 
0x12CB3460, 36963309790821440, 231390062, 231390065, 3, 640x360 
0x12CB3460, 36963309791138432, 231390092, 231390095, 3, 640x360 
0x12CB3460, 36963309791458272, 231390123, 231390126, 3, 640x360 
0x12CB3460, 36963309791779648, 231390152, 231390155, 3, 640x360 
0x12CB3460, 36963309792103312, 231390184, 231390187, 3, 640x360 
0x12CB3460, 36963309792419432, 231390222, 231390225, 3, 640x360 
0x12CB3460, 36963309792739352, 231390252, 231390255, 3, 640x360 
0x12CB3460, 36963309793059712, 231390283, 231390285, 2, 640x360 
0x12CB3460, 36963309793381008, 231390312, 231390316, 4, 640x360 
0x12CB3460, 36963309793861392, 231390365, 231390368, 3, 640x360 
0x12CB3460, 36963309794179104, 231390392, 231390394, 2, 640x360 
0x12CB3460, 36963309794500064, 231390433, 231390436, 3, 640x360 
0x12CB3460, 36963309794818920, 231390463, 231390466, 3, 640x360 
0x12CB3460, 36963309795138472, 231390492, 231390494, 2, 640x360 
0x12CB3460, 36963309795459800, 231390522, 231390525, 3, 640x360 
0x12CB3460, 36963309795779504, 231390552, 231390556, 4, 640x360 
0x12CB3460, 36963309796098160, 231390583, 231390586, 3, 640x360 
0x12CB3460, 36963309796418544, 231390623, 231390625, 2, 640x360 
0x12CB3460, 36963309796738088, 231390652, 231390656, 4, 640x360 
0x12CB3460, 36963309797061752, 231390682, 231390685, 3, 640x360 
0x12CB3460, 36963309797379832, 231390712, 231390715, 3, 640x360 
0x12CB3460, 36963309797860368, 231390762, 231390765, 3, 640x360 
0x12CB3460, 36963309798180200, 231390793, 231390796, 3, 640x360 
0x12CB3460, 36963309798498416, 231390823, 231390827, 4, 640x360 
0x12CB3460, 36963309798819872, 231390876, 231390879, 3, 640x360 
0x12CB3460, 36963309799139248, 231390893, 231390896, 3, 640x360 
0x12CB3460, 36963309799459864, 231390922, 231390925, 3, 640x360 
0x12CB3460, 36963309799779776, 231390953, 231390956, 3, 640x360 
0x12CB3460, 36963309800100088, 231390992, 231390995, 3, 640x360 
0x12CB3460, 36963309800420184, 231391022, 231391026, 4, 640x360 
0x12CB3460, 36963309800739768, 231391052, 231391055, 3, 640x360 
0x12CB3460, 36963309801058520, 231391082, 231391085, 3, 640x360 
0x12CB3460, 36963309801378984, 231391112, 231391115, 3, 640x360 
0x12CB3460, 36963309801862264, 231391163, 231391166, 3, 640x360 
0x12CB3460, 36963309802179728, 231391193, 231391196, 3, 640x360 
0x12CB3460, 36963309802500432, 231391224, 231391228, 4, 640x360 
0x12CB3460, 36963309802818032, 231391262, 231391265, 3, 640x360 
0x12CB3460, 36963309803138456, 231391293, 231391296, 3, 640x360 
0x12CB3460, 36963309803459992, 231391322, 231391328, 6, 640x360 
0x12CB3460, 36963309803780304, 231391377, 231391380, 3, 640x360 
0x12CB3460, 36963309804098936, 231391383, 231391386, 3, 640x360 
0x12CB3460, 36963309804419880, 231391423, 231391425, 2, 640x360 
0x12CB3460, 36963309804739576, 231391452, 231391455, 3, 640x360 
0x12CB3460, 36963309805060200, 231391483, 231391486, 3, 640x360 
0x12CB3460, 36963309805540392, 231391532, 231391535, 3, 640x360 
0x12CB3460, 36963309805859856, 231391562, 231391564, 2, 640x360 
0x12CB3460, 36963309806178624, 231391593, 231391596, 3, 640x360 
0x12CB3460, 36963309806500816, 231391634, 231391637, 3, 640x360 
0x12CB3460, 36963309806819920, 231391663, 231391667, 4, 640x360 
0x12CB3460, 36963309807139096, 231391693, 231391695, 2, 640x360 
0x12CB3460, 36963309807459176, 231391722, 231391725, 3, 640x360 
0x12CB3460, 36963309807778680, 231391752, 231391755, 3, 640x360 
0x12CB3460, 36963309808108920, 231391792, 231391795, 3, 640x360 
0x12CB3460, 36963309808419608, 231391822, 231391825, 3, 640x360 
0x12CB3460, 36963309808739088, 231391871, 231391874, 3, 640x360 
0x12CB3460, 36963309809062624, 231391882, 231391885, 3, 640x360 
0x12CB3460, 36963309809540704, 231391933, 231391936, 3, 640x360 
0x12CB3460, 36963309809860400, 231391963, 231391966, 3, 640x360 
0x12CB3460, 36963309810181328, 231391992, 231391996, 4, 640x360 
0x12CB3460, 36963309810498592, 231392023, 231392027, 4, 640x360 
0x12CB3460, 36963309810821024, 231392063, 231392066, 3, 640x360 
0x12CB3460, 36963309811139080, 231392092, 231392095, 3, 640x360 
0x12CB3460, 36963309811459296, 231392123, 231392126, 3, 640x360 
0x12CB3460, 36963309811777976, 231392152, 231392155, 3, 640x360 
0x12CB3460, 36963309812099232, 231392183, 231392188, 5, 640x360 
0x12CB3460, 36963309812418584, 231392223, 231392226, 3, 640x360 
0x12CB3460, 36963309812738312, 231392252, 231392255, 3, 640x360 
0x12CB3460, 36963309813059832, 231392283, 231392286, 3, 640x360 
0x12CB3460, 36963309813539000, 231392333, 231392335, 2, 640x360 
0x12CB3460, 36963309813861112, 231392374, 231392378, 4, 640x360 
0x12CB3460, 36963309814178296, 231392393, 231392396, 3, 640x360 
0x12CB3460, 36963309814499096, 231392432, 231392435, 3, 640x360 
0x12CB3460, 36963309814818200, 231392462, 231392465, 3, 640x360 
0x12CB3460, 36963309815139248, 231392493, 231392496, 3, 640x360 
0x12CB3460, 36963309815457720, 231392522, 231392527, 5, 640x360 
0x12CB3460, 36963309815778456, 231392552, 231392555, 3, 640x360 
0x12CB3460, 36963309816099176, 231392583, 231392587, 4, 640x360 
0x12CB3460, 36963309816419320, 231392623, 231392626, 3, 640x360 
0x12CB3460, 36963309816738176, 231392652, 231392655, 3, 640x360 
0x12CB3460, 36963309817219760, 231392702, 231392705, 3, 640x360 
0x12CB3460, 36963309817540384, 231392732, 231392735, 3, 640x360 
0x12CB3460, 36963309817858072, 231392762, 231392765, 3, 640x360 
0x12CB3460, 36963309818182912, 231392792, 231392795, 3, 640x360 
0x12CB3460, 36963309818499920, 231392834, 231392838, 4, 640x360 
0x12CB3460, 36963309818821288, 231392875, 231392878, 3, 640x360 
0x12CB3460, 36963309819138704, 231392892, 231392895, 3, 640x360 
0x12CB3460, 36963309819459416, 231392922, 231392925, 3, 640x360 
0x12CB3460, 36963309819780144, 231392953, 231392956, 3, 640x360 
0x12CB3460, 36963309820099808, 231392993, 231392996, 3, 640x360 
0x12CB3460, 36963309820419744, 231393022, 231393025, 3, 640x360 
0x12CB3460, 36963309820741320, 231393052, 231393055, 3, 640x360 
0x12CB3460, 36963309821219536, 231393103, 231393105, 2, 640x360 
0x12CB3460, 36963309821540440, 231393132, 231393135, 3, 640x360 
0x12CB3460, 36963309821858096, 231393163, 231393166, 3, 640x360 
0x12CB3460, 36963309822178896, 231393192, 231393195, 3, 640x360 
0x12CB3460, 36963309822499960, 231393223, 231393227, 4, 640x360 
0x12CB3460, 36963309822818856, 231393262, 231393265, 3, 640x360 
0x12CB3460, 36963309823138072, 231393292, 231393296, 4, 640x360 
0x12CB3460, 36963309823460320, 231393322, 231393325, 3, 640x360 
0x12CB3460, 36963309823781632, 231393374, 231393378, 4, 640x360 
0x12CB3460, 36963309824098264, 231393383, 231393387, 4, 640x360 
0x12CB3460, 36963309824418936, 231393422, 231393425, 3, 640x360 
0x12CB3460, 36963309824900040, 231393463, 231393467, 4, 640x360 
0x12CB3460, 36963309825222264, 231393502, 231393504, 2, 640x360 
0x12CB3460, 36963309825541056, 231393533, 231393535, 2, 640x360 
0x12CB3460, 36963309825859768, 231393562, 231393565, 3, 640x360 
0x12CB3460, 36963309826180016, 231393593, 231393595, 2, 640x360 
0x12CB3460, 36963309826501208, 231393633, 231393637, 4, 640x360 
0x12CB3460, 36963309826819968, 231393663, 231393665, 2, 640x360 
0x12CB3460, 36963309827138304, 231393692, 231393695, 3, 640x360 
0x12CB3460, 36963309827459128, 231393723, 231393726, 3, 640x360 
0x12CB3460, 36963309827779776, 231393752, 231393756, 4, 640x360 
0x12CB3460, 36963309828103144, 231393793, 231393796, 3, 640x360 
0x12CB3460, 36963309828419200, 231393823, 231393826, 3, 640x360 
0x12CB3460, 36963309828900224, 231393871, 231393874, 3, 640x360 
0x12CB3460, 36963309829218936, 231393903, 231393920, 17, 640x360 
0x12CB3460, 36963309829539232, 231393932, 231393935, 3, 640x360 
0x12CB3460, 36963309829860160, 231393963, 231393965, 2, 640x360 
0x12CB3460, 36963309830179600, 231393992, 231393996, 4, 640x360 
0x12CB3460, 36963309830499448, 231394023, 231394027, 4, 640x360 
0x12CB3460, 36963309830819704, 231394062, 231394065, 3, 640x360 
0x12CB3460, 36963309831137808, 231394092, 231394102, 10, 640x360 
0x12CB3460, 36963309831457912, 231394123, 231394126, 3, 640x360 
0x12CB3460, 36963309831778856, 231394152, 231394155, 3, 640x360 
0x12CB3460, 36963309832098224, 231394183, 231394187, 4, 640x360 
0x12CB3460, 36963309832420448, 231394223, 231394226, 3, 640x360 
0x12CB3460, 36963309832899104, 231394273, 231394276, 3, 640x360 
0x12CB3460, 36963309833220944, 231394302, 231394305, 3, 640x360 
0x12CB3460, 36963309833541376, 231394332, 231394335, 3, 640x360 
0x12CB3460, 36963309833860800, 231394376, 231394380, 4, 640x360 
0x12CB3460, 36963309834179912, 231394392, 231394395, 3, 640x360 
0x12CB3460, 36963309834498816, 231394423, 231394427, 4, 640x360 
0x12CB3460, 36963309834818656, 231394463, 231394466, 3, 640x360 
0x12CB3460, 36963309835137832, 231394492, 231394495, 3, 640x360 
0x12CB3460, 36963309835460064, 231394522, 231394525, 3, 640x360 
0x12CB3460, 36963309835778280, 231394553, 231394556, 3, 640x360 
0x12CB3460, 36963309836098736, 231394583, 231394587, 4, 640x360 
0x12CB3460, 36963309836580560, 231394633, 231394637, 4, 640x360 
0x12CB3460, 36963309836898976, 231394673, 231394676, 3, 640x360 
0x12CB3460, 36963309837218048, 231394702, 231394705, 3, 640x360 
0x12CB3460, 36963309837539360, 231394733, 231394736, 3, 640x360 
0x12CB3460, 36963309837859480, 231394762, 231394765, 3, 640x360 
0x12CB3460, 36963309838178552, 231394794, 231394797, 3, 640x360 
0x12CB3460, 36963309838500216, 231394833, 231394837, 4, 640x360 
0x12CB3460, 36963309838820672, 231394882, 231394886, 4, 640x360 
0x12CB3460, 36963309839140096, 231394894, 231394897, 3, 640x360 
0x12CB3460, 36963309839458216, 231394922, 231394925, 3, 640x360 
0x12CB3460, 36963309839778520, 231394952, 231394955, 3, 640x360 
0x12CB3460, 36963309840099280, 231394983, 231394986, 3, 640x360 
0x12CB3460, 36963309840580816, 231395033, 231395036, 3, 640x360 
0x12CB3460, 36963309840898000, 231395063, 231395066, 3, 640x360 
0x12CB3460, 36963309841217824, 231395102, 231395105, 3, 640x360 
0x12CB3460, 36963309841539872, 231395133, 231395136, 3, 640x360 
0x12CB3460, 36963309841859424, 231395162, 231395165, 3, 640x360 
0x12CB3460, 36963309842178224, 231395193, 231395195, 2, 640x360 
0x12CB3460, 36963309842499728, 231395224, 231395228, 4, 640x360 
0x12CB3460, 36963309842818408, 231395263, 231395265, 2, 640x360 
0x12CB3460, 36963309843141032, 231395292, 231395296, 4, 640x360 
0x12CB3460, 36963309843459304, 231395322, 231395326, 4, 640x360 
0x12CB3460, 36963309843778544, 231395353, 231395367, 14, 640x360 
0x12CB3460, 36963309844098368, 231395392, 231395395, 3, 640x360 
0x12CB3460, 36963309844579408, 231395433, 231395436, 3, 640x360 
0x12CB3460, 36963309844899824, 231395464, 231395467, 3, 640x360 
0x12CB3460, 36963309845218136, 231395502, 231395505, 3, 640x360 
0x12CB3460, 36963309845540240, 231395532, 231395544, 12, 640x360 
0x12CB3460, 36963309845859272, 231395562, 231395565, 3, 640x360 
0x12CB3460, 36963309846178936, 231395592, 231395595, 3, 640x360 
0x12CB3460, 36963309846499224, 231395633, 231395635, 2, 640x360 
0x12CB3460, 36963309846820152, 231395663, 231395666, 3, 640x360 
0x12CB3460, 36963309847139800, 231395693, 231395696, 3, 640x360 
0x12CB3460, 36963309847458736, 231395722, 231395725, 3, 640x360 
0x12CB3460, 36963309847778808, 231395752, 231395755, 3, 640x360 
0x12CB3460, 36963309848259160, 231395802, 231395805, 3, 640x360 
0x12CB3460, 36963309848577608, 231395833, 231395835, 2, 640x360 
0x12CB3460, 36963309848901040, 231395879, 231395883, 4, 640x360 
0x12CB3460, 36963309849218056, 231395902, 231395905, 3, 640x360 
0x12CB3460, 36963309849540504, 231395933, 231395935, 2, 640x360 
0x12CB3460, 36963309849861576, 231395963, 231395965, 2, 640x360 
0x12CB3460, 36963309850178784, 231395993, 231395995, 2, 640x360 
0x12CB3460, 36963309850498584, 231396032, 231396035, 3, 640x360 
0x12CB3460, 36963309850818960, 231396061, 231396064, 3, 640x360 
0x12CB3460, 36963309851138344, 231396092, 231396094, 2, 640x360 
0x12CB3460, 36963309851459392, 231396124, 231396127, 3, 640x360 
0x12CB3460, 36963309851778696, 231396153, 231396155, 2, 640x360 
0x12CB3460, 36963309852258840, 231396202, 231396220, 18, 640x360 
0x12CB3460, 36963309852579736, 231396232, 231396236, 4, 640x360 
0x12CB3460, 36963309852897944, 231396273, 231396275, 2, 640x360 
0x12CB3460, 36963309853218496, 231396302, 231396305, 3, 640x360 
0x12CB3460, 36963309853539104, 231396333, 231396336, 3, 640x360 
0x12CB3460, 36963309853860184, 231396370, 231396373, 3, 640x360 
0x12CB3460, 36963309854178968, 231396393, 231396396, 3, 640x360 
0x12CB3460, 36963309854498320, 231396422, 231396426, 4, 640x360 
0x12CB3460, 36963309854819176, 231396462, 231396465, 3, 640x360 
0x12CB3460, 36963309855139600, 231396492, 231396495, 3, 640x360 
0x12CB3460, 36963309855459584, 231396522, 231396525, 3, 640x360 
0x12CB3460, 36963309855937840, 231396572, 231396575, 3, 640x360 
0x12CB3460, 36963309856260520, 231396602, 231396605, 3, 640x360 
0x12CB3460, 36963309856581240, 231396634, 231396637, 3, 640x360 
0x12CB3460, 36963309856901344, 231396674, 231396678, 4, 640x360 
0x12CB3460, 36963309857220056, 231396703, 231396706, 3, 640x360 
0x12CB3460, 36963309857541216, 231396733, 231396751, 18, 640x360 
0x12CB3460, 36963309857860464, 231396762, 231396765, 3, 640x360 
0x12CB3460, 36963309858178568, 231396792, 231396795, 3, 640x360 
0x12CB3460, 36963309858498760, 231396823, 231396827, 4, 640x360 
0x12CB3460, 36963309858819920, 231396878, 231396881, 3, 640x360 
0x12CB3460, 36963309859142552, 231396892, 231396894, 2, 640x360 
0x12CB3460, 36963309859458376, 231396922, 231396925, 3, 640x360 
0x12CB3460, 36963309859940912, 231396972, 231396974, 2, 640x360 
0x12CB3460, 36963309860259288, 231397003, 231397005, 2, 640x360 
0x12CB3460, 36963309860579640, 231397032, 231397035, 3, 640x360 
0x12CB3460, 36963309860899376, 231397063, 231397066, 3, 640x360 
0x12CB3460, 36963309861218864, 231397102, 231397105, 3, 640x360 
0x12CB3460, 36963309861537880, 231397132, 231397135, 3, 640x360 
0x12CB3460, 36963309861858536, 231397162, 231397165, 3, 640x360 
0x12CB3460, 36963309862177440, 231397192, 231397195, 3, 640x360 
0x12CB3460, 36963309862498544, 231397223, 231397227, 4, 640x360 
0x12CB3460, 36963309862819152, 231397263, 231397265, 2, 640x360 
0x12CB3460, 36963309863138536, 231397292, 231397296, 4, 640x360 
0x12CB3460, 36963309863458440, 231397323, 231397325, 2, 640x360 
0x12CB3460, 36963309863941088, 231397377, 231397380, 3, 640x360 
0x12CB3460, 36963309864259128, 231397403, 231397405, 2, 640x360 
0x12CB3460, 36963309864579880, 231397434, 231397436, 2, 640x360 
0x12CB3460, 36963309864898288, 231397463, 231397467, 4, 640x360 
0x12CB3460, 36963309865219528, 231397503, 231397506, 3, 640x360 
0x12CB3460, 36963309865538520, 231397532, 231397535, 3, 640x360 
0x12CB3460, 36963309865858176, 231397563, 231397566, 3, 640x360 
0x12CB3460, 36963309866179864, 231397592, 231397596, 4, 640x360 
0x12CB3460, 36963309866498392, 231397632, 231397635, 3, 640x360 
0x12CB3460, 36963309866821416, 231397662, 231397665, 3, 640x360 
0x12CB3460, 36963309867138272, 231397692, 231397696, 4, 640x360 
0x12CB3460, 36963309867617520, 231397742, 231397745, 3, 640x360 
0x12CB3460, 36963309867937712, 231397772, 231397775, 3, 640x360 
0x12CB3460, 36963309868258096, 231397803, 231397806, 3, 640x360 
0x12CB3460, 36963309868577392, 231397833, 231397836, 3, 640x360 
0x12CB3460, 36963309868899432, 231397870, 231397874, 4, 640x360 
0x12CB3460, 36963309869218600, 231397903, 231397905, 2, 640x360 
0x12CB3460, 36963309869538000, 231397932, 231397935, 3, 640x360 
0x12CB3460, 36963309869858456, 231397963, 231397966, 3, 640x360 
0x12CB3460, 36963309870178464, 231397992, 231397996, 4, 640x360 
0x12CB3460, 36963309870499536, 231398023, 231398027, 4, 640x360 
0x12CB3460, 36963309870820088, 231398056, 231398060, 4, 640x360 
0x12CB3460, 36963309871139208, 231398093, 231398096, 3, 640x360 
0x12CB3460, 36963309871619736, 231398142, 231398145, 3, 640x360 
0x12CB3460, 36963309871939368, 231398173, 231398176, 3, 640x360 
0x12CB3460, 36963309872258872, 231398202, 231398205, 3, 640x360 
0x12CB3460, 36963309872578920, 231398233, 231398236, 3, 640x360 
0x12CB3460, 36963309872897560, 231398262, 231398266, 4, 640x360 
0x12CB3460, 36963309873218296, 231398302, 231398305, 3, 640x360 
0x12CB3460, 36963309873537824, 231398333, 231398335, 2, 640x360 
0x12CB3460, 36963309873860752, 231398378, 231398381, 3, 640x360 
0x12CB3460, 36963309874179224, 231398393, 231398397, 4, 640x360 
0x12CB3460, 36963309874498152, 231398423, 231398426, 3, 640x360 
0x12CB3460, 36963309874819296, 231398463, 231398466, 3, 640x360 
0x12CB3460, 36963309875140344, 231398492, 231398494, 2, 640x360 
0x12CB3460, 36963309875618736, 231398542, 231398546, 4, 640x360 
0x12CB3460, 36963309875939368, 231398573, 231398576, 3, 640x360 
0x12CB3460, 36963309876259816, 231398603, 231398606, 3, 640x360 
0x12CB3460, 36963309876580280, 231398634, 231398637, 3, 640x360 
0x12CB3460, 36963309876899856, 231398674, 231398678, 4, 640x360 
0x12CB3460, 36963309877221640, 231398703, 231398705, 2, 640x360 
0x12CB3460, 36963309877538176, 231398732, 231398735, 3, 640x360 
0x12CB3460, 36963309877857680, 231398762, 231398765, 3, 640x360 
0x12CB3460, 36963309878179392, 231398792, 231398796, 4, 640x360 
0x12CB3460, 36963309878499688, 231398833, 231398836, 3, 640x360 
0x12CB3460, 36963309878820384, 231398870, 231398873, 3, 640x360 
0x12CB3460, 36963309879297304, 231398903, 231398906, 3, 640x360 
0x12CB3460, 36963309879617784, 231398942, 231398944, 2, 640x360 
0x12CB3460, 36963309879938048, 231398973, 231398976, 3, 640x360 
0x12CB3460, 36963309880258456, 231399002, 231399007, 5, 640x360 
0x12CB3460, 36963309880579416, 231399032, 231399036, 4, 640x360 
0x12CB3460, 36963309880898968, 231399063, 231399067, 4, 640x360 
0x12CB3460, 36963309881217864, 231399103, 231399106, 3, 640x360 
0x12CB3460, 36963309881537384, 231399132, 231399135, 3, 640x360 
0x12CB3460, 36963309881858944, 231399163, 231399166, 3, 640x360 
0x12CB3460, 36963309882178296, 231399192, 231399195, 3, 640x360 
0x12CB3460, 36963309882502760, 231399226, 231399229, 3, 640x360 
0x12CB3460, 36963309882818984, 231399263, 231399266, 3, 640x360 
0x12CB3460, 36963309883297896, 231399304, 231399308, 4, 640x360 
0x12CB3460, 36963309883619768, 231399342, 231399358, 16, 640x360 
0x12CB3460, 36963309883941848, 231399369, 231399372, 3, 640x360 
0x12CB3460, 36963309884259384, 231399402, 231399405, 3, 640x360 
0x12CB3460, 36963309884579208, 231399433, 231399436, 3, 640x360 
0x12CB3460, 36963309884898520, 231399463, 231399466, 3, 640x360 
0x12CB3460, 36963309885218784, 231399503, 231399506, 3, 640x360 
0x12CB3460, 36963309885538856, 231399532, 231399537, 5, 640x360 
0x12CB3460, 36963309885859096, 231399563, 231399566, 3, 640x360 
0x12CB3460, 36963309886180032, 231399592, 231399596, 4, 640x360 
0x12CB3460, 36963309886500320, 231399633, 231399636, 3, 640x360 
0x12CB3460, 36963309886821120, 231399662, 231399665, 3, 640x360 
0x12CB3460, 36963309887297624, 231399704, 231399707, 3, 640x360 
0x12CB3460, 36963309887620832, 231399742, 231399744, 2, 640x360 
0x12CB3460, 36963309887939344, 231399773, 231399776, 3, 640x360 
0x12CB3460, 36963309888259888, 231399803, 231399806, 3, 640x360 
0x12CB3460, 36963309888580904, 231399834, 231399837, 3, 640x360 
0x12CB3460, 36963309888904200, 231399894, 231399897, 3, 640x360 
0x12CB3460, 36963309889217976, 231399903, 231399906, 3, 640x360 
0x12CB3460, 36963309889537888, 231399932, 231399935, 3, 640x360 
0x12CB3460, 36963309889859320, 231399963, 231399966, 3, 640x360 
0x12CB3460, 36963309890179600, 231399992, 231399995, 3, 640x360 
0x12CB3460, 36963309890499040, 231400024, 231400029, 5, 640x360 
0x12CB3460, 36963309890978920, 231400072, 231400075, 3, 640x360 
0x12CB3460, 36963309891297592, 231400103, 231400107, 4, 640x360 
0x12CB3460, 36963309891617688, 231400142, 231400146, 4, 640x360 
0x12CB3460, 36963309891937800, 231400170, 231400173, 3, 640x360 
0x12CB3460, 36963309892257976, 231400202, 231400205, 3, 640x360 
0x12CB3460, 36963309892577960, 231400232, 231400235, 3, 640x360 
0x12CB3460, 36963309892899120, 231400263, 231400265, 2, 640x360 
0x12CB3460, 36963309893217472, 231400303, 231400305, 2, 640x360 
0x12CB3460, 36963309893538584, 231400332, 231400337, 5, 640x360 
0x12CB3460, 36963309893860296, 231400371, 231400374, 3, 640x360 
0x12CB3460, 36963309894178304, 231400392, 231400395, 3, 640x360 
0x12CB3460, 36963309894499232, 231400423, 231400427, 4, 640x360 
0x12CB3460, 36963309894979168, 231400472, 231400476, 4, 640x360 
0x12CB3460, 36963309895297256, 231400504, 231400507, 3, 640x360 
0x12CB3460, 36963309895617752, 231400543, 231400545, 2, 640x360 
0x12CB3460, 36963309895938904, 231400572, 231400574, 2, 640x360 
0x12CB3460, 36963309896259576, 231400603, 231400605, 2, 640x360 
0x12CB3460, 36963309896580000, 231400634, 231400636, 2, 640x360 
0x12CB3460, 36963309896900384, 231400673, 231400676, 3, 640x360 
0x12CB3460, 36963309897218792, 231400702, 231400705, 3, 640x360 
0x12CB3460, 36963309897541504, 231400734, 231400736, 2, 640x360 
0x12CB3460, 36963309897858936, 231400762, 231400777, 15, 640x360 
0x12CB3460, 36963309898178264, 231400793, 231400796, 3, 640x360 
0x12CB3460, 36963309898658536, 231400844, 231400849, 5, 640x360 
0x12CB3460, 36963309898977936, 231400877, 231400881, 4, 640x360 
0x12CB3460, 36963309899299192, 231400903, 231400907, 4, 640x360 
0x12CB3460, 36963309899619272, 231400943, 231400946, 3, 640x360 
0x12CB3460, 36963309899938088, 231400972, 231400975, 3, 640x360 
0x12CB3460, 36963309900258920, 231401003, 231401007, 4, 640x360 
0x12CB3460, 36963309900579240, 231401033, 231401036, 3, 640x360 
0x12CB3460, 36963309900897872, 231401063, 231401067, 4, 640x360 
0x12CB3460, 36963309901217576, 231401102, 231401105, 3, 640x360 
0x12CB3460, 36963309901538272, 231401132, 231401150, 18, 640x360 
0x12CB3460, 36963309901859992, 231401162, 231401166, 4, 640x360 
0x12CB3460, 36963309902178128, 231401192, 231401195, 3, 640x360 
0x12CB3460, 36963309902660088, 231401243, 231401246, 3, 640x360 
0x12CB3460, 36963309902977592, 231401272, 231401275, 3, 640x360 
0x12CB3460, 36963309903297744, 231401304, 231401308, 4, 640x360 
0x12CB3460, 36963309903620472, 231401342, 231401345, 3, 640x360 
0x12CB3460, 36963309903940360, 231401378, 231401381, 3, 640x360 
0x12CB3460, 36963309904258520, 231401402, 231401405, 3, 640x360 
0x12CB3460, 36963309904579032, 231401433, 231401436, 3, 640x360 
0x12CB3460, 36963309904898152, 231401474, 231401478, 4, 640x360 
0x12CB3460, 36963309905217840, 231401503, 231401506, 3, 640x360 
0x12CB3460, 36963309905538352, 231401533, 231401536, 3, 640x360 
0x12CB3460, 36963309905859448, 231401563, 231401566, 3, 640x360 
0x12CB3460, 36963309906178424, 231401593, 231401596, 3, 640x360 
0x12CB3460, 36963309906659112, 231401643, 231401645, 2, 640x360 
0x12CB3460, 36963309906977288, 231401673, 231401675, 2, 640x360 
0x12CB3460, 36963309907300224, 231401713, 231401715, 2, 640x360 
0x12CB3460, 36963309907617720, 231401742, 231401744, 2, 640x360 
0x12CB3460, 36963309907939024, 231401772, 231401774, 2, 640x360 
0x12CB3460, 36963309908259656, 231401803, 231401806, 3, 640x360 
0x12CB3460, 36963309908578672, 231401833, 231401836, 3, 640x360 
0x12CB3460, 36963309908899016, 231401882, 231401885, 3, 640x360 
0x12CB3460, 36963309909217576, 231401902, 231401905, 3, 640x360 
0x12CB3460, 36963309909539232, 231401932, 231401935, 3, 640x360 
0x12CB3460, 36963309909860576, 231401963, 231401966, 3, 640x360 
0x12CB3460, 36963309910339776, 231402014, 231402017, 3, 640x360 
0x12CB3460, 36963309910659896, 231402042, 231402045, 3, 640x360 
0x12CB3460, 36963309910977288, 231402073, 231402076, 3, 640x360 
0x12CB3460, 36963309911297136, 231402103, 231402107, 4, 640x360 
0x12CB3460, 36963309911619432, 231402142, 231402145, 3, 640x360 
0x12CB3460, 36963309911939472, 231402173, 231402176, 3, 640x360 
0x12CB3460, 36963309912260560, 231402203, 231402206, 3, 640x360 
0x12CB3460, 36963309912579064, 231402232, 231402235, 3, 640x360 
0x12CB3460, 36963309912898608, 231402263, 231402267, 4, 640x360 
0x12CB3460, 36963309913218208, 231402303, 231402306, 3, 640x360 
0x12CB3460, 36963309913538848, 231402333, 231402336, 3, 640x360 
0x12CB3460, 36963309913860248, 231402366, 231402369, 3, 640x360 
0x12CB3460, 36963309914339000, 231402413, 231402416, 3, 640x360 
0x12CB3460, 36963309914659808, 231402443, 231402445, 2, 640x360 
0x12CB3460, 36963309914977480, 231402473, 231402476, 3, 640x360 
0x12CB3460, 36963309915298256, 231402504, 231402522, 18, 640x360 
0x12CB3460, 36963309915618824, 231402542, 231402547, 5, 640x360 
0x12CB3460, 36963309915937576, 231402572, 231402575, 3, 640x360 
0x12CB3460, 36963309916258560, 231402602, 231402605, 3, 640x360 
0x12CB3460, 36963309916577792, 231402633, 231402636, 3, 640x360 
0x12CB3460, 36963309916898800, 231402673, 231402676, 3, 640x360 
0x12CB3460, 36963309917222008, 231402703, 231402706, 3, 640x360 
0x12CB3460, 36963309917538032, 231402733, 231402736, 3, 640x360 
0x12CB3460, 36963309917859664, 231402763, 231402766, 3, 640x360 
0x12CB3460, 36963309918336904, 231402812, 231402815, 3, 640x360 
0x12CB3460, 36963309918659232, 231402842, 231402846, 4, 640x360 
0x12CB3460, 36963309918979752, 231402883, 231402887, 4, 640x360 
0x12CB3460, 36963309919297184, 231402903, 231402907, 4, 640x360 
0x12CB3460, 36963309919619344, 231402943, 231402945, 2, 640x360 
0x12CB3460, 36963309919938128, 231402972, 231402975, 3, 640x360 
0x12CB3460, 36963309920259032, 231403003, 231403007, 4, 640x360 
0x12CB3460, 36963309920580288, 231403032, 231403035, 3, 640x360 
0x12CB3460, 36963309920897712, 231403063, 231403067, 4, 640x360 
0x12CB3460, 36963309921217848, 231403103, 231403105, 2, 640x360 
0x12CB3460, 36963309921539816, 231403132, 231403150, 18, 640x360 
0x12CB3460, 36963309922018328, 231403182, 231403187, 5, 640x360 
0x12CB3460, 36963309922338976, 231403213, 231403216, 3, 640x360 
0x12CB3460, 36963309922659576, 231403243, 231403246, 3, 640x360 
0x12CB3460, 36963309922978864, 231403273, 231403276, 3, 640x360 
0x12CB3460, 36963309923298080, 231403303, 231403307, 4, 640x360 
0x12CB3460, 36963309923618688, 231403343, 231403348, 5, 640x360 
0x12CB3460, 36963309923939568, 231403378, 231403381, 3, 640x360 
0x12CB3460, 36963309924258224, 231403403, 231403406, 3, 640x360 
0x12CB3460, 36963309924578320, 231403432, 231403435, 3, 640x360 
0x12CB3460, 36963309924898968, 231403463, 231403466, 3, 640x360 
0x12CB3460, 36963309925217928, 231403503, 231403505, 2, 640x360 
0x12CB3460, 36963309925540488, 231403532, 231403535, 3, 640x360 
0x12CB3460, 36963309926018728, 231403582, 231403585, 3, 640x360 
0x12CB3460, 36963309926339064, 231403611, 231403614, 3, 640x360 
0x12CB3460, 36963309926657232, 231403643, 231403646, 3, 640x360 
0x12CB3460, 36963309926980000, 231403672, 231403675, 3, 640x360 
0x12CB3460, 36963309927299656, 231403704, 231403708, 4, 640x360 
0x12CB3460, 36963309927619536, 231403742, 231403745, 3, 640x360 
0x12CB3460, 36963309927938568, 231403772, 231403775, 3, 640x360 
0x12CB3460, 36963309928258432, 231403804, 231403807, 3, 640x360 
0x12CB3460, 36963309928581624, 231403834, 231403838, 4, 640x360 
0x12CB3460, 36963309928899560, 231403875, 231403879, 4, 640x360 
0x12CB3460, 36963309929218696, 231403902, 231403905, 3, 640x360 
0x12CB3460, 36963309929539464, 231403933, 231403936, 3, 640x360 
0x12CB3460, 36963309930019728, 231403983, 231403986, 3, 640x360 
0x12CB3460, 36963309930340176, 231404013, 231404016, 3, 640x360 
0x12CB3460, 36963309930660800, 231404043, 231404046, 3, 640x360 
0x12CB3460, 36963309930977784, 231404072, 231404075, 3, 640x360 
0x12CB3460, 36963309931297912, 231404103, 231404107, 4, 640x360 
0x12CB3460, 36963309931618000, 231404142, 231404144, 2, 640x360 
0x12CB3460, 36963309931939120, 231404173, 231404176, 3, 640x360 
0x12CB3460, 36963309932259800, 231404203, 231404206, 3, 640x360 
0x12CB3460, 36963309932578400, 231404233, 231404236, 3, 640x360 
0x12CB3460, 36963309932899656, 231404272, 231404274, 2, 640x360 
0x12CB3460, 36963309933218304, 231404303, 231404306, 3, 640x360 
0x12CB3460, 36963309933697008, 231404351, 231404355, 4, 640x360 
0x12CB3460, 36963309934017656, 231404378, 231404381, 3, 640x360 
0x12CB3460, 36963309934338376, 231404413, 231404416, 3, 640x360 
0x12CB3460, 36963309934658168, 231404442, 231404445, 3, 640x360 
0x12CB3460, 36963309934978992, 231404473, 231404476, 3, 640x360 
0x12CB3460, 36963309935297432, 231404503, 231404507, 4, 640x360 
0x12CB3460, 36963309935618168, 231404542, 231404547, 5, 640x360 
0x12CB3460, 36963309935937720, 231404571, 231404575, 4, 640x360 
0x12CB3460, 36963309936259344, 231404603, 231404606, 3, 640x360 
0x12CB3460, 36963309936580568, 231404634, 231404637, 3, 640x360 
0x12CB3460, 36963309936902848, 231404673, 231404676, 3, 640x360 
0x12CB3460, 36963309937222712, 231404703, 231404706, 3, 640x360 
0x12CB3460, 36963309937699456, 231404743, 231404747, 4, 640x360 
0x12CB3460, 36963309938017344, 231404781, 231404784, 3, 640x360 
0x12CB3460, 36963309938339616, 231404812, 231404815, 3, 640x360 
0x12CB3460, 36963309938657672, 231404842, 231404845, 3, 640x360 
0x12CB3460, 36963309938979192, 231404877, 231404880, 3, 640x360 
0x12CB3460, 36963309939298256, 231404913, 231404915, 2, 640x360 
0x12CB3460, 36963309939618872, 231404942, 231404945, 3, 640x360 
0x12CB3460, 36963309939937624, 231404972, 231404975, 3, 640x360 
0x12CB3460, 36963309940257536, 231405002, 231405005, 3, 640x360 
0x12CB3460, 36963309940577648, 231405032, 231405035, 3, 640x360 
0x12CB3460, 36963309940897176, 231405072, 231405075, 3, 640x360 
0x12CB3460, 36963309941378048, 231405113, 231405115, 2, 640x360 
0x12CB3460, 36963309941698096, 231405152, 231405155, 3, 640x360 
0x12CB3460, 36963309942017792, 231405182, 231405184, 2, 640x360 
0x12CB3460, 36963309942341984, 231405213, 231405215, 2, 640x360 
0x12CB3460, 36963309942657520, 231405241, 231405244, 3, 640x360 
0x12CB3460, 36963309942977520, 231405272, 231405275, 3, 640x360 
0x12CB3460, 36963309943298296, 231405304, 231405307, 3, 640x360 
0x12CB3460, 36963309943620256, 231405337, 231405341, 4, 640x360 
0x12CB3460, 36963309943938264, 231405374, 231405377, 3, 640x360 
0x12CB3460, 36963309944257496, 231405403, 231405406, 3, 640x360 
0x12CB3460, 36963309944578536, 231405433, 231405436, 3, 640x360 
0x12CB3460, 36963309944898888, 231405463, 231405467, 4, 640x360 
0x12CB3460, 36963309945380608, 231405513, 231405516, 3, 640x360 
0x12CB3460, 36963309945697272, 231405543, 231405546, 3, 640x360 
0x12CB3460, 36963309946018912, 231405583, 231405585, 2, 640x360 
0x12CB3460, 36963309946338008, 231405612, 231405615, 3, 640x360 
0x12CB3460, 36963309946658272, 231405643, 231405646, 3, 640x360 
0x12CB3460, 36963309946978768, 231405673, 231405675, 2, 640x360 
0x12CB3460, 36963309947297720, 231405704, 231405707, 3, 640x360 
0x12CB3460, 36963309947618024, 231405742, 231405744, 2, 640x360 
0x12CB3460, 36963309947938648, 231405773, 231405776, 3, 640x360 
0x12CB3460, 36963309948257944, 231405802, 231405805, 3, 640x360 
0x12CB3460, 36963309948579056, 231405833, 231405835, 2, 640x360 
0x12CB3460, 36963309948898296, 231405873, 231405876, 3, 640x360 
0x12CB3460, 36963309949376752, 231405913, 231405916, 3, 640x360 
0x12CB3460, 36963309949696832, 231405943, 231405946, 3, 640x360 
0x12CB3460, 36963309950017528, 231405982, 231405985, 3, 640x360 
0x12CB3460, 36963309950337264, 231406012, 231406015, 3, 640x360 
0x12CB3460, 36963309950658920, 231406042, 231406046, 4, 640x360 
0x12CB3460, 36963309950979512, 231406072, 231406075, 3, 640x360 
0x12CB3460, 36963309951297680, 231406103, 231406107, 4, 640x360 
0x12CB3460, 36963309951617288, 231406143, 231406145, 2, 640x360 
0x12CB3460, 36963309951937200, 231406172, 231406174, 2, 640x360 
0x12CB3460, 36963309952257008, 231406202, 231406205, 3, 640x360 
0x12CB3460, 36963309952579744, 231406233, 231406236, 3, 640x360 
0x12CB3460, 36963309953058712, 231406282, 231406285, 3, 640x360 
0x12CB3460, 36963309953377544, 231406313, 231406316, 3, 640x360 
0x12CB3460, 36963309953700352, 231406344, 231406367, 23, 640x360 
0x12CB3460, 36963309954017240, 231406383, 231406389, 6, 640x360 
0x12CB3460, 36963309954337160, 231406413, 231406415, 2, 640x360 
0x12CB3460, 36963309954658848, 231406443, 231406446, 3, 640x360 
0x12CB3460, 36963309954979352, 231406472, 231406476, 4, 640x360 
0x12CB3460, 36963309955301736, 231406504, 231406509, 5, 640x360 
0x12CB3460, 36963309955620512, 231406543, 231406546, 3, 640x360 
0x12CB3460, 36963309955937208, 231406572, 231406575, 3, 640x360 
0x12CB3460, 36963309956259056, 231406603, 231406606, 3, 640x360 
0x12CB3460, 36963309956579408, 231406633, 231406636, 3, 640x360 
0x12CB3460, 36963309957056928, 231406682, 231406685, 3, 640x360 
0x12CB3460, 36963309957378368, 231406713, 231406716, 3, 640x360 
0x12CB3460, 36963309957698440, 231406753, 231406756, 3, 640x360 
0x12CB3460, 36963309958017192, 231406782, 231406785, 3, 640x360 
0x12CB3460, 36963309958338832, 231406813, 231406815, 2, 640x360 
0x12CB3460, 36963309958657456, 231406842, 231406845, 3, 640x360 
0x12CB3460, 36963309958977776, 231406872, 231406875, 3, 640x360 
0x12CB3460, 36963309959297672, 231406912, 231406915, 3, 640x360 
0x12CB3460, 36963309959617504, 231406941, 231406945, 4, 640x360 
0x12CB3460, 36963309959938560, 231406972, 231406975, 3, 640x360 
0x12CB3460, 36963309960258624, 231407003, 231407006, 3, 640x360 
0x12CB3460, 36963309960579704, 231407032, 231407036, 4, 640x360 
0x12CB3460, 36963309961058040, 231407082, 231407085, 3, 640x360 
0x12CB3460, 36963309961378848, 231407113, 231407116, 3, 640x360 
0x12CB3460, 36963309961698568, 231407153, 231407170, 17, 640x360 
0x12CB3460, 36963309962018728, 231407183, 231407186, 3, 640x360 
0x12CB3460, 36963309962337568, 231407213, 231407216, 3, 640x360 
0x12CB3460, 36963309962658480, 231407243, 231407245, 2, 640x360 
0x12CB3460, 36963309962978600, 231407273, 231407276, 3, 640x360 
0x12CB3460, 36963309963299416, 231407304, 231407308, 4, 640x360 
0x12CB3460, 36963309963618232, 231407343, 231407345, 2, 640x360 
0x12CB3460, 36963309963939240, 231407380, 231407384, 4, 640x360 
0x12CB3460, 36963309964257288, 231407402, 231407405, 3, 640x360 
0x12CB3460, 36963309964737448, 231407453, 231407455, 2, 640x360 
0x12CB3460, 36963309965059576, 231407483, 231407500, 17, 640x360 
0x12CB3460, 36963309965380152, 231407514, 231407516, 2, 640x360 
0x12CB3460, 36963309965698296, 231407544, 231407548, 4, 640x360 
0x12CB3460, 36963309966018000, 231407582, 231407600, 18, 640x360 
0x12CB3460, 36963309966337488, 231407612, 231407615, 3, 640x360 
0x12CB3460, 36963309966659552, 231407642, 231407645, 3, 640x360 
0x12CB3460, 36963309966978344, 231407674, 231407677, 3, 640x360 
0x12CB3460, 36963309967300112, 231407712, 231407715, 3, 640x360 
0x12CB3460, 36963309967620136, 231407743, 231407746, 3, 640x360 
0x12CB3460, 36963309967939640, 231407773, 231407776, 3, 640x360 
0x12CB3460, 36963309968261080, 231407803, 231407806, 3, 640x360 
0x12CB3460, 36963309968742656, 231407879, 231407883, 4, 640x360 
0x12CB3460, 36963309969378192, 231407912, 231407915, 3, 640x360 
0x12CB3460, 36963309969699304, 231407951, 231407955, 4, 640x360 
0x12CB3460, 36963309970020152, 231407984, 231407987, 3, 640x360 
0x12CB3460, 36963309970338736, 231408012, 231408016, 4, 640x360 
0x12CB3460, 36963309970659704, 231408043, 231408047, 4, 640x360 
0x12CB3460, 36963309970978432, 231408073, 231408076, 3, 640x360 
0x12CB3460, 36963309971298584, 231408112, 231408115, 3, 640x360 
0x12CB3460, 36963309971617320, 231408142, 231408145, 3, 640x360 
0x12CB3460, 36963309971937240, 231408172, 231408175, 3, 640x360 
0x12CB3460, 36963309972416696, 231408223, 231408226, 3, 640x360 
0x12CB3460, 36963309972739408, 231408252, 231408255, 3, 640x360 
0x12CB3460, 36963309973058600, 231408282, 231408298, 16, 640x360 
0x12CB3460, 36963309973378760, 231408313, 231408315, 2, 640x360 
0x12CB3460, 36963309973698896, 231408343, 231408348, 5, 640x360 
0x12CB3460, 36963309974018576, 231408383, 231408386, 3, 640x360 
0x12CB3460, 36963309974337024, 231408412, 231408415, 3, 640x360 
0x12CB3460, 36963309974658216, 231408443, 231408445, 2, 640x360 
0x12CB3460, 36963309974978920, 231408472, 231408475, 3, 640x360 
0x12CB3460, 36963309975301488, 231408512, 231408515, 3, 640x360 
0x12CB3460, 36963309975619152, 231408542, 231408545, 3, 640x360 
0x12CB3460, 36963309975937144, 231408572, 231408575, 3, 640x360 
0x12CB3460, 36963309976419088, 231408623, 231408625, 2, 640x360 
0x12CB3460, 36963309976738472, 231408653, 231408671, 18, 640x360 
0x12CB3460, 36963309977057728, 231408683, 231408686, 3, 640x360 
0x12CB3460, 36963309977377464, 231408713, 231408716, 3, 640x360 
0x12CB3460, 36963309977697232, 231408753, 231408771, 18, 640x360 
0x12CB3460, 36963309978018048, 231408783, 231408786, 3, 640x360 
0x12CB3460, 36963309978338392, 231408813, 231408815, 2, 640x360 
0x12CB3460, 36963309978658576, 231408843, 231408853, 10, 640x360 
0x12CB3460, 36963309978977920, 231408880, 231408883, 3, 640x360 
0x12CB3460, 36963309979297624, 231408903, 231408907, 4, 640x360 
0x12CB3460, 36963309979617208, 231408942, 231408945, 3, 640x360 
0x12CB3460, 36963309979938664, 231408973, 231408976, 3, 640x360 
0x12CB3460, 36963309980419048, 231409023, 231409026, 3, 640x360 
0x12CB3460, 36963309980739792, 231409052, 231409056, 4, 640x360 
0x12CB3460, 36963309981056712, 231409082, 231409085, 3, 640x360 
0x12CB3460, 36963309981378704, 231409112, 231409115, 3, 640x360 
0x12CB3460, 36963309981699832, 231409144, 231409148, 4, 640x360 
0x12CB3460, 36963309982020184, 231409182, 231409185, 3, 640x360 
0x12CB3460, 36963309982338376, 231409212, 231409215, 3, 640x360 
0x12CB3460, 36963309982657520, 231409242, 231409245, 3, 640x360 
0x12CB3460, 36963309982977200, 231409273, 231409276, 3, 640x360 
0x12CB3460, 36963309983298112, 231409304, 231409307, 3, 640x360 
0x12CB3460, 36963309983618640, 231409342, 231409345, 3, 640x360 
0x12CB3460, 36963309984097096, 231409385, 231409388, 3, 640x360 
0x12CB3460, 36963309984416856, 231409422, 231409424, 2, 640x360 
0x12CB3460, 36963309984737152, 231409452, 231409455, 3, 640x360 
0x12CB3460, 36963309985057496, 231409482, 231409485, 3, 640x360 
0x12CB3460, 36963309985380352, 231409514, 231409517, 3, 640x360 
0x12CB3460, 36963309985697872, 231409553, 231409556, 3, 640x360 
0x12CB3460, 36963309986017664, 231409582, 231409585, 3, 640x360 
0x12CB3460, 36963309986338312, 231409612, 231409629, 17, 640x360 
0x12CB3460, 36963309986659944, 231409643, 231409647, 4, 640x360 
0x12CB3460, 36963309986979240, 231409673, 231409677, 4, 640x360 
0x12CB3460, 36963309987306776, 231409713, 231409716, 3, 640x360 
0x12CB3460, 36963309987619808, 231409742, 231409745, 3, 640x360 
0x12CB3460, 36963309988098568, 231409793, 231409796, 3, 640x360 
0x12CB3460, 36963309988419168, 231409823, 231409827, 4, 640x360 
0x12CB3460, 36963309988741256, 231409875, 231409880, 5, 640x360 
0x12CB3460, 36963309989058536, 231409882, 231409885, 3, 640x360 
0x12CB3460, 36963309989378472, 231409912, 231409915, 3, 640x360 
0x12CB3460, 36963309989697904, 231409943, 231409946, 3, 640x360 
0x12CB3460, 36963309990018280, 231409982, 231409985, 3, 640x360 
0x12CB3460, 36963309990337984, 231410013, 231410016, 3, 640x360 
0x12CB3460, 36963309990660168, 231410042, 231410046, 4, 640x360 
0x12CB3460, 36963309990978872, 231410073, 231410076, 3, 640x360 
0x12CB3460, 36963309991299248, 231410113, 231410115, 2, 640x360 
0x12CB3460, 36963309991617896, 231410142, 231410145, 3, 640x360 
0x12CB3460, 36963309992099144, 231410182, 231410187, 5, 640x360 
0x12CB3460, 36963309992417896, 231410223, 231410226, 3, 640x360 
0x12CB3460, 36963309992737968, 231410252, 231410255, 3, 640x360 
0x12CB3460, 36963309993058640, 231410282, 231410298, 16, 640x360 
0x12CB3460, 36963309993379080, 231410313, 231410316, 3, 640x360 
0x12CB3460, 36963309993700216, 231410358, 231410375, 17, 640x360 
0x12CB3460, 36963309994018112, 231410385, 231410388, 3, 640x360 
0x12CB3460, 36963309994337816, 231410412, 231410415, 3, 640x360 
0x12CB3460, 36963309994658384, 231410442, 231410445, 3, 640x360 
0x12CB3460, 36963309994978680, 231410473, 231410476, 3, 640x360 
0x12CB3460, 36963309995299896, 231410504, 231410507, 3, 640x360 
0x12CB3460, 36963309995779648, 231410552, 231410556, 4, 640x360 
0x12CB3460, 36963309996099832, 231410592, 231410595, 3, 640x360 
0x12CB3460, 36963309996421312, 231410622, 231410625, 3, 640x360 
0x12CB3460, 36963309996748760, 231410654, 231410657, 3, 640x360 
0x12CB3460, 36963309997057928, 231410683, 231410686, 3, 640x360 
0x12CB3460, 36963309997378352, 231410712, 231410715, 3, 640x360 
0x12CB3460, 36963309997699080, 231410753, 231410755, 2, 640x360 
0x12CB3460, 36963309998018056, 231410783, 231410786, 3, 640x360 
0x12CB3460, 36963309998337520, 231410812, 231410815, 3, 640x360 
0x12CB3460, 36963309998657936, 231410842, 231410845, 3, 640x360 
0x12CB3460, 36963309998978600, 231410878, 231410881, 3, 640x360 
0x12CB3460, 36963309999298760, 231410913, 231410915, 2, 640x360 
0x12CB3460, 36963309999778784, 231410953, 231410956, 3, 640x360 
0x12CB3460, 36963310000100016, 231410993, 231410996, 3, 640x360 
0x12CB3460, 36963310000420320, 231411024, 231411027, 3, 640x360 
0x12CB3460, 36963310000743656, 231411053, 231411056, 3, 640x360 
0x12CB3460, 36963310001057128, 231411082, 231411085, 3, 640x360 
0x12CB3460, 36963310001378328, 231411112, 231411115, 3, 640x360 
0x12CB3460, 36963310001698864, 231411153, 231411156, 3, 640x360 
0x12CB3460, 36963310002018056, 231411183, 231411186, 3, 640x360 
0x12CB3460, 36963310002339032, 231411213, 231411216, 3, 640x360 
0x12CB3460, 36963310002657120, 231411242, 231411245, 3, 640x360 
0x12CB3460, 36963310002977368, 231411273, 231411276, 3, 640x360 
0x12CB3460, 36963310003300392, 231411304, 231411308, 4, 640x360 
0x12CB3460, 36963310003779720, 231411377, 231411380, 3, 640x360 
0x12CB3460, 36963310004098392, 231411383, 231411388, 5, 640x360 
0x12CB3460, 36963310004416744, 231411422, 231411425, 3, 640x360 
0x12CB3460, 36963310004738176, 231411452, 231411455, 3, 640x360 
0x12CB3460, 36963310005057520, 231411483, 231411485, 2, 640x360 
0x12CB3460, 36963310005379472, 231411512, 231411516, 4, 640x360 
0x12CB3460, 36963310005699280, 231411544, 231411547, 3, 640x360 
0x12CB3460, 36963310006018032, 231411582, 231411585, 3, 640x360 
0x12CB3460, 36963310006338680, 231411612, 231411615, 3, 640x360 
0x12CB3460, 36963310006659688, 231411642, 231411645, 3, 640x360 
0x12CB3460, 36963310006978704, 231411672, 231411676, 4, 640x360 
0x12CB3460, 36963310007462832, 231411724, 231411728, 4, 640x360 
0x12CB3460, 36963310007776304, 231411752, 231411755, 3, 640x360 
0x12CB3460, 36963310008098696, 231411783, 231411787, 4, 640x360 
0x12CB3460, 36963310008417040, 231411823, 231411826, 3, 640x360 
0x12CB3460, 36963310008739032, 231411880, 231411885, 5, 640x360 
0x12CB3460, 36963310009377616, 231411912, 231411915, 3, 640x360 
0x12CB3460, 36963310009696968, 231411943, 231411947, 4, 640x360 
0x12CB3460, 36963310010017336, 231411983, 231411985, 2, 640x360 
0x12CB3460, 36963310010338272, 231412012, 231412016, 4, 640x360 
0x12CB3460, 36963310010657152, 231412042, 231412045, 3, 640x360 
0x12CB3460, 36963310010977192, 231412072, 231412075, 3, 640x360 
0x12CB3460, 36963310011456368, 231412123, 231412125, 2, 640x360 
0x12CB3460, 36963310011778272, 231412152, 231412156, 4, 640x360 
0x12CB3460, 36963310012097856, 231412192, 231412195, 3, 640x360 
0x12CB3460, 36963310012417080, 231412221, 231412228, 7, 640x360 
0x12CB3460, 36963310012738064, 231412252, 231412255, 3, 640x360 
0x12CB3460, 36963310013057600, 231412283, 231412286, 3, 640x360 
0x12CB3460, 36963310013377184, 231412313, 231412316, 3, 640x360 
0x12CB3460, 36963310013698736, 231412344, 231412348, 4, 640x360 
0x12CB3460, 36963310014017632, 231412382, 231412385, 3, 640x360 
0x12CB3460, 36963310014337456, 231412413, 231412415, 2, 640x360 
0x12CB3460, 36963310014658048, 231412442, 231412448, 6, 640x360 
0x12CB3460, 36963310015140368, 231412493, 231412496, 3, 640x360 
0x12CB3460, 36963310015461192, 231412523, 231412527, 4, 640x360 
0x12CB3460, 36963310015778704, 231412552, 231412556, 4, 640x360 
0x12CB3460, 36963310016098240, 231412583, 231412586, 3, 640x360 
0x12CB3460, 36963310016418496, 231412622, 231412625, 3, 640x360 
0x12CB3460, 36963310016739416, 231412652, 231412655, 3, 640x360 
0x12CB3460, 36963310017057472, 231412683, 231412701, 18, 640x360 
0x12CB3460, 36963310017376752, 231412713, 231412716, 3, 640x360 
0x12CB3460, 36963310017697632, 231412743, 231412747, 4, 640x360 
0x12CB3460, 36963310018018440, 231412782, 231412785, 3, 640x360 
0x12CB3460, 36963310018338336, 231412812, 231412815, 3, 640x360 
0x12CB3460, 36963310018658304, 231412843, 231412848, 5, 640x360 
0x12CB3460, 36963310019139488, 231412892, 231412894, 2, 640x360 
0x12CB3460, 36963310019458384, 231412922, 231412925, 3, 640x360 
0x12CB3460, 36963310019776944, 231412952, 231412955, 3, 640x360 
0x12CB3460, 36963310020099400, 231412984, 231412988, 4, 640x360 
0x12CB3460, 36963310020418152, 231413022, 231413025, 3, 640x360 
0x12CB3460, 36963310020740128, 231413053, 231413057, 4, 640x360 
0x12CB3460, 36963310021057080, 231413082, 231413085, 3, 640x360 
0x12CB3460, 36963310021377936, 231413112, 231413115, 3, 640x360 
0x12CB3460, 36963310021698120, 231413143, 231413147, 4, 640x360 
0x12CB3460, 36963310022018624, 231413183, 231413186, 3, 640x360 
0x12CB3460, 36963310022339992, 231413212, 231413216, 4, 640x360 
0x12CB3460, 36963310022657304, 231413243, 231413246, 3, 640x360 
0x12CB3460, 36963310023137000, 231413292, 231413295, 3, 640x360 
0x12CB3460, 36963310023456952, 231413323, 231413326, 3, 640x360 
0x12CB3460, 36963310023778896, 231413353, 231413357, 4, 640x360 
0x12CB3460, 36963310024097624, 231413390, 231413393, 3, 640x360 
0x12CB3460, 36963310024418272, 231413423, 231413425, 2, 640x360 
0x12CB3460, 36963310024738576, 231413452, 231413454, 2, 640x360 
0x12CB3460, 36963310025057616, 231413483, 231413486, 3, 640x360 
0x12CB3460, 36963310025379672, 231413513, 231413516, 3, 640x360 
0x12CB3460, 36963310025698824, 231413553, 231413559, 6, 640x360 
0x12CB3460, 36963310026017928, 231413582, 231413585, 3, 640x360 
0x12CB3460, 36963310026337736, 231413611, 231413614, 3, 640x360 
0x12CB3460, 36963310026818704, 231413662, 231413666, 4, 640x360 
0x12CB3460, 36963310027139864, 231413693, 231413696, 3, 640x360 
0x12CB3460, 36963310027458464, 231413722, 231413725, 3, 640x360 
0x12CB3460, 36963310027777944, 231413752, 231413755, 3, 640x360 
0x12CB3460, 36963310028098376, 231413792, 231413795, 3, 640x360 
0x12CB3460, 36963310028419352, 231413822, 231413825, 3, 640x360 
0x12CB3460, 36963310028739952, 231413858, 231413869, 11, 640x360 
0x12CB3460, 36963310029060688, 231413882, 231413886, 4, 640x360 
0x12CB3460, 36963310029377288, 231413913, 231413916, 3, 640x360 
0x12CB3460, 36963310029698112, 231413952, 231413955, 3, 640x360 
0x12CB3460, 36963310030017864, 231413983, 231414001, 18, 640x360 
0x12CB3460, 36963310030340632, 231414013, 231414016, 3, 640x360 
0x12CB3460, 36963310030819072, 231414062, 231414065, 3, 640x360 
0x12CB3460, 36963310031138024, 231414092, 231414095, 3, 640x360 
0x12CB3460, 36963310031457416, 231414122, 231414125, 3, 640x360 
0x12CB3460, 36963310031777560, 231414153, 231414156, 3, 640x360 
0x12CB3460, 36963310032097848, 231414183, 231414187, 4, 640x360 
0x12CB3460, 36963310032420424, 231414222, 231414224, 2, 640x360 
0x12CB3460, 36963310032736736, 231414253, 231414256, 3, 640x360 
0x12CB3460, 36963310033057128, 231414282, 231414285, 3, 640x360 
0x12CB3460, 36963310033378192, 231414313, 231414316, 3, 640x360 
0x12CB3460, 36963310033698768, 231414370, 231414374, 4, 640x360 
0x12CB3460, 36963310034018944, 231414382, 231414385, 3, 640x360 
0x12CB3460, 36963310034336872, 231414412, 231414415, 3, 640x360 
0x12CB3460, 36963310034816624, 231414462, 231414465, 3, 640x360 
0x12CB3460, 36963310035136816, 231414493, 231414495, 2, 640x360 
0x12CB3460, 36963310035457384, 231414523, 231414526, 3, 640x360 
0x12CB3460, 36963310035778248, 231414553, 231414559, 6, 640x360 
0x12CB3460, 36963310036097936, 231414592, 231414603, 11, 640x360 
0x12CB3460, 36963310036418944, 231414622, 231414625, 3, 640x360 
0x12CB3460, 36963310036737768, 231414653, 231414656, 3, 640x360 
0x12CB3460, 36963310037057136, 231414682, 231414685, 3, 640x360 
0x12CB3460, 36963310037379592, 231414712, 231414716, 4, 640x360 
0x12CB3460, 36963310037698016, 231414743, 231414747, 4, 640x360 
0x12CB3460, 36963310038018680, 231414782, 231414784, 2, 640x360 
0x12CB3460, 36963310038497952, 231414833, 231414835, 2, 640x360 
0x12CB3460, 36963310038817928, 231414879, 231414883, 4, 640x360 
0x12CB3460, 36963310039138280, 231414893, 231414896, 3, 640x360 
0x12CB3460, 36963310039458080, 231414922, 231414928, 6, 640x360 
0x12CB3460, 36963310039776448, 231414953, 231414955, 2, 640x360 
0x12CB3460, 36963310040098592, 231414983, 231414987, 4, 640x360 
0x12CB3460, 36963310040417248, 231415022, 231415025, 3, 640x360 
0x12CB3460, 36963310040738664, 231415053, 231415057, 4, 640x360 
0x12CB3460, 36963310041057056, 231415082, 231415084, 2, 640x360 
0x12CB3460, 36963310041377960, 231415113, 231415115, 2, 640x360 
0x12CB3460, 36963310041699552, 231415152, 231415155, 3, 640x360 
0x12CB3460, 36963310042018256, 231415182, 231415185, 3, 640x360 
0x12CB3460, 36963310042498456, 231415233, 231415236, 3, 640x360 
0x12CB3460, 36963310042818952, 231415262, 231415265, 3, 640x360 
0x12CB3460, 36963310043136752, 231415293, 231415299, 6, 640x360 
0x12CB3460, 36963310043456256, 231415322, 231415325, 3, 640x360 
0x12CB3460, 36963310043777104, 231415376, 231415380, 4, 640x360 
0x12CB3460, 36963310044097792, 231415385, 231415389, 4, 640x360 
0x12CB3460, 36963310044417984, 231415422, 231415425, 3, 640x360 
0x12CB3460, 36963310044736800, 231415452, 231415455, 3, 640x360 
0x12CB3460, 36963310045057664, 231415483, 231415486, 3, 640x360 
0x12CB3460, 36963310045378376, 231415512, 231415516, 4, 640x360 
0x12CB3460, 36963310045698024, 231415543, 231415546, 3, 640x360 
0x12CB3460, 36963310046017816, 231415582, 231415585, 3, 640x360 
0x12CB3460, 36963310046497488, 231415623, 231415626, 3, 640x360 
0x12CB3460, 36963310046817400, 231415663, 231415666, 3, 640x360 
0x12CB3460, 36963310047138176, 231415693, 231415696, 3, 640x360 
0x12CB3460, 36963310047457024, 231415723, 231415726, 3, 640x360 
0x12CB3460, 36963310047776936, 231415753, 231415756, 3, 640x360 
0x12CB3460, 36963310048097760, 231415783, 231415788, 5, 640x360 
0x12CB3460, 36963310048417080, 231415823, 231415826, 3, 640x360 
0x12CB3460, 36963310048738288, 231415882, 231415886, 4, 640x360 
0x12CB3460, 36963310049377880, 231415912, 231415915, 3, 640x360 
0x12CB3460, 36963310049698080, 231415943, 231415947, 4, 640x360 
0x12CB3460, 36963310050177880, 231415994, 231415997, 3, 640x360 
0x12CB3460, 36963310050500712, 231416034, 231416038, 4, 640x360 
0x12CB3460, 36963310050820072, 231416063, 231416066, 3, 640x360 
0x12CB3460, 36963310051136776, 231416091, 231416094, 3, 640x360 
0x12CB3460, 36963310051457624, 231416122, 231416125, 3, 640x360 
0x12CB3460, 36963310051777360, 231416153, 231416155, 2, 640x360 
0x12CB3460, 36963310052096656, 231416183, 231416187, 4, 640x360 
0x12CB3460, 36963310052417296, 231416222, 231416225, 3, 640x360 
0x12CB3460, 36963310052736584, 231416252, 231416255, 3, 640x360 
0x12CB3460, 36963310053056824, 231416282, 231416285, 3, 640x360 
0x12CB3460, 36963310053377624, 231416312, 231416315, 3, 640x360 
0x12CB3460, 36963310053698152, 231416343, 231416347, 4, 640x360 
0x12CB3460, 36963310054177256, 231416392, 231416395, 3, 640x360 
0x12CB3460, 36963310054496392, 231416422, 231416426, 4, 640x360 
0x12CB3460, 36963310054818552, 231416462, 231416465, 3, 640x360 
0x12CB3460, 36963310055140200, 231416492, 231416495, 3, 640x360 
0x12CB3460, 36963310055460048, 231416523, 231416526, 3, 640x360 
0x12CB3460, 36963310055779152, 231416552, 231416555, 3, 640x360 
0x12CB3460, 36963310056097024, 231416583, 231416601, 18, 640x360 
0x12CB3460, 36963310056419024, 231416622, 231416625, 3, 640x360 
0x12CB3460, 36963310056740224, 231416654, 231416657, 3, 640x360 
0x12CB3460, 36963310057057024, 231416682, 231416685, 3, 640x360 
0x12CB3460, 36963310057381704, 231416713, 231416716, 3, 640x360 
0x12CB3460, 36963310057857136, 231416762, 231416765, 3, 640x360 
0x12CB3460, 36963310058176360, 231416793, 231416797, 4, 640x360 
0x12CB3460, 36963310058497152, 231416832, 231416836, 4, 640x360 
0x12CB3460, 36963310058816984, 231416875, 231416878, 3, 640x360 
0x12CB3460, 36963310059138576, 231416892, 231416896, 4, 640x360 
0x12CB3460, 36963310059457312, 231416923, 231416925, 2, 640x360 
0x12CB3460, 36963310059777992, 231416952, 231416955, 3, 640x360 
0x12CB3460, 36963310060097568, 231416983, 231416986, 3, 640x360 
0x12CB3460, 36963310060417696, 231417023, 231417026, 3, 640x360 
0x12CB3460, 36963310060737992, 231417052, 231417055, 3, 640x360 
0x12CB3460, 36963310061056624, 231417083, 231417085, 2, 640x360 
0x12CB3460, 36963310061378064, 231417112, 231417115, 3, 640x360 
0x12CB3460, 36963310061857376, 231417164, 231417167, 3, 640x360 
0x12CB3460, 36963310062177048, 231417193, 231417195, 2, 640x360 
0x12CB3460, 36963310062500408, 231417225, 231417230, 5, 640x360 
0x12CB3460, 36963310062817352, 231417262, 231417265, 3, 640x360 
0x12CB3460, 36963310063139216, 231417293, 231417299, 6, 640x360 
0x12CB3460, 36963310063457888, 231417322, 231417328, 6, 640x360 
0x12CB3460, 36963310063779784, 231417372, 231417375, 3, 640x360 
0x12CB3460, 36963310064096096, 231417383, 231417386, 3, 640x360 
0x12CB3460, 36963310064418192, 231417422, 231417425, 3, 640x360 
0x12CB3460, 36963310064736896, 231417453, 231417456, 3, 640x360 
0x12CB3460, 36963310065058720, 231417482, 231417485, 3, 640x360 
0x12CB3460, 36963310065377920, 231417513, 231417516, 3, 640x360 
0x12CB3460, 36963310065858216, 231417562, 231417565, 3, 640x360 
0x12CB3460, 36963310066176776, 231417592, 231417595, 3, 640x360 
0x12CB3460, 36963310066499048, 231417623, 231417627, 4, 640x360 
0x12CB3460, 36963310066818280, 231417663, 231417667, 4, 640x360 
0x12CB3460, 36963310067137128, 231417692, 231417695, 3, 640x360 
0x12CB3460, 36963310067456712, 231417721, 231417724, 3, 640x360 
0x12CB3460, 36963310067776760, 231417753, 231417756, 3, 640x360 
0x12CB3460, 36963310068097904, 231417784, 231417799, 15, 640x360 
0x12CB3460, 36963310068417584, 231417821, 231417824, 3, 640x360 
0x12CB3460, 36963310068737112, 231417852, 231417857, 5, 640x360 
0x12CB3460, 36963310069057496, 231417885, 231417888, 3, 640x360 
0x12CB3460, 36963310069537600, 231417932, 231417935, 3, 640x360 
0x12CB3460, 36963310069858096, 231417963, 231417966, 3, 640x360 
0x12CB3460, 36963310070178600, 231417993, 231417996, 3, 640x360 
0x12CB3460, 36963310070500480, 231418034, 231418039, 5, 640x360 
0x12CB3460, 36963310070818384, 231418063, 231418067, 4, 640x360 
0x12CB3460, 36963310071137224, 231418092, 231418095, 3, 640x360 
0x12CB3460, 36963310071457352, 231418123, 231418125, 2, 640x360 
0x12CB3460, 36963310071776080, 231418153, 231418156, 3, 640x360 
0x12CB3460, 36963310072097200, 231418183, 231418186, 3, 640x360 
0x12CB3460, 36963310072420192, 231418222, 231418224, 2, 640x360 
0x12CB3460, 36963310072736872, 231418253, 231418255, 2, 640x360 
0x12CB3460, 36963310073057000, 231418282, 231418284, 2, 640x360 
0x12CB3460, 36963310073536904, 231418333, 231418336, 3, 640x360 
0x12CB3460, 36963310073868280, 231418375, 231418378, 3, 640x360 
0x12CB3460, 36963310074183288, 231418393, 231418397, 4, 640x360 
0x12CB3460, 36963310074496056, 231418423, 231418426, 3, 640x360 
0x12CB3460, 36963310074817792, 231418462, 231418465, 3, 640x360 
0x12CB3460, 36963310075138568, 231418492, 231418495, 3, 640x360 
0x12CB3460, 36963310075460056, 231418522, 231418525, 3, 640x360 
0x12CB3460, 36963310075776960, 231418551, 231418555, 4, 640x360 
0x12CB3460, 36963310076097456, 231418583, 231418586, 3, 640x360 
0x12CB3460, 36963310076418064, 231418622, 231418625, 3, 640x360 
0x12CB3460, 36963310076737648, 231418652, 231418655, 3, 640x360 
0x12CB3460, 36963310077058904, 231418684, 231418687, 3, 640x360 
0x12CB3460, 36963310077539408, 231418733, 231418736, 3, 640x360 
0x12CB3460, 36963310077858192, 231418762, 231418765, 3, 640x360 
0x12CB3460, 36963310078177112, 231418793, 231418797, 4, 640x360 
0x12CB3460, 36963310078497352, 231418833, 231418836, 3, 640x360 
0x12CB3460, 36963310078818296, 231418874, 231418878, 4, 640x360 
0x12CB3460, 36963310079136648, 231418891, 231418894, 3, 640x360 
0x12CB3460, 36963310079456368, 231418922, 231418925, 3, 640x360 
0x12CB3460, 36963310079778048, 231418952, 231418955, 3, 640x360 
0x12CB3460, 36963310080099336, 231418992, 231418995, 3, 640x360 
0x12CB3460, 36963310080418904, 231419022, 231419026, 4, 640x360 
0x12CB3460, 36963310080741216, 231419053, 231419057, 4, 640x360 
0x12CB3460, 36963310081216560, 231419102, 231419105, 3, 640x360 
0x12CB3460, 36963310081536816, 231419132, 231419136, 4, 640x360 
0x12CB3460, 36963310081858488, 231419163, 231419165, 2, 640x360 
0x12CB3460, 36963310082178968, 231419193, 231419197, 4, 640x360 
0x12CB3460, 36963310082498264, 231419224, 231419228, 4, 640x360 
0x12CB3460, 36963310082816704, 231419262, 231419265, 3, 640x360 
0x12CB3460, 36963310083136920, 231419292, 231419296, 4, 640x360 
0x12CB3460, 36963310083457416, 231419322, 231419325, 3, 640x360 
0x12CB3460, 36963310083777728, 231419377, 231419380, 3, 640x360 
0x12CB3460, 36963310084097192, 231419392, 231419395, 3, 640x360 
0x12CB3460, 36963310084418232, 231419422, 231419425, 3, 640x360 
0x12CB3460, 36963310084737056, 231419452, 231419455, 3, 640x360 
0x12CB3460, 36963310085216952, 231419502, 231419505, 3, 640x360 
0x12CB3460, 36963310085540656, 231419532, 231419536, 4, 640x360 
0x12CB3460, 36963310085857352, 231419562, 231419564, 2, 640x360 
0x12CB3460, 36963310086177952, 231419592, 231419595, 3, 640x360 
0x12CB3460, 36963310086498424, 231419632, 231419635, 3, 640x360 
0x12CB3460, 36963310086820192, 231419663, 231419666, 3, 640x360 
0x12CB3460, 36963310087138952, 231419692, 231419696, 4, 640x360 
0x12CB3460, 36963310087458296, 231419722, 231419726, 4, 640x360 
0x12CB3460, 36963310087777056, 231419752, 231419755, 3, 640x360 
0x12CB3460, 36963310088096704, 231419783, 231419787, 4, 640x360 
0x12CB3460, 36963310088417888, 231419822, 231419825, 3, 640x360 
0x12CB3460, 36963310088898752, 231419876, 231419880, 4, 640x360 
0x12CB3460, 36963310089217296, 231419901, 231419905, 4, 640x360 
0x12CB3460, 36963310089538088, 231419932, 231419935, 3, 640x360 
0x12CB3460, 36963310089857872, 231419961, 231419978, 17, 640x360 
0x12CB3460, 36963310090178720, 231419993, 231419996, 3, 640x360 
0x12CB3460, 36963310090498840, 231420033, 231420049, 16, 640x360 
0x12CB3460, 36963310090818440, 231420062, 231420065, 3, 640x360 
0x12CB3460, 36963310091136080, 231420091, 231420094, 3, 640x360 
0x12CB3460, 36963310091456480, 231420122, 231420125, 3, 640x360 
0x12CB3460, 36963310091778784, 231420152, 231420156, 4, 640x360 
0x12CB3460, 36963310092096296, 231420183, 231420186, 3, 640x360 
0x12CB3460, 36963310092417760, 231420222, 231420225, 3, 640x360 
0x12CB3460, 36963310092897784, 231420264, 231420267, 3, 640x360 
0x12CB3460, 36963310093217640, 231420302, 231420305, 3, 640x360 
0x12CB3460, 36963310093538280, 231420333, 231420335, 2, 640x360 
0x12CB3460, 36963310093860752, 231420374, 231420377, 3, 640x360 
0x12CB3460, 36963310094175848, 231420392, 231420395, 3, 640x360 
0x12CB3460, 36963310094497824, 231420423, 231420428, 5, 640x360 
0x12CB3460, 36963310094817008, 231420462, 231420464, 2, 640x360 
0x12CB3460, 36963310095137728, 231420492, 231420494, 2, 640x360 
0x12CB3460, 36963310095459088, 231420523, 231420526, 3, 640x360 
0x12CB3460, 36963310095777120, 231420553, 231420557, 4, 640x360 
0x12CB3460, 36963310096097584, 231420592, 231420595, 3, 640x360 
0x12CB3460, 36963310096417376, 231420622, 231420624, 2, 640x360 
0x12CB3460, 36963310096897640, 231420672, 231420676, 4, 640x360 
0x12CB3460, 36963310097217536, 231420703, 231420706, 3, 640x360 
0x12CB3460, 36963310097536856, 231420732, 231420734, 2, 640x360 
0x12CB3460, 36963310097858136, 231420762, 231420765, 3, 640x360 
0x12CB3460, 36963310098176976, 231420792, 231420796, 4, 640x360 
0x12CB3460, 36963310098496544, 231420823, 231420827, 4, 640x360 
0x12CB3460, 36963310098817992, 231420873, 231420876, 3, 640x360 
0x12CB3460, 36963310099136120, 231420892, 231420895, 3, 640x360 
0x12CB3460, 36963310099456872, 231420922, 231420925, 3, 640x360 
0x12CB3460, 36963310099777328, 231420952, 231420957, 5, 640x360 
0x12CB3460, 36963310100097440, 231420992, 231420994, 2, 640x360 
0x12CB3460, 36963310100577864, 231421032, 231421036, 4, 640x360 
0x12CB3460, 36963310100900904, 231421063, 231421067, 4, 640x360 
0x12CB3460, 36963310101216024, 231421102, 231421106, 4, 640x360 
0x12CB3460, 36963310101537584, 231421132, 231421134, 2, 640x360 
0x12CB3460, 36963310101858536, 231421164, 231421167, 3, 640x360 
0x12CB3460, 36963310102175784, 231421193, 231421195, 2, 640x360 
0x12CB3460, 36963310102498320, 231421232, 231421235, 3, 640x360 
0x12CB3460, 36963310102816544, 231421262, 231421264, 2, 640x360 
0x12CB3460, 36963310103137160, 231421292, 231421295, 3, 640x360 
0x12CB3460, 36963310103457152, 231421322, 231421328, 6, 640x360 
0x12CB3460, 36963310103778784, 231421379, 231421383, 4, 640x360 
0x12CB3460, 36963310104098232, 231421384, 231421388, 4, 640x360 
0x12CB3460, 36963310104576728, 231421433, 231421435, 2, 640x360 
0x12CB3460, 36963310104898080, 231421473, 231421475, 2, 640x360 
0x12CB3460, 36963310105217248, 231421503, 231421506, 3, 640x360 
0x12CB3460, 36963310105539248, 231421533, 231421536, 3, 640x360 
0x12CB3460, 36963310105859160, 231421562, 231421565, 3, 640x360 
0x12CB3460, 36963310106177904, 231421592, 231421595, 3, 640x360 
0x12CB3460, 36963310106499520, 231421632, 231421635, 3, 640x360 
0x12CB3460, 36963310106818112, 231421663, 231421667, 4, 640x360 
0x12CB3460, 36963310107137800, 231421693, 231421696, 3, 640x360 
0x12CB3460, 36963310107459528, 231421724, 231421728, 4, 640x360 
0x12CB3460, 36963310107776144, 231421752, 231421756, 4, 640x360 
0x12CB3460, 36963310108097952, 231421783, 231421787, 4, 640x360 
0x12CB3460, 36963310108578960, 231421833, 231421836, 3, 640x360 
0x12CB3460, 36963310108898448, 231421876, 231421879, 3, 640x360 
0x12CB3460, 36963310109216896, 231421902, 231421905, 3, 640x360 
0x12CB3460, 36963310109537752, 231421932, 231421934, 2, 640x360 
0x12CB3460, 36963310109856912, 231421962, 231421966, 4, 640x360 
0x12CB3460, 36963310110177608, 231421992, 231421995, 3, 640x360 
0x12CB3460, 36963310110498360, 231422023, 231422027, 4, 640x360 
0x12CB3460, 36963310110820880, 231422062, 231422066, 4, 640x360 
0x12CB3460, 36963310111136152, 231422092, 231422095, 3, 640x360 
0x12CB3460, 36963310111457096, 231422122, 231422125, 3, 640x360 
0x12CB3460, 36963310111777848, 231422152, 231422156, 4, 640x360 
0x12CB3460, 36963310112255568, 231422203, 231422206, 3, 640x360 
0x12CB3460, 36963310112576600, 231422232, 231422235, 3, 640x360 
0x12CB3460, 36963310112897632, 231422272, 231422274, 2, 640x360 
0x12CB3460, 36963310113216616, 231422302, 231422305, 3, 640x360 
0x12CB3460, 36963310113536568, 231422333, 231422336, 3, 640x360 
0x12CB3460, 36963310113860592, 231422383, 231422386, 3, 640x360 
0x12CB3460, 36963310114178272, 231422393, 231422396, 3, 640x360 
0x12CB3460, 36963310114497232, 231422422, 231422427, 5, 640x360 
0x12CB3460, 36963310114817064, 231422462, 231422465, 3, 640x360 
0x12CB3460, 36963310115137376, 231422492, 231422495, 3, 640x360 
0x12CB3460, 36963310115460104, 231422523, 231422527, 4, 640x360 
0x12CB3460, 36963310115777432, 231422551, 231422558, 7, 640x360 
0x12CB3460, 36963310116259184, 231422603, 231422605, 2, 640x360 
0x12CB3460, 36963310116579216, 231422632, 231422636, 4, 640x360 
0x12CB3460, 36963310116896992, 231422673, 231422676, 3, 640x360 
0x12CB3460, 36963310117218808, 231422702, 231422705, 3, 640x360 
0x12CB3460, 36963310117540064, 231422733, 231422737, 4, 640x360 
0x12CB3460, 36963310117856040, 231422762, 231422765, 3, 640x360 
0x12CB3460, 36963310118177976, 231422793, 231422797, 4, 640x360 
0x12CB3460, 36963310118497248, 231422832, 231422835, 3, 640x360 
0x12CB3460, 36963310118818080, 231422880, 231422884, 4, 640x360 
0x12CB3460, 36963310119137480, 231422893, 231422904, 11, 640x360 
0x12CB3460, 36963310119456416, 231422922, 231422929, 7, 640x360 
0x12CB3460, 36963310119777224, 231422953, 231422955, 2, 640x360 
0x12CB3460, 36963310120256880, 231423003, 231423006, 3, 640x360 
0x12CB3460, 36963310120576256, 231423033, 231423036, 3, 640x360 
0x12CB3460, 36963310120896904, 231423062, 231423066, 4, 640x360 
0x12CB3460, 36963310121216128, 231423102, 231423106, 4, 640x360 
0x12CB3460, 36963310121537832, 231423132, 231423135, 3, 640x360 
0x12CB3460, 36963310121858536, 231423163, 231423166, 3, 640x360 
0x12CB3460, 36963310122177176, 231423193, 231423196, 3, 640x360 
0x12CB3460, 36963310122499792, 231423223, 231423227, 4, 640x360 
0x12CB3460, 36963310122816952, 231423263, 231423265, 2, 640x360 
0x12CB3460, 36963310123136560, 231423292, 231423295, 3, 640x360 
0x12CB3460, 36963310123456664, 231423323, 231423325, 2, 640x360 
0x12CB3460, 36963310123936112, 231423371, 231423374, 3, 640x360 
0x12CB3460, 36963310124255440, 231423402, 231423405, 3, 640x360 
0x12CB3460, 36963310124576504, 231423433, 231423435, 2, 640x360 
0x12CB3460, 36963310124897976, 231423472, 231423475, 3, 640x360 
0x12CB3460, 36963310125216800, 231423502, 231423505, 3, 640x360 
0x12CB3460, 36963310125537880, 231423533, 231423536, 3, 640x360 
0x12CB3460, 36963310125859984, 231423563, 231423566, 3, 640x360 
0x12CB3460, 36963310126177496, 231423593, 231423596, 3, 640x360 
0x12CB3460, 36963310126496984, 231423633, 231423636, 3, 640x360 
0x12CB3460, 36963310126816792, 231423662, 231423665, 3, 640x360 
0x12CB3460, 36963310127137608, 231423693, 231423697, 4, 640x360 
0x12CB3460, 36963310127457208, 231423724, 231423727, 3, 640x360 
0x12CB3460, 36963310127937896, 231423772, 231423775, 3, 640x360 
0x12CB3460, 36963310128258800, 231423802, 231423806, 4, 640x360 
0x12CB3460, 36963310128580376, 231423834, 231423837, 3, 640x360 
0x12CB3460, 36963310128899112, 231423886, 231423889, 3, 640x360 
0x12CB3460, 36963310129216688, 231423902, 231423905, 3, 640x360 
0x12CB3460, 36963310129537288, 231423932, 231423934, 2, 640x360 
0x12CB3460, 36963310129857600, 231423962, 231423965, 3, 640x360 
0x12CB3460, 36963310130178080, 231423992, 231423995, 3, 640x360 
0x12CB3460, 36963310130497424, 231424024, 231424028, 4, 640x360 
0x12CB3460, 36963310130817208, 231424064, 231424067, 3, 640x360 
0x12CB3460, 36963310131136616, 231424092, 231424094, 2, 640x360 
0x12CB3460, 36963310131617520, 231424142, 231424145, 3, 640x360 
0x12CB3460, 36963310131936200, 231424172, 231424174, 2, 640x360 
0x12CB3460, 36963310132256104, 231424204, 231424206, 2, 640x360 
0x12CB3460, 36963310132577024, 231424232, 231424236, 4, 640x360 
0x12CB3460, 36963310132897408, 231424263, 231424267, 4, 640x360 
0x12CB3460, 36963310133217784, 231424302, 231424320, 18, 640x360 
0x12CB3460, 36963310133537912, 231424332, 231424335, 3, 640x360 
0x12CB3460, 36963310133857536, 231424375, 231424378, 3, 640x360 
0x12CB3460, 36963310134176288, 231424392, 231424395, 3, 640x360 
0x12CB3460, 36963310134497216, 231424433, 231424435, 2, 640x360 
0x12CB3460, 36963310134818448, 231424462, 231424464, 2, 640x360 
0x12CB3460, 36963310135138568, 231424493, 231424495, 2, 640x360 
0x12CB3460, 36963310135620152, 231424544, 231424547, 3, 640x360 
0x12CB3460, 36963310135935568, 231424572, 231424574, 2, 640x360 
0x12CB3460, 36963310136255968, 231424602, 231424606, 4, 640x360 
0x12CB3460, 36963310136578248, 231424633, 231424635, 2, 640x360 
0x12CB3460, 36963310136900328, 231424673, 231424676, 3, 640x360 
0x12CB3460, 36963310137218416, 231424702, 231424706, 4, 640x360 
0x12CB3460, 36963310137539080, 231424733, 231424737, 4, 640x360 
0x12CB3460, 36963310137856976, 231424762, 231424764, 2, 640x360 
0x12CB3460, 36963310138176264, 231424793, 231424796, 3, 640x360 
0x12CB3460, 36963310138497048, 231424833, 231424836, 3, 640x360 
0x12CB3460, 36963310138818864, 231424873, 231424876, 3, 640x360 
0x12CB3460, 36963310139136640, 231424892, 231424895, 3, 640x360 
0x12CB3460, 36963310139617496, 231424942, 231424945, 3, 640x360 
0x12CB3460, 36963310139937888, 231424972, 231424975, 3, 640x360 
0x12CB3460, 36963310140259768, 231425002, 231425005, 3, 640x360 
0x12CB3460, 36963310140580848, 231425033, 231425037, 4, 640x360 
0x12CB3460, 36963310140896744, 231425062, 231425066, 4, 640x360 
0x12CB3460, 36963310141216192, 231425102, 231425106, 4, 640x360 
0x12CB3460, 36963310141536616, 231425133, 231425135, 2, 640x360 
0x12CB3460, 36963310141858088, 231425163, 231425166, 3, 640x360 
0x12CB3460, 36963310142177544, 231425193, 231425196, 3, 640x360 
0x12CB3460, 36963310142498256, 231425224, 231425228, 4, 640x360 
0x12CB3460, 36963310142817640, 231425262, 231425265, 3, 640x360 
0x12CB3460, 36963310143298176, 231425304, 231425308, 4, 640x360 
0x12CB3460, 36963310143617000, 231425343, 231425346, 3, 640x360 
0x12CB3460, 36963310143938112, 231425388, 231425392, 4, 640x360 
0x12CB3460, 36963310144255976, 231425403, 231425407, 4, 640x360 
0x12CB3460, 36963310144576704, 231425432, 231425435, 3, 640x360 
0x12CB3460, 36963310144897728, 231425473, 231425476, 3, 640x360 
0x12CB3460, 36963310145217040, 231425501, 231425505, 4, 640x360 
0x12CB3460, 36963310145537720, 231425533, 231425536, 3, 640x360 
0x12CB3460, 36963310145856512, 231425562, 231425565, 3, 640x360 
0x12CB3460, 36963310146176992, 231425592, 231425595, 3, 640x360 
0x12CB3460, 36963310146496528, 231425631, 231425634, 3, 640x360 
0x12CB3460, 36963310146817600, 231425663, 231425666, 3, 640x360 
0x12CB3460, 36963310147299736, 231425713, 231425717, 4, 640x360 
0x12CB3460, 36963310147620208, 231425738, 231425742, 4, 640x360 
0x12CB3460, 36963310147936720, 231425771, 231425774, 3, 640x360 
0x12CB3460, 36963310148256736, 231425802, 231425805, 3, 640x360 
0x12CB3460, 36963310148577360, 231425833, 231425836, 3, 640x360 
0x12CB3460, 36963310148899120, 231425880, 231425883, 3, 640x360 
0x12CB3460, 36963310149217056, 231425902, 231425905, 3, 640x360 
0x12CB3460, 36963310149536752, 231425933, 231425935, 2, 640x360 
0x12CB3460, 36963310149856552, 231425963, 231425965, 2, 640x360 
0x12CB3460, 36963310150177216, 231425992, 231425996, 4, 640x360 
0x12CB3460, 36963310150500320, 231426032, 231426035, 3, 640x360 
0x12CB3460, 36963310150818520, 231426062, 231426065, 3, 640x360 
0x12CB3460, 36963310151296992, 231426103, 231426107, 4, 640x360 
0x12CB3460, 36963310151615744, 231426142, 231426145, 3, 640x360 
0x12CB3460, 36963310151937504, 231426172, 231426175, 3, 640x360 
0x12CB3460, 36963310152258448, 231426203, 231426206, 3, 640x360 
0x12CB3460, 36963310152577416, 231426233, 231426236, 3, 640x360 
0x12CB3460, 36963310152896696, 231426272, 231426275, 3, 640x360 
0x12CB3460, 36963310153216512, 231426302, 231426305, 3, 640x360 
0x12CB3460, 36963310153537416, 231426333, 231426336, 3, 640x360 
0x12CB3460, 36963310153858960, 231426369, 231426372, 3, 640x360 
0x12CB3460, 36963310154176712, 231426393, 231426395, 2, 640x360 
0x12CB3460, 36963310154496736, 231426432, 231426435, 3, 640x360 
0x12CB3460, 36963310154979200, 231426473, 231426477, 4, 640x360 
0x12CB3460, 36963310155298400, 231426513, 231426515, 2, 640x360 
0x12CB3460, 36963310155619720, 231426543, 231426546, 3, 640x360 
0x12CB3460, 36963310155937480, 231426571, 231426574, 3, 640x360 
0x12CB3460, 36963310156256136, 231426602, 231426606, 4, 640x360 
0x12CB3460, 36963310156579240, 231426632, 231426635, 3, 640x360 
0x12CB3460, 36963310156897592, 231426674, 231426677, 3, 640x360 
0x12CB3460, 36963310157215976, 231426703, 231426705, 2, 640x360 
0x12CB3460, 36963310157537672, 231426732, 231426735, 3, 640x360 
0x12CB3460, 36963310157857248, 231426761, 231426764, 3, 640x360 
0x12CB3460, 36963310158177048, 231426792, 231426795, 3, 640x360 
0x12CB3460, 36963310158497152, 231426823, 231426827, 4, 640x360 
0x12CB3460, 36963310158977648, 231426871, 231426875, 4, 640x360 
0x12CB3460, 36963310159296888, 231426903, 231426907, 4, 640x360 
0x12CB3460, 36963310159615600, 231426943, 231426946, 3, 640x360 
0x12CB3460, 36963310159936952, 231426972, 231426975, 3, 640x360 
0x12CB3460, 36963310160257232, 231427003, 231427006, 3, 640x360 
0x12CB3460, 36963310160577696, 231427033, 231427035, 2, 640x360 
0x12CB3460, 36963310160897536, 231427072, 231427075, 3, 640x360 
0x12CB3460, 36963310161216168, 231427102, 231427106, 4, 640x360 
0x12CB3460, 36963310161537544, 231427133, 231427136, 3, 640x360 
0x12CB3460, 36963310161856192, 231427162, 231427165, 3, 640x360 
0x12CB3460, 36963310162177160, 231427192, 231427195, 3, 640x360 
0x12CB3460, 36963310162498504, 231427223, 231427226, 3, 640x360 
0x12CB3460, 36963310162977800, 231427273, 231427275, 2, 640x360 
0x12CB3460, 36963310163297016, 231427303, 231427307, 4, 640x360 
0x12CB3460, 36963310163617576, 231427343, 231427348, 5, 640x360 
0x12CB3460, 36963310163939008, 231427374, 231427378, 4, 640x360 
0x12CB3460, 36963310164257056, 231427403, 231427405, 2, 640x360 
0x12CB3460, 36963310164579856, 231427432, 231427436, 4, 640x360 
0x12CB3460, 36963310164897296, 231427463, 231427467, 4, 640x360 
0x12CB3460, 36963310165218760, 231427501, 231427505, 4, 640x360 
0x12CB3460, 36963310165537944, 231427534, 231427537, 3, 640x360 
0x12CB3460, 36963310165858944, 231427562, 231427565, 3, 640x360 
0x12CB3460, 36963310166176360, 231427592, 231427595, 3, 640x360 
0x12CB3460, 36963310166658760, 231427642, 231427645, 3, 640x360 
0x12CB3460, 36963310166979232, 231427672, 231427677, 5, 640x360 
0x12CB3460, 36963310167296056, 231427703, 231427707, 4, 640x360 
0x12CB3460, 36963310167619256, 231427743, 231427745, 2, 640x360 
0x12CB3460, 36963310167936464, 231427772, 231427774, 2, 640x360 
0x12CB3460, 36963310168257472, 231427803, 231427806, 3, 640x360 
0x12CB3460, 36963310168576792, 231427832, 231427835, 3, 640x360 
0x12CB3460, 36963310168897672, 231427880, 231427883, 3, 640x360 
0x12CB3460, 36963310169215616, 231427903, 231427906, 3, 640x360 
0x12CB3460, 36963310169537888, 231427932, 231427934, 2, 640x360 
0x12CB3460, 36963310169856472, 231427962, 231427965, 3, 640x360 
0x12CB3460, 36963310170178192, 231427992, 231427996, 4, 640x360 
0x12CB3460, 36963310170659272, 231428043, 231428046, 3, 640x360 
0x12CB3460, 36963310170975768, 231428072, 231428074, 2, 640x360 
0x12CB3460, 36963310171296728, 231428103, 231428107, 4, 640x360 
0x12CB3460, 36963310171616552, 231428143, 231428145, 2, 640x360 
0x12CB3460, 36963310171936816, 231428172, 231428175, 3, 640x360 
0x12CB3460, 36963310172256552, 231428203, 231428208, 5, 640x360 
0x12CB3460, 36963310172580336, 231428233, 231428236, 3, 640x360 
0x12CB3460, 36963310172896168, 231428272, 231428275, 3, 640x360 
0x12CB3460, 36963310173217208, 231428302, 231428305, 3, 640x360 
0x12CB3460, 36963310173536304, 231428332, 231428334, 2, 640x360 
0x12CB3460, 36963310173859728, 231428364, 231428368, 4, 640x360 
0x12CB3460, 36963310174336680, 231428412, 231428414, 2, 640x360 
0x12CB3460, 36963310174657000, 231428442, 231428445, 3, 640x360 
0x12CB3460, 36963310174977664, 231428472, 231428475, 3, 640x360 
0x12CB3460, 36963310175298336, 231428503, 231428508, 5, 640x360 
0x12CB3460, 36963310175617632, 231428543, 231428546, 3, 640x360 
0x12CB3460, 36963310175935976, 231428572, 231428575, 3, 640x360 
0x12CB3460, 36963310176256456, 231428602, 231428605, 3, 640x360 
0x12CB3460, 36963310176577200, 231428632, 231428635, 3, 640x360 
0x12CB3460, 36963310176896832, 231428663, 231428666, 3, 640x360 
0x12CB3460, 36963310177216240, 231428703, 231428706, 3, 640x360 
0x12CB3460, 36963310177538232, 231428733, 231428736, 3, 640x360 
0x12CB3460, 36963310177857728, 231428762, 231428765, 3, 640x360 
0x12CB3460, 36963310178338864, 231428813, 231428816, 3, 640x360 
0x12CB3460, 36963310178662152, 231428844, 231428866, 22, 640x360 
0x12CB3460, 36963310178976056, 231428876, 231428879, 3, 640x360 
0x12CB3460, 36963310179296576, 231428904, 231428907, 3, 640x360 
0x12CB3460, 36963310179617168, 231428942, 231428945, 3, 640x360 
0x12CB3460, 36963310179936872, 231428972, 231428974, 2, 640x360 
0x12CB3460, 36963310180257768, 231429004, 231429006, 2, 640x360 
0x12CB3460, 36963310180576720, 231429034, 231429037, 3, 640x360 
0x12CB3460, 36963310180896576, 231429072, 231429075, 3, 640x360 
0x12CB3460, 36963310181217008, 231429101, 231429104, 3, 640x360 
0x12CB3460, 36963310181537528, 231429132, 231429135, 3, 640x360 
0x12CB3460, 36963310181858032, 231429162, 231429165, 3, 640x360 
0x12CB3460, 36963310182335736, 231429213, 231429216, 3, 640x360 
0x12CB3460, 36963310182656752, 231429242, 231429244, 2, 640x360 
0x12CB3460, 36963310182975752, 231429272, 231429275, 3, 640x360 
0x12CB3460, 36963310183297928, 231429305, 231429308, 3, 640x360 
0x12CB3460, 36963310183617024, 231429342, 231429345, 3, 640x360 
0x12CB3460, 36963310183936808, 231429379, 231429382, 3, 640x360 
0x12CB3460, 36963310184257184, 231429402, 231429405, 3, 640x360 
0x12CB3460, 36963310184579472, 231429432, 231429435, 3, 640x360 
0x12CB3460, 36963310184896960, 231429473, 231429475, 2, 640x360 
0x12CB3460, 36963310185218328, 231429503, 231429506, 3, 640x360 
0x12CB3460, 36963310185537512, 231429533, 231429536, 3, 640x360 
0x12CB3460, 36963310186016000, 231429581, 231429584, 3, 640x360 
0x12CB3460, 36963310186338144, 231429612, 231429614, 2, 640x360 
0x12CB3460, 36963310186657856, 231429642, 231429654, 12, 640x360 
0x12CB3460, 36963310186976600, 231429673, 231429676, 3, 640x360 
0x12CB3460, 36963310187297408, 231429703, 231429707, 4, 640x360 
0x12CB3460, 36963310187617048, 231429736, 231429739, 3, 640x360 
0x12CB3460, 36963310187936432, 231429772, 231429775, 3, 640x360 
0x12CB3460, 36963310188257096, 231429802, 231429806, 4, 640x360 
0x12CB3460, 36963310188578056, 231429833, 231429836, 3, 640x360 
0x12CB3460, 36963310188898608, 231429885, 231429899, 14, 640x360 
0x12CB3460, 36963310189216496, 231429899, 231429902, 3, 640x360 
0x12CB3460, 36963310189537008, 231429932, 231429935, 3, 640x360 
0x12CB3460, 36963310190017888, 231429982, 231429985, 3, 640x360 
0x12CB3460, 36963310190338400, 231430013, 231430016, 3, 640x360 
0x12CB3460, 36963310190657872, 231430043, 231430046, 3, 640x360 
0x12CB3460, 36963310190977304, 231430072, 231430076, 4, 640x360 
0x12CB3460, 36963310191296624, 231430104, 231430109, 5, 640x360 
0x12CB3460, 36963310191616496, 231430142, 231430145, 3, 640x360 
0x12CB3460, 36963310191936616, 231430171, 231430174, 3, 640x360 
0x12CB3460, 36963310192255952, 231430202, 231430206, 4, 640x360 
0x12CB3460, 36963310192576408, 231430232, 231430236, 4, 640x360 
0x12CB3460, 36963310192896920, 231430263, 231430267, 4, 640x360 
0x12CB3460, 36963310193216280, 231430302, 231430306, 4, 640x360 
0x12CB3460, 36963310193536488, 231430331, 231430334, 3, 640x360 
0x12CB3460, 36963310194015184, 231430383, 231430394, 11, 640x360 
0x12CB3460, 36963310194336976, 231430412, 231430415, 3, 640x360 
0x12CB3460, 36963310194657368, 231430443, 231430446, 3, 640x360 
0x12CB3460, 36963310194976448, 231430472, 231430475, 3, 640x360 
0x12CB3460, 36963310195299936, 231430505, 231430509, 4, 640x360 
0x12CB3460, 36963310195616816, 231430542, 231430545, 3, 640x360 
0x12CB3460, 36963310195935632, 231430572, 231430579, 7, 640x360 
0x12CB3460, 36963310196259640, 231430603, 231430606, 3, 640x360 
0x12CB3460, 36963310196577984, 231430634, 231430637, 3, 640x360 
0x12CB3460, 36963310196898744, 231430673, 231430677, 4, 640x360 
0x12CB3460, 36963310197219256, 231430703, 231430706, 3, 640x360 
0x12CB3460, 36963310197694984, 231430743, 231430746, 3, 640x360 
0x12CB3460, 36963310198015712, 231430782, 231430785, 3, 640x360 
0x12CB3460, 36963310198335064, 231430812, 231430814, 2, 640x360 
0x12CB3460, 36963310198656584, 231430842, 231430860, 18, 640x360 
0x12CB3460, 36963310198976760, 231430874, 231430877, 3, 640x360 
0x12CB3460, 36963310199295440, 231430903, 231430907, 4, 640x360 
0x12CB3460, 36963310199615936, 231430942, 231430945, 3, 640x360 
0x12CB3460, 36963310199937000, 231430972, 231430975, 3, 640x360 
0x12CB3460, 36963310200255624, 231431002, 231431005, 3, 640x360 
0x12CB3460, 36963310200576368, 231431033, 231431035, 2, 640x360 
0x12CB3460, 36963310200896424, 231431073, 231431075, 2, 640x360 
0x12CB3460, 36963310201216328, 231431101, 231431106, 5, 640x360 
0x12CB3460, 36963310201697984, 231431143, 231431147, 4, 640x360 
0x12CB3460, 36963310202016072, 231431182, 231431185, 3, 640x360 
0x12CB3460, 36963310202336016, 231431212, 231431215, 3, 640x360 
0x12CB3460, 36963310202656312, 231431243, 231431245, 2, 640x360 
0x12CB3460, 36963310202975736, 231431272, 231431275, 3, 640x360 
0x12CB3460, 36963310203297296, 231431303, 231431307, 4, 640x360 
0x12CB3460, 36963310203616944, 231431343, 231431346, 3, 640x360 
0x12CB3460, 36963310203938024, 231431380, 231431383, 3, 640x360 
0x12CB3460, 36963310204255232, 231431401, 231431405, 4, 640x360 
0x12CB3460, 36963310204578360, 231431432, 231431435, 3, 640x360 
0x12CB3460, 36963310204897728, 231431463, 231431467, 4, 640x360 
0x12CB3460, 36963310205379816, 231431514, 231431517, 3, 640x360 
0x12CB3460, 36963310205697176, 231431552, 231431555, 3, 640x360 
0x12CB3460, 36963310206017136, 231431582, 231431585, 3, 640x360 
0x12CB3460, 36963310206337008, 231431612, 231431614, 2, 640x360 
0x12CB3460, 36963310206657352, 231431643, 231431646, 3, 640x360 
0x12CB3460, 36963310206976600, 231431672, 231431675, 3, 640x360 
0x12CB3460, 36963310207297856, 231431703, 231431707, 4, 640x360 
0x12CB3460, 36963310207616776, 231431736, 231431740, 4, 640x360 
0x12CB3460, 36963310207935736, 231431772, 231431775, 3, 640x360 
0x12CB3460, 36963310208257656, 231431802, 231431806, 4, 640x360 
0x12CB3460, 36963310208578664, 231431832, 231431836, 4, 640x360 
0x12CB3460, 36963310208906200, 231431880, 231431883, 3, 640x360 
0x12CB3460, 36963310209376320, 231431911, 231431914, 3, 640x360 
0x12CB3460, 36963310209696832, 231431942, 231431946, 4, 640x360 
0x12CB3460, 36963310210017392, 231431982, 231431985, 3, 640x360 
0x12CB3460, 36963310210336368, 231432012, 231432015, 3, 640x360 
0x12CB3460, 36963310210660992, 231432044, 231432047, 3, 640x360 
0x12CB3460, 36963310210975840, 231432072, 231432075, 3, 640x360 
0x12CB3460, 36963310211296224, 231432112, 231432115, 3, 640x360 
0x12CB3460, 36963310211615336, 231432141, 231432144, 3, 640x360 
0x12CB3460, 36963310211935520, 231432172, 231432175, 3, 640x360 
0x12CB3460, 36963310212255520, 231432203, 231432206, 3, 640x360 
0x12CB3460, 36963310212576872, 231432232, 231432236, 4, 640x360 
0x12CB3460, 36963310212895968, 231432263, 231432266, 3, 640x360 
0x12CB3460, 36963310213377504, 231432312, 231432315, 3, 640x360 
0x12CB3460, 36963310213698240, 231432383, 231432387, 4, 640x360 
0x12CB3460, 36963310214335112, 231432412, 231432415, 3, 640x360 
0x12CB3460, 36963310214656992, 231432441, 231432444, 3, 640x360 
0x12CB3460, 36963310214977832, 231432472, 231432475, 3, 640x360 
0x12CB3460, 36963310215298432, 231432503, 231432507, 4, 640x360 
0x12CB3460, 36963310215617496, 231432543, 231432547, 4, 640x360 
0x12CB3460, 36963310215936320, 231432572, 231432577, 5, 640x360 
0x12CB3460, 36963310216255912, 231432601, 231432605, 4, 640x360 
0x12CB3460, 36963310216578552, 231432632, 231432636, 4, 640x360 
0x12CB3460, 36963310217059056, 231432683, 231432686, 3, 640x360 
0x12CB3460, 36963310217376320, 231432712, 231432715, 3, 640x360 
0x12CB3460, 36963310217698184, 231432752, 231432755, 3, 640x360 
0x12CB3460, 36963310218016136, 231432781, 231432784, 3, 640x360 
0x12CB3460, 36963310218336752, 231432812, 231432815, 3, 640x360 
0x12CB3460, 36963310218657280, 231432842, 231432845, 3, 640x360 
0x12CB3460, 36963310218978928, 231432883, 231432887, 4, 640x360 
0x12CB3460, 36963310219296232, 231432913, 231432916, 3, 640x360 
0x12CB3460, 36963310219616200, 231432942, 231432954, 12, 640x360 
0x12CB3460, 36963310219937464, 231432973, 231432976, 3, 640x360 
0x12CB3460, 36963310220258016, 231433003, 231433006, 3, 640x360 
0x12CB3460, 36963310220577416, 231433032, 231433049, 17, 640x360 
0x12CB3460, 36963310221056272, 231433082, 231433085, 3, 640x360 
0x12CB3460, 36963310221376864, 231433112, 231433115, 3, 640x360 
0x12CB3460, 36963310221697920, 231433143, 231433147, 4, 640x360 
0x12CB3460, 36963310222018984, 231433183, 231433186, 3, 640x360 
0x12CB3460, 36963310222338208, 231433212, 231433215, 3, 640x360 
0x12CB3460, 36963310222656264, 231433243, 231433245, 2, 640x360 
0x12CB3460, 36963310222975688, 231433272, 231433275, 3, 640x360 
0x12CB3460, 36963310223296000, 231433303, 231433307, 4, 640x360 
0x12CB3460, 36963310223617120, 231433343, 231433345, 2, 640x360 
0x12CB3460, 36963310223938888, 231433384, 231433387, 3, 640x360 
0x12CB3460, 36963310224256128, 231433402, 231433406, 4, 640x360 
0x12CB3460, 36963310224577288, 231433431, 231433435, 4, 640x360 
0x12CB3460, 36963310225057568, 231433483, 231433486, 3, 640x360 
0x12CB3460, 36963310225377928, 231433512, 231433516, 4, 640x360 
0x12CB3460, 36963310225700120, 231433553, 231433557, 4, 640x360 
0x12CB3460, 36963310226016000, 231433582, 231433586, 4, 640x360 
0x12CB3460, 36963310226335264, 231433612, 231433614, 2, 640x360 
0x12CB3460, 36963310226657208, 231433643, 231433646, 3, 640x360 
0x12CB3460, 36963310226976112, 231433673, 231433675, 2, 640x360 
0x12CB3460, 36963310227296208, 231433703, 231433707, 4, 640x360 
0x12CB3460, 36963310227615392, 231433742, 231433745, 3, 640x360 
0x12CB3460, 36963310227936664, 231433771, 231433774, 3, 640x360 
0x12CB3460, 36963310228257304, 231433802, 231433806, 4, 640x360 
0x12CB3460, 36963310228738056, 231433873, 231433878, 5, 640x360 
0x12CB3460, 36963310229055472, 231433883, 231433888, 5, 640x360 
0x12CB3460, 36963310229376992, 231433913, 231433916, 3, 640x360 
0x12CB3460, 36963310229696760, 231433952, 231433956, 4, 640x360 
0x12CB3460, 36963310230017816, 231433982, 231433985, 3, 640x360 
0x12CB3460, 36963310230336824, 231434012, 231434015, 3, 640x360 
0x12CB3460, 36963310230658360, 231434043, 231434047, 4, 640x360 
0x12CB3460, 36963310230975768, 231434073, 231434076, 3, 640x360 
0x12CB3460, 36963310231298024, 231434113, 231434115, 2, 640x360 
0x12CB3460, 36963310231615592, 231434142, 231434145, 3, 640x360 
0x12CB3460, 36963310231935944, 231434173, 231434175, 2, 640x360 
0x12CB3460, 36963310232257632, 231434202, 231434205, 3, 640x360 
0x12CB3460, 36963310232736096, 231434252, 231434255, 3, 640x360 
0x12CB3460, 36963310233055288, 231434282, 231434285, 3, 640x360 
0x12CB3460, 36963310233377648, 231434312, 231434316, 4, 640x360 
0x12CB3460, 36963310233695608, 231434343, 231434347, 4, 640x360 
0x12CB3460, 36963310234017328, 231434382, 231434385, 3, 640x360 
0x12CB3460, 36963310234335568, 231434412, 231434415, 3, 640x360 
0x12CB3460, 36963310234656584, 231434442, 231434448, 6, 640x360 
0x12CB3460, 36963310234976024, 231434472, 231434475, 3, 640x360 
0x12CB3460, 36963310235296824, 231434503, 231434506, 3, 640x360 
0x12CB3460, 36963310235615560, 231434542, 231434545, 3, 640x360 
0x12CB3460, 36963310235936152, 231434572, 231434575, 3, 640x360 
0x12CB3460, 36963310236257176, 231434602, 231434606, 4, 640x360 
0x12CB3460, 36963310236737448, 231434651, 231434655, 4, 640x360 
0x12CB3460, 36963310237057808, 231434684, 231434687, 3, 640x360 
0x12CB3460, 36963310237377936, 231434713, 231434717, 4, 640x360 
0x12CB3460, 36963310237697368, 231434743, 231434747, 4, 640x360 
0x12CB3460, 36963310238016472, 231434782, 231434785, 3, 640x360 
0x12CB3460, 36963310238335696, 231434812, 231434815, 3, 640x360 
0x12CB3460, 36963310238656184, 231434842, 231434845, 3, 640x360 
0x12CB3460, 36963310238975480, 231434878, 231434882, 4, 640x360 
0x12CB3460, 36963310239295888, 231434903, 231434906, 3, 640x360 
0x12CB3460, 36963310239616704, 231434942, 231434945, 3, 640x360 
0x12CB3460, 36963310239936568, 231434972, 231434975, 3, 640x360 
0x12CB3460, 36963310240417624, 231435022, 231435030, 8, 640x360 
0x12CB3460, 36963310240738752, 231435053, 231435056, 3, 640x360 
0x12CB3460, 36963310241056008, 231435082, 231435084, 2, 640x360 
0x12CB3460, 36963310241376888, 231435113, 231435115, 2, 640x360 
0x12CB3460, 36963310241696288, 231435152, 231435156, 4, 640x360 
0x12CB3460, 36963310242015728, 231435182, 231435185, 3, 640x360 
0x12CB3460, 36963310242336464, 231435212, 231435215, 3, 640x360 
0x12CB3460, 36963310242655416, 231435242, 231435246, 4, 640x360 
0x12CB3460, 36963310242976232, 231435273, 231435276, 3, 640x360 
0x12CB3460, 36963310243296680, 231435303, 231435308, 5, 640x360 
0x12CB3460, 36963310243617528, 231435342, 231435345, 3, 640x360 
0x12CB3460, 36963310243938120, 231435376, 231435379, 3, 640x360 
0x12CB3460, 36963310244416728, 231435422, 231435425, 3, 640x360 
0x12CB3460, 36963310244736792, 231435451, 231435455, 4, 640x360 
0x12CB3460, 36963310245055632, 231435482, 231435485, 3, 640x360 
0x12CB3460, 36963310245379264, 231435513, 231435518, 5, 640x360 
0x12CB3460, 36963310245697640, 231435553, 231435557, 4, 640x360 
0x12CB3460, 36963310246017632, 231435582, 231435585, 3, 640x360 
0x12CB3460, 36963310246338056, 231435612, 231435615, 3, 640x360 
0x12CB3460, 36963310246657584, 231435643, 231435655, 12, 640x360 
0x12CB3460, 36963310246976712, 231435672, 231435676, 4, 640x360 
0x12CB3460, 36963310247296408, 231435704, 231435707, 3, 640x360 
0x12CB3460, 36963310247617352, 231435736, 231435739, 3, 640x360 
0x12CB3460, 36963310248096624, 231435783, 231435787, 4, 640x360 
0x12CB3460, 36963310248417688, 231435821, 231435824, 3, 640x360 
0x12CB3460, 36963310248736464, 231435854, 231435857, 3, 640x360 
0x12CB3460, 36963310249057416, 231435882, 231435895, 13, 640x360 
0x12CB3460, 36963310249375896, 231435913, 231435916, 3, 640x360 
0x12CB3460, 36963310249695448, 231435943, 231435946, 3, 640x360 
0x12CB3460, 36963310250016800, 231435982, 231435985, 3, 640x360 
0x12CB3460, 36963310250338144, 231436012, 231436014, 2, 640x360 
0x12CB3460, 36963310250658920, 231436045, 231436049, 4, 640x360 
0x12CB3460, 36963310250976032, 231436073, 231436078, 5, 640x360 
0x12CB3460, 36963310251296512, 231436102, 231436106, 4, 640x360 
0x12CB3460, 36963310251615984, 231436142, 231436144, 2, 640x360 
0x12CB3460, 36963310252096464, 231436182, 231436186, 4, 640x360 
0x12CB3460, 36963310252417744, 231436222, 231436224, 2, 640x360 
0x12CB3460, 36963310252737584, 231436252, 231436256, 4, 640x360 
0x12CB3460, 36963310253057144, 231436282, 231436285, 3, 640x360 
0x12CB3460, 36963310253377424, 231436313, 231436330, 17, 640x360 
0x12CB3460, 36963310253698496, 231436381, 231436384, 3, 640x360 
0x12CB3460, 36963310254335832, 231436413, 231436415, 2, 640x360 
0x12CB3460, 36963310254655752, 231436442, 231436444, 2, 640x360 
0x12CB3460, 36963310254976616, 231436471, 231436474, 3, 640x360 
0x12CB3460, 36963310255296136, 231436503, 231436507, 4, 640x360 
0x12CB3460, 36963310255617000, 231436543, 231436546, 3, 640x360 
0x12CB3460, 36963310256095952, 231436582, 231436585, 3, 640x360 
0x12CB3460, 36963310256414648, 231436622, 231436625, 3, 640x360 
0x12CB3460, 36963310256735928, 231436652, 231436656, 4, 640x360 
0x12CB3460, 36963310257057312, 231436684, 231436686, 2, 640x360 
0x12CB3460, 36963310257377280, 231436712, 231436715, 3, 640x360 
0x12CB3460, 36963310257695808, 231436744, 231436747, 3, 640x360 
0x12CB3460, 36963310258016288, 231436782, 231436784, 2, 640x360 
0x12CB3460, 36963310258337280, 231436812, 231436815, 3, 640x360 
0x12CB3460, 36963310258657240, 231436842, 231436845, 3, 640x360 
0x12CB3460, 36963310258976056, 231436873, 231436876, 3, 640x360 
0x12CB3460, 36963310259296136, 231436902, 231436907, 5, 640x360 
0x12CB3460, 36963310259776792, 231436951, 231436955, 4, 640x360 
0x12CB3460, 36963310260097936, 231436992, 231436995, 3, 640x360 
0x12CB3460, 36963310260418584, 231437022, 231437026, 4, 640x360 
0x12CB3460, 36963310260736352, 231437053, 231437056, 3, 640x360 
0x12CB3460, 36963310261056536, 231437083, 231437085, 2, 640x360 
0x12CB3460, 36963310261376776, 231437112, 231437115, 3, 640x360 
0x12CB3460, 36963310261697328, 231437152, 231437156, 4, 640x360 
0x12CB3460, 36963310262015584, 231437183, 231437185, 2, 640x360 
0x12CB3460, 36963310262336096, 231437212, 231437215, 3, 640x360 
0x12CB3460, 36963310262655192, 231437243, 231437245, 2, 640x360 
0x12CB3460, 36963310262976136, 231437272, 231437275, 3, 640x360 
0x12CB3460, 36963310263296496, 231437312, 231437315, 3, 640x360 
0x12CB3460, 36963310263776784, 231437353, 231437371, 18, 640x360 
0x12CB3460, 36963310264096408, 231437393, 231437397, 4, 640x360 
0x12CB3460, 36963310264415368, 231437422, 231437424, 2, 640x360 
0x12CB3460, 36963310264736400, 231437453, 231437456, 3, 640x360 
0x12CB3460, 36963310265057080, 231437482, 231437485, 3, 640x360 
0x12CB3460, 36963310265377560, 231437513, 231437516, 3, 640x360 
0x12CB3460, 36963310265697504, 231437551, 231437554, 3, 640x360 
0x12CB3460, 36963310266016624, 231437582, 231437585, 3, 640x360 
0x12CB3460, 36963310266338960, 231437612, 231437614, 2, 640x360 
0x12CB3460, 36963310266658896, 231437643, 231437646, 3, 640x360 
0x12CB3460, 36963310266978672, 231437672, 231437675, 3, 640x360 
0x12CB3460, 36963310267299304, 231437706, 231437709, 3, 640x360 
0x12CB3460, 36963310267775200, 231437752, 231437756, 4, 640x360 
0x12CB3460, 36963310268096568, 231437783, 231437787, 4, 640x360 
0x12CB3460, 36963310268416664, 231437821, 231437824, 3, 640x360 
0x12CB3460, 36963310268737504, 231437876, 231437880, 4, 640x360 
0x12CB3460, 36963310269055512, 231437882, 231437885, 3, 640x360 
0x12CB3460, 36963310269375344, 231437913, 231437916, 3, 640x360 
0x12CB3460, 36963310269696200, 231437952, 231437955, 3, 640x360 
0x12CB3460, 36963310270016488, 231437981, 231437984, 3, 640x360 
0x12CB3460, 36963310270337056, 231438012, 231438015, 3, 640x360 
0x12CB3460, 36963310270657440, 231438042, 231438046, 4, 640x360 
0x12CB3460, 36963310270975960, 231438072, 231438075, 3, 640x360 
0x12CB3460, 36963310271456480, 231438122, 231438125, 3, 640x360 
0x12CB3460, 36963310271774432, 231438152, 231438155, 3, 640x360 
0x12CB3460, 36963310272096736, 231438183, 231438187, 4, 640x360 
0x12CB3460, 36963310272415760, 231438222, 231438226, 4, 640x360 
0x12CB3460, 36963310272736112, 231438253, 231438256, 3, 640x360 
0x12CB3460, 36963310273056832, 231438282, 231438285, 3, 640x360 
0x12CB3460, 36963310273376992, 231438313, 231438316, 3, 640x360 
0x12CB3460, 36963310273697376, 231438379, 231438382, 3, 640x360 
0x12CB3460, 36963310274335152, 231438412, 231438415, 3, 640x360 
0x12CB3460, 36963310274655880, 231438443, 231438445, 2, 640x360 
0x12CB3460, 36963310274976216, 231438472, 231438475, 3, 640x360 
0x12CB3460, 36963310275455776, 231438522, 231438525, 3, 640x360 
0x12CB3460, 36963310275776624, 231438551, 231438555, 4, 640x360 
0x12CB3460, 36963310276096640, 231438592, 231438594, 2, 640x360 
0x12CB3460, 36963310276417576, 231438622, 231438625, 3, 640x360 
0x12CB3460, 36963310276735720, 231438652, 231438655, 3, 640x360 
0x12CB3460, 36963310277057744, 231438683, 231438685, 2, 640x360 
0x12CB3460, 36963310277379080, 231438712, 231438717, 5, 640x360 
0x12CB3460, 36963310277697592, 231438753, 231438756, 3, 640x360 
0x12CB3460, 36963310278016640, 231438776, 231438780, 4, 640x360 
0x12CB3460, 36963310278335840, 231438812, 231438815, 3, 640x360 
0x12CB3460, 36963310278656120, 231438843, 231438845, 2, 640x360 
0x12CB3460, 36963310278976208, 231438874, 231438877, 3, 640x360 
0x12CB3460, 36963310279455464, 231438922, 231438925, 3, 640x360 
0x12CB3460, 36963310279774664, 231438953, 231438955, 2, 640x360 
0x12CB3460, 36963310280095160, 231438993, 231438995, 2, 640x360 
0x12CB3460, 36963310280417808, 231439022, 231439025, 3, 640x360 
0x12CB3460, 36963310280736704, 231439052, 231439056, 4, 640x360 
0x12CB3460, 36963310281055792, 231439082, 231439085, 3, 640x360 
0x12CB3460, 36963310281375240, 231439112, 231439115, 3, 640x360 
0x12CB3460, 36963310281695672, 231439143, 231439146, 3, 640x360 
0x12CB3460, 36963310282014744, 231439181, 231439184, 3, 640x360 
0x12CB3460, 36963310282334944, 231439212, 231439215, 3, 640x360 
0x12CB3460, 36963310282657136, 231439242, 231439245, 3, 640x360 
0x12CB3460, 36963310283134840, 231439292, 231439296, 4, 640x360 
0x12CB3460, 36963310283457136, 231439322, 231439325, 3, 640x360 
0x12CB3460, 36963310283777432, 231439375, 231439378, 3, 640x360 
0x12CB3460, 36963310284094728, 231439382, 231439386, 4, 640x360 
0x12CB3460, 36963310284415272, 231439421, 231439424, 3, 640x360 
0x12CB3460, 36963310284735056, 231439452, 231439455, 3, 640x360 
0x12CB3460, 36963310285056792, 231439482, 231439485, 3, 640x360 
0x12CB3460, 36963310285377232, 231439512, 231439515, 3, 640x360 
0x12CB3460, 36963310285696928, 231439553, 231439556, 3, 640x360 
0x12CB3460, 36963310286016776, 231439581, 231439585, 4, 640x360 
0x12CB3460, 36963310286337480, 231439612, 231439615, 3, 640x360 
0x12CB3460, 36963310286657024, 231439642, 231439644, 2, 640x360 
0x12CB3460, 36963310287137608, 231439693, 231439696, 3, 640x360 
0x12CB3460, 36963310287456552, 231439723, 231439727, 4, 640x360 
0x12CB3460, 36963310287776096, 231439753, 231439757, 4, 640x360 
0x12CB3460, 36963310288096184, 231439783, 231439786, 3, 640x360 
0x12CB3460, 36963310288415416, 231439822, 231439825, 3, 640x360 
0x12CB3460, 36963310288737928, 231439875, 231439879, 4, 640x360 
0x12CB3460, 36963310289056264, 231439882, 231439885, 3, 640x360 
0x12CB3460, 36963310289375992, 231439912, 231439914, 2, 640x360 
0x12CB3460, 36963310289696736, 231439943, 231439948, 5, 640x360 
0x12CB3460, 36963310290016432, 231439983, 231439985, 2, 640x360 
0x12CB3460, 36963310290336952, 231440012, 231440015, 3, 640x360 
0x12CB3460, 36963310290818536, 231440063, 231440066, 3, 640x360 
0x12CB3460, 36963310291134488, 231440092, 231440096, 4, 640x360 
0x12CB3460, 36963310291456552, 231440122, 231440125, 3, 640x360 
0x12CB3460, 36963310291776856, 231440152, 231440155, 3, 640x360 
0x12CB3460, 36963310292097712, 231440192, 231440195, 3, 640x360 
0x12CB3460, 36963310292416720, 231440223, 231440230, 7, 640x360 
0x12CB3460, 36963310292737256, 231440252, 231440255, 3, 640x360 
0x12CB3460, 36963310293054520, 231440282, 231440285, 3, 640x360 
0x12CB3460, 36963310293375344, 231440312, 231440329, 17, 640x360 
0x12CB3460, 36963310293697192, 231440343, 231440347, 4, 640x360 
0x12CB3460, 36963310294017064, 231440382, 231440385, 3, 640x360 
0x12CB3460, 36963310294335032, 231440413, 231440415, 2, 640x360 
0x12CB3460, 36963310294815304, 231440461, 231440464, 3, 640x360 
0x12CB3460, 36963310295135208, 231440492, 231440495, 3, 640x360 
0x12CB3460, 36963310295454416, 231440523, 231440525, 2, 640x360 
0x12CB3460, 36963310295774672, 231440553, 231440556, 3, 640x360 
0x12CB3460, 36963310296094824, 231440582, 231440586, 4, 640x360 
0x12CB3460, 36963310296416920, 231440622, 231440625, 3, 640x360 
0x12CB3460, 36963310296734640, 231440652, 231440655, 3, 640x360 
0x12CB3460, 36963310297056080, 231440682, 231440685, 3, 640x360 
0x12CB3460, 36963310297376816, 231440712, 231440715, 3, 640x360 
0x12CB3460, 36963310297696448, 231440743, 231440746, 3, 640x360 
0x12CB3460, 36963310298016856, 231440782, 231440785, 3, 640x360 
0x12CB3460, 36963310298336896, 231440813, 231440815, 2, 640x360 
0x12CB3460, 36963310298816832, 231440875, 231440878, 3, 640x360 
0x12CB3460, 36963310299136120, 231440893, 231440897, 4, 640x360 
0x12CB3460, 36963310299456392, 231440922, 231440924, 2, 640x360 
0x12CB3460, 36963310299776312, 231440953, 231440956, 3, 640x360 
0x12CB3460, 36963310300097048, 231440991, 231440994, 3, 640x360 
0x12CB3460, 36963310300418128, 231441023, 231441026, 3, 640x360 
0x12CB3460, 36963310300738536, 231441052, 231441056, 4, 640x360 
0x12CB3460, 36963310301054704, 231441082, 231441085, 3, 640x360 
0x12CB3460, 36963310301376168, 231441112, 231441115, 3, 640x360 
0x12CB3460, 36963310301695616, 231441142, 231441146, 4, 640x360 
0x12CB3460, 36963310302015832, 231441182, 231441185, 3, 640x360 
0x12CB3460, 36963310302495904, 231441223, 231441226, 3, 640x360 
0x12CB3460, 36963310302815224, 231441263, 231441269, 6, 640x360 
0x12CB3460, 36963310303134328, 231441292, 231441296, 4, 640x360 
0x12CB3460, 36963310303456576, 231441323, 231441326, 3, 640x360 
0x12CB3460, 36963310303779488, 231441374, 231441378, 4, 640x360 
0x12CB3460, 36963310304095824, 231441383, 231441387, 4, 640x360 
0x12CB3460, 36963310304414752, 231441421, 231441424, 3, 640x360 
0x12CB3460, 36963310304736016, 231441452, 231441455, 3, 640x360 
0x12CB3460, 36963310305055144, 231441483, 231441485, 2, 640x360 
0x12CB3460, 36963310305377240, 231441512, 231441516, 4, 640x360 
0x12CB3460, 36963310305697016, 231441544, 231441548, 4, 640x360 
0x12CB3460, 36963310306015360, 231441582, 231441585, 3, 640x360 
0x12CB3460, 36963310306496488, 231441633, 231441636, 3, 640x360 
0x12CB3460, 36963310306815656, 231441662, 231441666, 4, 640x360 
0x12CB3460, 36963310307136872, 231441692, 231441695, 3, 640x360 
0x12CB3460, 36963310307456128, 231441722, 231441725, 3, 640x360 
0x12CB3460, 36963310307775128, 231441752, 231441756, 4, 640x360 
0x12CB3460, 36963310308096600, 231441783, 231441787, 4, 640x360 
0x12CB3460, 36963310308415568, 231441822, 231441830, 8, 640x360 
0x12CB3460, 36963310308736248, 231441873, 231441877, 4, 640x360 
0x12CB3460, 36963310309056624, 231441882, 231441885, 3, 640x360 
0x12CB3460, 36963310309374656, 231441913, 231441916, 3, 640x360 
0x12CB3460, 36963310309696096, 231441942, 231441946, 4, 640x360 
0x12CB3460, 36963310310017656, 231441982, 231441999, 17, 640x360 
0x12CB3460, 36963310310495552, 231442033, 231442037, 4, 640x360 
0x12CB3460, 36963310310815152, 231442062, 231442066, 4, 640x360 
0x12CB3460, 36963310311135200, 231442091, 231442094, 3, 640x360 
0x12CB3460, 36963310311455800, 231442122, 231442124, 2, 640x360 
0x12CB3460, 36963310311776056, 231442152, 231442155, 3, 640x360 
0x12CB3460, 36963310312096960, 231442182, 231442186, 4, 640x360 
0x12CB3460, 36963310312416656, 231442222, 231442225, 3, 640x360 
0x12CB3460, 36963310312735040, 231442251, 231442254, 3, 640x360 
0x12CB3460, 36963310313056352, 231442282, 231442285, 3, 640x360 
0x12CB3460, 36963310313375976, 231442312, 231442315, 3, 640x360 
0x12CB3460, 36963310313696672, 231442343, 231442348, 5, 640x360 
0x12CB3460, 36963310314175488, 231442392, 231442395, 3, 640x360 
0x12CB3460, 36963310314494536, 231442433, 231442436, 3, 640x360 
0x12CB3460, 36963310314815368, 231442462, 231442465, 3, 640x360 
0x12CB3460, 36963310315135240, 231442492, 231442494, 2, 640x360 
0x12CB3460, 36963310315458896, 231442523, 231442526, 3, 640x360 
0x12CB3460, 36963310315776368, 231442554, 231442558, 4, 640x360 
0x12CB3460, 36963310316095152, 231442592, 231442594, 2, 640x360 
0x12CB3460, 36963310316415184, 231442623, 231442626, 3, 640x360 
0x12CB3460, 36963310316735424, 231442652, 231442655, 3, 640x360 
0x12CB3460, 36963310317057296, 231442682, 231442686, 4, 640x360 
0x12CB3460, 36963310317378984, 231442723, 231442729, 6, 640x360 
0x12CB3460, 36963310317696952, 231442747, 231442750, 3, 640x360 
0x12CB3460, 36963310318174512, 231442793, 231442796, 3, 640x360 
0x12CB3460, 36963310318495976, 231442831, 231442834, 3, 640x360 
0x12CB3460, 36963310318816160, 231442866, 231442870, 4, 640x360 
0x12CB3460, 36963310319134352, 231442891, 231442894, 3, 640x360 
0x12CB3460, 36963310319455104, 231442922, 231442925, 3, 640x360 
0x12CB3460, 36963310319775000, 231442951, 231442955, 4, 640x360 
0x12CB3460, 36963310320096896, 231442983, 231442987, 4, 640x360 
0x12CB3460, 36963310320417896, 231443023, 231443027, 4, 640x360 
0x12CB3460, 36963310320737344, 231443054, 231443057, 3, 640x360 
0x12CB3460, 36963310321054616, 231443083, 231443088, 5, 640x360 
0x12CB3460, 36963310321375768, 231443113, 231443115, 2, 640x360 
0x12CB3460, 36963310321855376, 231443161, 231443164, 3, 640x360 
0x12CB3460, 36963310322175720, 231443192, 231443195, 3, 640x360 
0x12CB3460, 36963310322494648, 231443223, 231443227, 4, 640x360 
0x12CB3460, 36963310322818368, 231443262, 231443265, 3, 640x360 
0x12CB3460, 36963310323134984, 231443292, 231443295, 3, 640x360 
0x12CB3460, 36963310323456072, 231443322, 231443325, 3, 640x360 
0x12CB3460, 36963310323776816, 231443376, 231443379, 3, 640x360 
0x12CB3460, 36963310324095616, 231443383, 231443387, 4, 640x360 
0x12CB3460, 36963310324415344, 231443422, 231443425, 3, 640x360 
0x12CB3460, 36963310324735928, 231443451, 231443454, 3, 640x360 
0x12CB3460, 36963310325056104, 231443482, 231443485, 3, 640x360 
0x12CB3460, 36963310325377248, 231443513, 231443516, 3, 640x360 
0x12CB3460, 36963310325855392, 231443562, 231443565, 3, 640x360 
0x12CB3460, 36963310326176024, 231443593, 231443595, 2, 640x360 
0x12CB3460, 36963310326496160, 231443623, 231443626, 3, 640x360 
0x12CB3460, 36963310326818104, 231443662, 231443665, 3, 640x360 
0x12CB3460, 36963310327136288, 231443692, 231443705, 13, 640x360 
0x12CB3460, 36963310327459120, 231443724, 231443728, 4, 640x360 
0x12CB3460, 36963310327776288, 231443753, 231443756, 3, 640x360 
0x12CB3460, 36963310328096136, 231443783, 231443787, 4, 640x360 
0x12CB3460, 36963310328415504, 231443822, 231443825, 3, 640x360 
0x12CB3460, 36963310328736096, 231443884, 231443887, 3, 640x360 
0x12CB3460, 36963310329375536, 231443911, 231443914, 3, 640x360 
0x12CB3460, 36963310329856136, 231443962, 231443964, 2, 640x360 
0x12CB3460, 36963310330174312, 231443992, 231443995, 3, 640x360 
0x12CB3460, 36963310330496240, 231444032, 231444035, 3, 640x360 
0x12CB3460, 36963310330818128, 231444061, 231444064, 3, 640x360 
0x12CB3460, 36963310331134824, 231444093, 231444096, 3, 640x360 
0x12CB3460, 36963310331454672, 231444121, 231444129, 8, 640x360 
0x12CB3460, 36963310331775240, 231444152, 231444155, 3, 640x360 
0x12CB3460, 36963310332095120, 231444182, 231444186, 4, 640x360 
0x12CB3460, 36963310332415056, 231444221, 231444224, 3, 640x360 
0x12CB3460, 36963310332736592, 231444253, 231444258, 5, 640x360 
0x12CB3460, 36963310333054768, 231444282, 231444285, 3, 640x360 
0x12CB3460, 36963310333536928, 231444332, 231444335, 3, 640x360 
0x12CB3460, 36963310333855984, 231444371, 231444374, 3, 640x360 
0x12CB3460, 36963310334175664, 231444392, 231444395, 3, 640x360 
0x12CB3460, 36963310334494856, 231444422, 231444429, 7, 640x360 
0x12CB3460, 36963310334815240, 231444462, 231444464, 2, 640x360 
0x12CB3460, 36963310335137504, 231444492, 231444495, 3, 640x360 
0x12CB3460, 36963310335455976, 231444522, 231444524, 2, 640x360 
0x12CB3460, 36963310335775960, 231444553, 231444571, 18, 640x360 
0x12CB3460, 36963310336095272, 231444592, 231444595, 3, 640x360 
0x12CB3460, 36963310336414864, 231444623, 231444625, 2, 640x360 
0x12CB3460, 36963310336736648, 231444652, 231444655, 3, 640x360 
0x12CB3460, 36963310337054784, 231444682, 231444685, 3, 640x360 
0x12CB3460, 36963310337536640, 231444732, 231444735, 3, 640x360 
0x12CB3460, 36963310337854544, 231444762, 231444766, 4, 640x360 
0x12CB3460, 36963310338174560, 231444792, 231444795, 3, 640x360 
0x12CB3460, 36963310338496504, 231444823, 231444827, 4, 640x360 
0x12CB3460, 36963310338816304, 231444880, 231444883, 3, 640x360 
0x12CB3460, 36963310339135232, 231444892, 231444895, 3, 640x360 
0x12CB3460, 36963310339454424, 231444922, 231444924, 2, 640x360 
0x12CB3460, 36963310339774760, 231444952, 231444955, 3, 640x360 
0x12CB3460, 36963310340095048, 231444993, 231444995, 2, 640x360 
0x12CB3460, 36963310340416512, 231445022, 231445025, 3, 640x360 
0x12CB3460, 36963310340738920, 231445051, 231445055, 4, 640x360 
0x12CB3460, 36963310341055592, 231445082, 231445087, 5, 640x360 
0x12CB3460, 36963310341536256, 231445132, 231445134, 2, 640x360 
0x12CB3460, 36963310341854048, 231445162, 231445165, 3, 640x360 
0x12CB3460, 36963310342175496, 231445192, 231445195, 3, 640x360 
0x12CB3460, 36963310342497176, 231445223, 231445227, 4, 640x360 
0x12CB3460, 36963310342816056, 231445263, 231445265, 2, 640x360 
0x12CB3460, 36963310343136368, 231445291, 231445294, 3, 640x360 
0x12CB3460, 36963310343455856, 231445322, 231445325, 3, 640x360 
0x12CB3460, 36963310343776592, 231445375, 231445379, 4, 640x360 
0x12CB3460, 36963310344094688, 231445383, 231445387, 4, 640x360 
0x12CB3460, 36963310344415032, 231445423, 231445426, 3, 640x360 
0x12CB3460, 36963310344734720, 231445451, 231445455, 4, 640x360 
0x12CB3460, 36963310345214312, 231445502, 231445505, 3, 640x360 
0x12CB3460, 36963310345534816, 231445532, 231445535, 3, 640x360 
0x12CB3460, 36963310345856200, 231445562, 231445565, 3, 640x360 
0x12CB3460, 36963310346175320, 231445593, 231445595, 2, 640x360 
0x12CB3460, 36963310346496536, 231445623, 231445626, 3, 640x360 
0x12CB3460, 36963310346819768, 231445662, 231445665, 3, 640x360 
0x12CB3460, 36963310347135536, 231445691, 231445694, 3, 640x360 
0x12CB3460, 36963310347456520, 231445723, 231445726, 3, 640x360 
0x12CB3460, 36963310347775256, 231445752, 231445756, 4, 640x360 
0x12CB3460, 36963310348095808, 231445782, 231445786, 4, 640x360 
0x12CB3460, 36963310348415312, 231445822, 231445825, 3, 640x360 
0x12CB3460, 36963310348737856, 231445870, 231445873, 3, 640x360 
0x12CB3460, 36963310349215240, 231445903, 231445906, 3, 640x360 
0x12CB3460, 36963310349535840, 231445932, 231445935, 3, 640x360 
0x12CB3460, 36963310349854504, 231445962, 231445965, 3, 640x360 
0x12CB3460, 36963310350176416, 231445993, 231445996, 3, 640x360 
0x12CB3460, 36963310350497320, 231446032, 231446035, 3, 640x360 
0x12CB3460, 36963310350819528, 231446061, 231446064, 3, 640x360 
0x12CB3460, 36963310351135976, 231446092, 231446096, 4, 640x360 
0x12CB3460, 36963310351455336, 231446121, 231446124, 3, 640x360 
0x12CB3460, 36963310351774472, 231446152, 231446155, 3, 640x360 
0x12CB3460, 36963310352097464, 231446192, 231446195, 3, 640x360 
0x12CB3460, 36963310352416032, 231446222, 231446225, 3, 640x360 
0x12CB3460, 36963310352735064, 231446253, 231446256, 3, 640x360 
0x12CB3460, 36963310353216240, 231446302, 231446306, 4, 640x360 
0x12CB3460, 36963310353534912, 231446332, 231446335, 3, 640x360 
0x12CB3460, 36963310353856512, 231446394, 231446396, 2, 640x360 
0x12CB3460, 36963310354495144, 231446423, 231446426, 3, 640x360 
0x12CB3460, 36963310354814896, 231446461, 231446464, 3, 640x360 
0x12CB3460, 36963310355135056, 231446492, 231446495, 3, 640x360 
0x12CB3460, 36963310355454816, 231446522, 231446529, 7, 640x360 
0x12CB3460, 36963310355775072, 231446552, 231446555, 3, 640x360 
0x12CB3460, 36963310356094768, 231446583, 231446587, 4, 640x360 
0x12CB3460, 36963310356416088, 231446621, 231446624, 3, 640x360 
0x12CB3460, 36963310356894600, 231446672, 231446675, 3, 640x360 
0x12CB3460, 36963310357216144, 231446702, 231446705, 3, 640x360 
0x12CB3460, 36963310357535256, 231446733, 231446736, 3, 640x360 
0x12CB3460, 36963310357855600, 231446762, 231446765, 3, 640x360 
0x12CB3460, 36963310358175648, 231446793, 231446795, 2, 640x360 
0x12CB3460, 36963310358496304, 231446833, 231446836, 3, 640x360 
0x12CB3460, 36963310358817096, 231446879, 231446882, 3, 640x360 
0x12CB3460, 36963310359135048, 231446892, 231446895, 3, 640x360 
0x12CB3460, 36963310359454296, 231446922, 231446927, 5, 640x360 
0x12CB3460, 36963310359774696, 231446953, 231446956, 3, 640x360 
0x12CB3460, 36963310360095512, 231446992, 231446995, 3, 640x360 
0x12CB3460, 36963310360415632, 231447022, 231447024, 2, 640x360 
0x12CB3460, 36963310360894024, 231447063, 231447066, 3, 640x360 
0x12CB3460, 36963310361215784, 231447102, 231447105, 3, 640x360 
0x12CB3460, 36963310361536360, 231447132, 231447150, 18, 640x360 
0x12CB3460, 36963310361856952, 231447162, 231447165, 3, 640x360 
0x12CB3460, 36963310362175200, 231447193, 231447196, 3, 640x360 
0x12CB3460, 36963310362497760, 231447225, 231447230, 5, 640x360 
0x12CB3460, 36963310362815728, 231447262, 231447265, 3, 640x360 
0x12CB3460, 36963310363135384, 231447293, 231447298, 5, 640x360 
0x12CB3460, 36963310363455592, 231447322, 231447324, 2, 640x360 
0x12CB3460, 36963310363778112, 231447375, 231447378, 3, 640x360 
0x12CB3460, 36963310364095888, 231447382, 231447386, 4, 640x360 
0x12CB3460, 36963310364574504, 231447432, 231447436, 4, 640x360 
0x12CB3460, 36963310364896064, 231447472, 231447475, 3, 640x360 
0x12CB3460, 36963310365215256, 231447503, 231447506, 3, 640x360 
0x12CB3460, 36963310365534640, 231447532, 231447535, 3, 640x360 
0x12CB3460, 36963310365855464, 231447562, 231447565, 3, 640x360 
0x12CB3460, 36963310366176032, 231447592, 231447596, 4, 640x360 
0x12CB3460, 36963310366496048, 231447623, 231447626, 3, 640x360 
0x12CB3460, 36963310366817584, 231447662, 231447665, 3, 640x360 
0x12CB3460, 36963310367135304, 231447691, 231447694, 3, 640x360 
0x12CB3460, 36963310367456320, 231447722, 231447725, 3, 640x360 
0x12CB3460, 36963310367774488, 231447753, 231447756, 3, 640x360 
0x12CB3460, 36963310368094872, 231447792, 231447795, 3, 640x360 
0x12CB3460, 36963310368574368, 231447833, 231447835, 2, 640x360 
0x12CB3460, 36963310368897744, 231447884, 231447887, 3, 640x360 
0x12CB3460, 36963310369216304, 231447901, 231447904, 3, 640x360 
0x12CB3460, 36963310369536216, 231447932, 231447935, 3, 640x360 
0x12CB3460, 36963310369858200, 231447962, 231447965, 3, 640x360 
0x12CB3460, 36963310370176864, 231447993, 231447996, 3, 640x360 
0x12CB3460, 36963310370495944, 231448032, 231448035, 3, 640x360 
0x12CB3460, 36963310370814768, 231448062, 231448065, 3, 640x360 
0x12CB3460, 36963310371134680, 231448092, 231448096, 4, 640x360 
0x12CB3460, 36963310371455440, 231448122, 231448125, 3, 640x360 
0x12CB3460, 36963310371774760, 231448152, 231448155, 3, 640x360 
0x12CB3460, 36963310372094904, 231448182, 231448186, 4, 640x360 
0x12CB3460, 36963310372574232, 231448232, 231448235, 3, 640x360 
0x12CB3460, 36963310372895168, 231448263, 231448267, 4, 640x360 
0x12CB3460, 36963310373216288, 231448302, 231448305, 3, 640x360 
0x12CB3460, 36963310373537056, 231448331, 231448334, 3, 640x360 
0x12CB3460, 36963310373856432, 231448388, 231448392, 4, 640x360 
0x12CB3460, 36963310374178008, 231448393, 231448396, 3, 640x360 
0x12CB3460, 36963310374495272, 231448423, 231448427, 4, 640x360 
0x12CB3460, 36963310374814464, 231448462, 231448465, 3, 640x360 
0x12CB3460, 36963310375134872, 231448491, 231448494, 3, 640x360 
0x12CB3460, 36963310375456896, 231448522, 231448530, 8, 640x360 
0x12CB3460, 36963310375775184, 231448552, 231448555, 3, 640x360 
0x12CB3460, 36963310376255744, 231448602, 231448606, 4, 640x360 
0x12CB3460, 36963310376574376, 231448632, 231448635, 3, 640x360 
0x12CB3460, 36963310376895072, 231448671, 231448675, 4, 640x360 
0x12CB3460, 36963310377214712, 231448703, 231448706, 3, 640x360 
0x12CB3460, 36963310377536368, 231448733, 231448736, 3, 640x360 
0x12CB3460, 36963310377855800, 231448762, 231448764, 2, 640x360 
0x12CB3460, 36963310378175000, 231448792, 231448796, 4, 640x360 
0x12CB3460, 36963310378494760, 231448823, 231448826, 3, 640x360 
0x12CB3460, 36963310378816248, 231448875, 231448880, 5, 640x360 
0x12CB3460, 36963310379133704, 231448892, 231448895, 3, 640x360 
0x12CB3460, 36963310379455848, 231448922, 231448924, 2, 640x360 
0x12CB3460, 36963310379774752, 231448952, 231448955, 3, 640x360 
0x12CB3460, 36963310380255936, 231449002, 231449006, 4, 640x360 
0x12CB3460, 36963310380574080, 231449033, 231449036, 3, 640x360 
0x12CB3460, 36963310380894560, 231449063, 231449067, 4, 640x360 
0x12CB3460, 36963310381215272, 231449102, 231449105, 3, 640x360 
0x12CB3460, 36963310381537704, 231449132, 231449135, 3, 640x360 
0x12CB3460, 36963310381855512, 231449162, 231449165, 3, 640x360 
0x12CB3460, 36963310382175288, 231449192, 231449195, 3, 640x360 
0x12CB3460, 36963310382494904, 231449224, 231449228, 4, 640x360 
0x12CB3460, 36963310382814376, 231449262, 231449265, 3, 640x360 
0x12CB3460, 36963310383135224, 231449293, 231449297, 4, 640x360 
0x12CB3460, 36963310383454256, 231449322, 231449325, 3, 640x360 
0x12CB3460, 36963310383775736, 231449353, 231449370, 17, 640x360 
0x12CB3460, 36963310384253432, 231449402, 231449404, 2, 640x360 
0x12CB3460, 36963310384573672, 231449431, 231449435, 4, 640x360 
0x12CB3460, 36963310384894144, 231449473, 231449476, 3, 640x360 
0x12CB3460, 36963310385213864, 231449502, 231449505, 3, 640x360 
0x12CB3460, 36963310385535288, 231449532, 231449535, 3, 640x360 
0x12CB3460, 36963310385854272, 231449562, 231449564, 2, 640x360 
0x12CB3460, 36963310386173856, 231449592, 231449596, 4, 640x360 
0x12CB3460, 36963310386494704, 231449633, 231449635, 2, 640x360 
0x12CB3460, 36963310386815344, 231449663, 231449665, 2, 640x360 
0x12CB3460, 36963310387134696, 231449692, 231449695, 3, 640x360 
0x12CB3460, 36963310387457104, 231449722, 231449726, 4, 640x360 
0x12CB3460, 36963310387933976, 231449772, 231449775, 3, 640x360 
0x12CB3460, 36963310388254680, 231449802, 231449806, 4, 640x360 
0x12CB3460, 36963310388573792, 231449832, 231449835, 3, 640x360 
0x12CB3460, 36963310388897904, 231449867, 231449870, 3, 640x360 
0x12CB3460, 36963310389214888, 231449902, 231449905, 3, 640x360 
0x12CB3460, 36963310389535968, 231449932, 231449935, 3, 640x360 
0x12CB3460, 36963310389855792, 231449962, 231449966, 4, 640x360 
0x12CB3460, 36963310390176136, 231449992, 231449995, 3, 640x360 
0x12CB3460, 36963310390494288, 231450022, 231450025, 3, 640x360 
0x12CB3460, 36963310390817480, 231450056, 231450060, 4, 640x360 
0x12CB3460, 36963310391140592, 231450092, 231450097, 5, 640x360 
0x12CB3460, 36963310391459080, 231450124, 231450129, 5, 640x360 
0x12CB3460, 36963310391933808, 231450172, 231450181, 9, 640x360 
0x12CB3460, 36963310392255312, 231450201, 231450209, 8, 640x360 
0x12CB3460, 36963310392574512, 231450232, 231450236, 4, 640x360 
0x12CB3460, 36963310392895264, 231450263, 231450266, 3, 640x360 
0x12CB3460, 36963310393220072, 231450303, 231450309, 6, 640x360 
0x12CB3460, 36963310393533824, 231450333, 231450337, 4, 640x360 
0x12CB3460, 36963310393856560, 231450374, 231450377, 3, 640x360 
0x12CB3460, 36963310394174944, 231450392, 231450395, 3, 640x360 
0x12CB3460, 36963310394494960, 231450422, 231450427, 5, 640x360 
0x12CB3460, 36963310394814504, 231450462, 231450465, 3, 640x360 
0x12CB3460, 36963310395135216, 231450492, 231450495, 3, 640x360 
0x12CB3460, 36963310395456064, 231450522, 231450525, 3, 640x360 
0x12CB3460, 36963310395935240, 231450573, 231450576, 3, 640x360 
0x12CB3460, 36963310396253688, 231450601, 231450604, 3, 640x360 
0x12CB3460, 36963310396573584, 231450632, 231450635, 3, 640x360 
0x12CB3460, 36963310396894696, 231450673, 231450676, 3, 640x360 
0x12CB3460, 36963310397214720, 231450702, 231450705, 3, 640x360 
0x12CB3460, 36963310397536432, 231450732, 231450734, 2, 640x360 
0x12CB3460, 36963310397854784, 231450762, 231450764, 2, 640x360 
0x12CB3460, 36963310398176864, 231450792, 231450796, 4, 640x360 
0x12CB3460, 36963310398495592, 231450822, 231450826, 4, 640x360 
0x12CB3460, 36963310398816520, 231450875, 231450878, 3, 640x360 
0x12CB3460, 36963310399135288, 231450892, 231450895, 3, 640x360 
0x12CB3460, 36963310399613808, 231450942, 231450947, 5, 640x360 
0x12CB3460, 36963310399935520, 231450971, 231450975, 4, 640x360 
0x12CB3460, 36963310400255272, 231451002, 231451006, 4, 640x360 
0x12CB3460, 36963310400574584, 231451033, 231451036, 3, 640x360 
0x12CB3460, 36963310400893944, 231451072, 231451075, 3, 640x360 
0x12CB3460, 36963310401214424, 231451102, 231451106, 4, 640x360 
0x12CB3460, 36963310401534096, 231451132, 231451135, 3, 640x360 
0x12CB3460, 36963310401853656, 231451162, 231451165, 3, 640x360 
0x12CB3460, 36963310402178936, 231451192, 231451196, 4, 640x360 
0x12CB3460, 36963310402494312, 231451222, 231451225, 3, 640x360 
0x12CB3460, 36963310402815152, 231451262, 231451267, 5, 640x360 
0x12CB3460, 36963310403134704, 231451293, 231451296, 3, 640x360 
0x12CB3460, 36963310403616464, 231451342, 231451347, 5, 640x360 
0x12CB3460, 36963310403937344, 231451379, 231451382, 3, 640x360 
0x12CB3460, 36963310404255200, 231451402, 231451405, 3, 640x360 
0x12CB3460, 36963310404573904, 231451432, 231451436, 4, 640x360 
0x12CB3460, 36963310404894600, 231451471, 231451474, 3, 640x360 
0x12CB3460, 36963310405215032, 231451502, 231451505, 3, 640x360 
0x12CB3460, 36963310405535824, 231451532, 231451534, 2, 640x360 
0x12CB3460, 36963310405856888, 231451562, 231451566, 4, 640x360 
0x12CB3460, 36963310406178024, 231451592, 231451595, 3, 640x360 
0x12CB3460, 36963310406493736, 231451623, 231451625, 2, 640x360 
0x12CB3460, 36963310406815064, 231451661, 231451664, 3, 640x360 
0x12CB3460, 36963310407293176, 231451703, 231451708, 5, 640x360 
0x12CB3460, 36963310407614416, 231451743, 231451747, 4, 640x360 
0x12CB3460, 36963310407935320, 231451772, 231451775, 3, 640x360 
0x12CB3460, 36963310408255400, 231451801, 231451804, 3, 640x360 
0x12CB3460, 36963310408573672, 231451832, 231451835, 3, 640x360 
0x12CB3460, 36963310408894696, 231451869, 231451873, 4, 640x360 
0x12CB3460, 36963310409213624, 231451902, 231451905, 3, 640x360 
0x12CB3460, 36963310409534200, 231451932, 231451938, 6, 640x360 
0x12CB3460, 36963310409854760, 231451963, 231451966, 3, 640x360 
0x12CB3460, 36963310410176168, 231451991, 231451995, 4, 640x360 
0x12CB3460, 36963310410494992, 231452033, 231452037, 4, 640x360 
0x12CB3460, 36963310410814880, 231452057, 231452060, 3, 640x360 
0x12CB3460, 36963310411293184, 231452102, 231452108, 6, 640x360 
0x12CB3460, 36963310411615296, 231452142, 231452144, 2, 640x360 
0x12CB3460, 36963310411933488, 231452173, 231452177, 4, 640x360 
0x12CB3460, 36963310412253384, 231452202, 231452206, 4, 640x360 
0x12CB3460, 36963310412575808, 231452234, 231452236, 2, 640x360 
0x12CB3460, 36963310412894248, 231452263, 231452267, 4, 640x360 
0x12CB3460, 36963310413214640, 231452301, 231452305, 4, 640x360 
0x12CB3460, 36963310413534408, 231452332, 231452335, 3, 640x360 
0x12CB3460, 36963310413855016, 231452376, 231452379, 3, 640x360 
0x12CB3460, 36963310414174176, 231452393, 231452395, 2, 640x360 
0x12CB3460, 36963310414499984, 231452432, 231452435, 3, 640x360 
0x12CB3460, 36963310414814856, 231452461, 231452464, 3, 640x360 
0x12CB3460, 36963310415296032, 231452512, 231452514, 2, 640x360 
0x12CB3460, 36963310415614512, 231452542, 231452544, 2, 640x360 
0x12CB3460, 36963310415933728, 231452572, 231452574, 2, 640x360 
0x12CB3460, 36963310416255848, 231452602, 231452605, 3, 640x360 
0x12CB3460, 36963310416575088, 231452632, 231452635, 3, 640x360 
0x12CB3460, 36963310416894800, 231452673, 231452677, 4, 640x360 
0x12CB3460, 36963310417214704, 231452702, 231452706, 4, 640x360 
0x12CB3460, 36963310417535736, 231452732, 231452735, 3, 640x360 
0x12CB3460, 36963310417855464, 231452762, 231452764, 2, 640x360 
0x12CB3460, 36963310418174664, 231452791, 231452794, 3, 640x360 
0x12CB3460, 36963310418494048, 231452823, 231452826, 3, 640x360 
0x12CB3460, 36963310418975640, 231452873, 231452876, 3, 640x360 
0x12CB3460, 36963310419295608, 231452903, 231452906, 3, 640x360 
0x12CB3460, 36963310419615568, 231452942, 231452944, 2, 640x360 
0x12CB3460, 36963310419935824, 231452972, 231452975, 3, 640x360 
0x12CB3460, 36963310420254624, 231453002, 231453005, 3, 640x360 
0x12CB3460, 36963310420577832, 231453032, 231453036, 4, 640x360 
0x12CB3460, 36963310420894792, 231453062, 231453066, 4, 640x360 
0x12CB3460, 36963310421214168, 231453102, 231453106, 4, 640x360 
0x12CB3460, 36963310421534432, 231453133, 231453136, 3, 640x360 
0x12CB3460, 36963310421854960, 231453162, 231453165, 3, 640x360 
0x12CB3460, 36963310422175136, 231453191, 231453194, 3, 640x360 
0x12CB3460, 36963310422495936, 231453233, 231453237, 4, 640x360 
0x12CB3460, 36963310422975200, 231453272, 231453275, 3, 640x360 
0x12CB3460, 36963310423295528, 231453302, 231453305, 3, 640x360 
0x12CB3460, 36963310423616080, 231453342, 231453346, 4, 640x360 
0x12CB3460, 36963310423935256, 231453370, 231453373, 3, 640x360 
0x12CB3460, 36963310424254048, 231453403, 231453406, 3, 640x360 
0x12CB3460, 36963310424574600, 231453432, 231453436, 4, 640x360 
0x12CB3460, 36963310424895432, 231453462, 231453465, 3, 640x360 
0x12CB3460, 36963310425215216, 231453502, 231453505, 3, 640x360 
0x12CB3460, 36963310425534736, 231453532, 231453534, 2, 640x360 
0x12CB3460, 36963310425854936, 231453563, 231453566, 3, 640x360 
0x12CB3460, 36963310426176144, 231453593, 231453596, 3, 640x360 
0x12CB3460, 36963310426497096, 231453633, 231453636, 3, 640x360 
0x12CB3460, 36963310426975728, 231453672, 231453676, 4, 640x360 
0x12CB3460, 36963310427294392, 231453703, 231453708, 5, 640x360 
0x12CB3460, 36963310427617472, 231453742, 231453745, 3, 640x360 
0x12CB3460, 36963310427935264, 231453772, 231453775, 3, 640x360 
0x12CB3460, 36963310428255376, 231453802, 231453804, 2, 640x360 
0x12CB3460, 36963310428574632, 231453833, 231453836, 3, 640x360 
0x12CB3460, 36963310428895656, 231453865, 231453869, 4, 640x360 
0x12CB3460, 36963310429214032, 231453902, 231453905, 3, 640x360 
0x12CB3460, 36963310429534280, 231453931, 231453934, 3, 640x360 
0x12CB3460, 36963310429856496, 231453962, 231453965, 3, 640x360 
0x12CB3460, 36963310430176568, 231453992, 231453996, 4, 640x360 
0x12CB3460, 36963310430655392, 231454042, 231454045, 3, 640x360 
0x12CB3460, 36963310430973624, 231454073, 231454075, 2, 640x360 
0x12CB3460, 36963310431295088, 231454112, 231454115, 3, 640x360 
0x12CB3460, 36963310431615360, 231454143, 231454145, 2, 640x360 
0x12CB3460, 36963310431935024, 231454172, 231454174, 2, 640x360 
0x12CB3460, 36963310432255120, 231454202, 231454205, 3, 640x360 
0x12CB3460, 36963310432574752, 231454232, 231454236, 4, 640x360 
0x12CB3460, 36963310432893504, 231454263, 231454266, 3, 640x360 
0x12CB3460, 36963310433215808, 231454302, 231454304, 2, 640x360 
0x12CB3460, 36963310433535448, 231454333, 231454335, 2, 640x360 
0x12CB3460, 36963310433858216, 231454375, 231454378, 3, 640x360 
0x12CB3460, 36963310434174208, 231454391, 231454394, 3, 640x360 
0x12CB3460, 36963310434655056, 231454442, 231454445, 3, 640x360 
0x12CB3460, 36963310434975352, 231454472, 231454475, 3, 640x360 
0x12CB3460, 36963310435295560, 231454502, 231454505, 3, 640x360 
0x12CB3460, 36963310435614424, 231454542, 231454545, 3, 640x360 
0x12CB3460, 36963310435935448, 231454572, 231454575, 3, 640x360 
0x12CB3460, 36963310436254784, 231454602, 231454606, 4, 640x360 
0x12CB3460, 36963310436573728, 231454632, 231454635, 3, 640x360 
0x12CB3460, 36963310436895368, 231454663, 231454667, 4, 640x360 
0x12CB3460, 36963310437215584, 231454702, 231454705, 3, 640x360 
0x12CB3460, 36963310437535448, 231454732, 231454737, 5, 640x360 
0x12CB3460, 36963310437854832, 231454763, 231454765, 2, 640x360 
0x12CB3460, 36963310438333704, 231454812, 231454815, 3, 640x360 
0x12CB3460, 36963310438653968, 231454843, 231454867, 24, 640x360 
0x12CB3460, 36963310438973944, 231454882, 231454885, 3, 640x360 
0x12CB3460, 36963310439301088, 231454903, 231454911, 8, 640x360 
0x12CB3460, 36963310439613944, 231454941, 231454944, 3, 640x360 
0x12CB3460, 36963310439935696, 231454972, 231454976, 4, 640x360 
0x12CB3460, 36963310440256576, 231455002, 231455008, 6, 640x360 
0x12CB3460, 36963310440576696, 231455033, 231455039, 6, 640x360 
0x12CB3460, 36963310440893576, 231455063, 231455066, 3, 640x360 
0x12CB3460, 36963310441213968, 231455102, 231455105, 3, 640x360 
0x12CB3460, 36963310441533752, 231455132, 231455135, 3, 640x360 
0x12CB3460, 36963310441854312, 231455162, 231455179, 17, 640x360 
0x12CB3460, 36963310442337280, 231455213, 231455216, 3, 640x360 
0x12CB3460, 36963310442655696, 231455242, 231455245, 3, 640x360 
0x12CB3460, 36963310442975696, 231455273, 231455280, 7, 640x360 
0x12CB3460, 36963310443296152, 231455302, 231455306, 4, 640x360 
0x12CB3460, 36963310443614552, 231455341, 231455344, 3, 640x360 
0x12CB3460, 36963310443935888, 231455378, 231455381, 3, 640x360 
0x12CB3460, 36963310444253720, 231455401, 231455404, 3, 640x360 
0x12CB3460, 36963310444574424, 231455432, 231455435, 3, 640x360 
0x12CB3460, 36963310444898264, 231455463, 231455466, 3, 640x360 
0x12CB3460, 36963310445215424, 231455502, 231455505, 3, 640x360 
0x12CB3460, 36963310445536376, 231455532, 231455535, 3, 640x360 
0x12CB3460, 36963310445855416, 231455562, 231455565, 3, 640x360 
0x12CB3460, 36963310446333504, 231455611, 231455614, 3, 640x360 
0x12CB3460, 36963310446655600, 231455642, 231455645, 3, 640x360 
0x12CB3460, 36963310446975480, 231455672, 231455675, 3, 640x360 
0x12CB3460, 36963310447294416, 231455712, 231455715, 3, 640x360 
0x12CB3460, 36963310447615320, 231455743, 231455746, 3, 640x360 
0x12CB3460, 36963310447934736, 231455772, 231455775, 3, 640x360 
0x12CB3460, 36963310448258560, 231455802, 231455804, 2, 640x360 
0x12CB3460, 36963310448574024, 231455833, 231455836, 3, 640x360 
0x12CB3460, 36963310448895720, 231455881, 231455884, 3, 640x360 
0x12CB3460, 36963310449215456, 231455901, 231455904, 3, 640x360 
0x12CB3460, 36963310449534336, 231455932, 231455934, 2, 640x360 
0x12CB3460, 36963310450015992, 231455982, 231455985, 3, 640x360 
0x12CB3460, 36963310450336408, 231456013, 231456015, 2, 640x360 
0x12CB3460, 36963310450657744, 231456043, 231456046, 3, 640x360 
0x12CB3460, 36963310450976192, 231456073, 231456076, 3, 640x360 
0x12CB3460, 36963310451293736, 231456102, 231456107, 5, 640x360 
0x12CB3460, 36963310451614168, 231456142, 231456145, 3, 640x360 
0x12CB3460, 36963310451934664, 231456172, 231456175, 3, 640x360 
0x12CB3460, 36963310452254152, 231456201, 231456204, 3, 640x360 
0x12CB3460, 36963310452575016, 231456233, 231456236, 3, 640x360 
0x12CB3460, 36963310452895064, 231456263, 231456267, 4, 640x360 
0x12CB3460, 36963310453214528, 231456302, 231456305, 3, 640x360 
0x12CB3460, 36963310453534344, 231456333, 231456335, 2, 640x360 
0x12CB3460, 36963310454014088, 231456375, 231456378, 3, 640x360 
0x12CB3460, 36963310454333560, 231456412, 231456415, 3, 640x360 
0x12CB3460, 36963310454655648, 231456442, 231456447, 5, 640x360 
0x12CB3460, 36963310454975048, 231456472, 231456475, 3, 640x360 
0x12CB3460, 36963310455294512, 231456512, 231456515, 3, 640x360 
0x12CB3460, 36963310455616224, 231456542, 231456545, 3, 640x360 
0x12CB3460, 36963310455935496, 231456571, 231456574, 3, 640x360 
0x12CB3460, 36963310456254928, 231456603, 231456606, 3, 640x360 
0x12CB3460, 36963310456574232, 231456632, 231456635, 3, 640x360 
0x12CB3460, 36963310456896416, 231456672, 231456674, 2, 640x360 
0x12CB3460, 36963310457215792, 231456701, 231456705, 4, 640x360 
0x12CB3460, 36963310457534376, 231456732, 231456735, 3, 640x360 
0x12CB3460, 36963310458015784, 231456782, 231456785, 3, 640x360 
0x12CB3460, 36963310458334976, 231456812, 231456815, 3, 640x360 
0x12CB3460, 36963310458656912, 231456842, 231456845, 3, 640x360 
0x12CB3460, 36963310458979200, 231456887, 231456890, 3, 640x360 
0x12CB3460, 36963310459293584, 231456912, 231456915, 3, 640x360 
0x12CB3460, 36963310459614216, 231456941, 231456944, 3, 640x360 
0x12CB3460, 36963310459935208, 231456972, 231456974, 2, 640x360 
0x12CB3460, 36963310460255624, 231457001, 231457004, 3, 640x360 
0x12CB3460, 36963310460576776, 231457032, 231457036, 4, 640x360 
0x12CB3460, 36963310460894744, 231457063, 231457067, 4, 640x360 
0x12CB3460, 36963310461219216, 231457102, 231457105, 3, 640x360 
0x12CB3460, 36963310461694792, 231457143, 231457146, 3, 640x360 
0x12CB3460, 36963310462014384, 231457182, 231457184, 2, 640x360 
0x12CB3460, 36963310462335064, 231457212, 231457215, 3, 640x360 
0x12CB3460, 36963310462656480, 231457242, 231457245, 3, 640x360 
0x12CB3460, 36963310462974400, 231457273, 231457276, 3, 640x360 
0x12CB3460, 36963310463294264, 231457302, 231457306, 4, 640x360 
0x12CB3460, 36963310463615472, 231457342, 231457345, 3, 640x360 
0x12CB3460, 36963310463937984, 231457374, 231457377, 3, 640x360 
0x12CB3460, 36963310464254112, 231457403, 231457406, 3, 640x360 
0x12CB3460, 36963310464574624, 231457432, 231457435, 3, 640x360 
0x12CB3460, 36963310464895112, 231457471, 231457474, 3, 640x360 
0x12CB3460, 36963310465215056, 231457502, 231457505, 3, 640x360 
0x12CB3460, 36963310465697624, 231457552, 231457556, 4, 640x360 
0x12CB3460, 36963310466020528, 231457583, 231457587, 4, 640x360 
0x12CB3460, 36963310466338984, 231457613, 231457616, 3, 640x360 
0x12CB3460, 36963310466655624, 231457642, 231457644, 2, 640x360 
0x12CB3460, 36963310466974056, 231457673, 231457675, 2, 640x360 
0x12CB3460, 36963310467295008, 231457711, 231457714, 3, 640x360 
0x12CB3460, 36963310467615832, 231457736, 231457741, 5, 640x360 
0x12CB3460, 36963310467934704, 231457772, 231457775, 3, 640x360 
0x12CB3460, 36963310468253608, 231457802, 231457805, 3, 640x360 
0x12CB3460, 36963310468576152, 231457832, 231457835, 3, 640x360 
0x12CB3460, 36963310468894752, 231457868, 231457871, 3, 640x360 
0x12CB3460, 36963310469215656, 231457902, 231457905, 3, 640x360 
0x12CB3460, 36963310469695632, 231457943, 231457946, 3, 640x360 
0x12CB3460, 36963310470015920, 231457982, 231457985, 3, 640x360 
0x12CB3460, 36963310470336184, 231458012, 231458015, 3, 640x360 
0x12CB3460, 36963310470657696, 231458044, 231458047, 3, 640x360 
0x12CB3460, 36963310470973952, 231458073, 231458075, 2, 640x360 
0x12CB3460, 36963310471294232, 231458112, 231458115, 3, 640x360 
0x12CB3460, 36963310471614432, 231458141, 231458144, 3, 640x360 
0x12CB3460, 36963310471933640, 231458172, 231458174, 2, 640x360 
0x12CB3460, 36963310472255096, 231458201, 231458204, 3, 640x360 
0x12CB3460, 36963310472576920, 231458232, 231458236, 4, 640x360 
0x12CB3460, 36963310472894776, 231458272, 231458279, 7, 640x360 
0x12CB3460, 36963310473375424, 231458312, 231458315, 3, 640x360 
0x12CB3460, 36963310473696672, 231458353, 231458375, 22, 640x360 
0x12CB3460, 36963310474013984, 231458386, 231458390, 4, 640x360 
0x12CB3460, 36963310474334976, 231458411, 231458414, 3, 640x360 
0x12CB3460, 36963310474654824, 231458442, 231458444, 2, 640x360 
0x12CB3460, 36963310474974984, 231458473, 231458475, 2, 640x360 
0x12CB3460, 36963310475295112, 231458502, 231458507, 5, 640x360 
0x12CB3460, 36963310475613824, 231458541, 231458544, 3, 640x360 
0x12CB3460, 36963310475934944, 231458572, 231458575, 3, 640x360 
0x12CB3460, 36963310476254832, 231458602, 231458605, 3, 640x360 
0x12CB3460, 36963310476575984, 231458632, 231458635, 3, 640x360 
0x12CB3460, 36963310476895584, 231458663, 231458666, 3, 640x360 
0x12CB3460, 36963310477376968, 231458713, 231458716, 3, 640x360 
0x12CB3460, 36963310477697144, 231458745, 231458749, 4, 640x360 
0x12CB3460, 36963310478014032, 231458782, 231458785, 3, 640x360 
0x12CB3460, 36963310478333784, 231458812, 231458815, 3, 640x360 
0x12CB3460, 36963310478655312, 231458842, 231458844, 2, 640x360 
0x12CB3460, 36963310478977936, 231458888, 231458891, 3, 640x360 
0x12CB3460, 36963310479294984, 231458902, 231458905, 3, 640x360 
0x12CB3460, 36963310479614648, 231458942, 231458945, 3, 640x360 
0x12CB3460, 36963310479935312, 231458972, 231458975, 3, 640x360 
0x12CB3460, 36963310480256032, 231459003, 231459006, 3, 640x360 
0x12CB3460, 36963310480576184, 231459032, 231459036, 4, 640x360 
0x12CB3460, 36963310481054632, 231459082, 231459085, 3, 640x360 
0x12CB3460, 36963310481375440, 231459112, 231459116, 4, 640x360 
0x12CB3460, 36963310481694432, 231459142, 231459145, 3, 640x360 
0x12CB3460, 36963310482015176, 231459182, 231459185, 3, 640x360 
0x12CB3460, 36963310482334856, 231459211, 231459215, 4, 640x360 
0x12CB3460, 36963310482654336, 231459243, 231459245, 2, 640x360 
0x12CB3460, 36963310482974784, 231459272, 231459276, 4, 640x360 
0x12CB3460, 36963310483293240, 231459302, 231459306, 4, 640x360 
0x12CB3460, 36963310483615336, 231459342, 231459345, 3, 640x360 
0x12CB3460, 36963310483935320, 231459376, 231459380, 4, 640x360 
0x12CB3460, 36963310484253800, 231459402, 231459405, 3, 640x360 
0x12CB3460, 36963310484576280, 231459432, 231459436, 4, 640x360 
0x12CB3460, 36963310485055176, 231459482, 231459499, 17, 640x360 
0x12CB3460, 36963310485373824, 231459511, 231459515, 4, 640x360 
0x12CB3460, 36963310485694840, 231459542, 231459545, 3, 640x360 
0x12CB3460, 36963310486015872, 231459582, 231459585, 3, 640x360 
0x12CB3460, 36963310486334840, 231459612, 231459615, 3, 640x360 
0x12CB3460, 36963310486654936, 231459642, 231459644, 2, 640x360 
0x12CB3460, 36963310486975376, 231459673, 231459675, 2, 640x360 
0x12CB3460, 36963310487294816, 231459713, 231459717, 4, 640x360 
0x12CB3460, 36963310487617088, 231459743, 231459746, 3, 640x360 
0x12CB3460, 36963310487934096, 231459772, 231459778, 6, 640x360 
0x12CB3460, 36963310488255088, 231459802, 231459805, 3, 640x360 
0x12CB3460, 36963310488576584, 231459832, 231459835, 3, 640x360 
0x12CB3460, 36963310489053696, 231459883, 231459885, 2, 640x360 
0x12CB3460, 36963310489374904, 231459912, 231459915, 3, 640x360 
0x12CB3460, 36963310489695456, 231459943, 231459947, 4, 640x360 
0x12CB3460, 36963310490013760, 231459982, 231459985, 3, 640x360 
0x12CB3460, 36963310490335864, 231460011, 231460014, 3, 640x360 
0x12CB3460, 36963310490655064, 231460042, 231460046, 4, 640x360 
0x12CB3460, 36963310490975192, 231460071, 231460075, 4, 640x360 
0x12CB3460, 36963310491294760, 231460102, 231460107, 5, 640x360 
0x12CB3460, 36963310491613320, 231460142, 231460145, 3, 640x360 
0x12CB3460, 36963310491934952, 231460171, 231460174, 3, 640x360 
0x12CB3460, 36963310492254688, 231460202, 231460205, 3, 640x360 
0x12CB3460, 36963310492734856, 231460252, 231460254, 2, 640x360 
0x12CB3460, 36963310493055328, 231460283, 231460285, 2, 640x360 
0x12CB3460, 36963310493375224, 231460312, 231460315, 3, 640x360 
0x12CB3460, 36963310493695704, 231460352, 231460356, 4, 640x360 
0x12CB3460, 36963310494014368, 231460382, 231460385, 3, 640x360 
0x12CB3460, 36963310494334224, 231460412, 231460414, 2, 640x360 
0x12CB3460, 36963310494654944, 231460442, 231460445, 3, 640x360 
0x12CB3460, 36963310494973992, 231460472, 231460475, 3, 640x360 
0x12CB3460, 36963310495293584, 231460503, 231460522, 19, 640x360 
0x12CB3460, 36963310495614744, 231460542, 231460545, 3, 640x360 
0x12CB3460, 36963310495934392, 231460571, 231460574, 3, 640x360 
0x12CB3460, 36963310496255624, 231460602, 231460606, 4, 640x360 
0x12CB3460, 36963310496734600, 231460652, 231460654, 2, 640x360 
0x12CB3460, 36963310497054512, 231460682, 231460685, 3, 640x360 
0x12CB3460, 36963310497374728, 231460712, 231460715, 3, 640x360 
0x12CB3460, 36963310497694360, 231460743, 231460747, 4, 640x360 
0x12CB3460, 36963310498015992, 231460781, 231460784, 3, 640x360 
0x12CB3460, 36963310498334872, 231460812, 231460814, 2, 640x360 
0x12CB3460, 36963310498655520, 231460842, 231460862, 20, 640x360 
0x12CB3460, 36963310498974024, 231460874, 231460877, 3, 640x360 
0x12CB3460, 36963310499293256, 231460902, 231460906, 4, 640x360 
0x12CB3460, 36963310499613944, 231460942, 231460944, 2, 640x360 
0x12CB3460, 36963310499935960, 231460972, 231460975, 3, 640x360 
0x12CB3460, 36963310500255928, 231461002, 231461005, 3, 640x360 
0x12CB3460, 36963310500735200, 231461052, 231461055, 3, 640x360 
0x12CB3460, 36963310501053232, 231461083, 231461086, 3, 640x360 
0x12CB3460, 36963310501373144, 231461112, 231461115, 3, 640x360 
0x12CB3460, 36963310501694912, 231461142, 231461146, 4, 640x360 
0x12CB3460, 36963310502015896, 231461182, 231461200, 18, 640x360 
0x12CB3460, 36963310502335568, 231461211, 231461215, 4, 640x360 
0x12CB3460, 36963310502654752, 231461243, 231461245, 2, 640x360 
0x12CB3460, 36963310502974392, 231461272, 231461275, 3, 640x360 
0x12CB3460, 36963310503294016, 231461312, 231461315, 3, 640x360 
0x12CB3460, 36963310503616336, 231461343, 231461347, 4, 640x360 
0x12CB3460, 36963310503936280, 231461378, 231461382, 4, 640x360 
0x12CB3460, 36963310504414840, 231461422, 231461424, 2, 640x360 
0x12CB3460, 36963310504734456, 231461452, 231461455, 3, 640x360 
0x12CB3460, 36963310505053136, 231461481, 231461484, 3, 640x360 
0x12CB3460, 36963310505374232, 231461512, 231461515, 3, 640x360 
0x12CB3460, 36963310505694288, 231461552, 231461555, 3, 640x360 
0x12CB3460, 36963310506013912, 231461581, 231461584, 3, 640x360 
0x12CB3460, 36963310506334536, 231461612, 231461615, 3, 640x360 
0x12CB3460, 36963310506653152, 231461642, 231461644, 2, 640x360 
0x12CB3460, 36963310506973240, 231461672, 231461675, 3, 640x360 
0x12CB3460, 36963310507294008, 231461712, 231461715, 3, 640x360 
0x12CB3460, 36963310507614536, 231461735, 231461738, 3, 640x360 
0x12CB3460, 36963310507933808, 231461772, 231461775, 3, 640x360 
0x12CB3460, 36963310508414104, 231461822, 231461825, 3, 640x360 
0x12CB3460, 36963310508736544, 231461853, 231461856, 3, 640x360 
0x12CB3460, 36963310509054632, 231461889, 231461893, 4, 640x360 
0x12CB3460, 36963310509373032, 231461912, 231461915, 3, 640x360 
0x12CB3460, 36963310509695136, 231461942, 231461946, 4, 640x360 
0x12CB3460, 36963310510014328, 231461982, 231461986, 4, 640x360 
0x12CB3460, 36963310510334328, 231462011, 231462014, 3, 640x360 
0x12CB3460, 36963310510654088, 231462042, 231462045, 3, 640x360 
0x12CB3460, 36963310510973624, 231462073, 231462076, 3, 640x360 
0x12CB3460, 36963310511296096, 231462111, 231462114, 3, 640x360 
0x12CB3460, 36963310511614040, 231462142, 231462144, 2, 640x360 
0x12CB3460, 36963310511935280, 231462173, 231462175, 2, 640x360 
0x12CB3460, 36963310512416104, 231462222, 231462225, 3, 640x360 
0x12CB3460, 36963310512734352, 231462251, 231462254, 3, 640x360 
0x12CB3460, 36963310513053568, 231462282, 231462285, 3, 640x360 
0x12CB3460, 36963310513374360, 231462311, 231462315, 4, 640x360 
0x12CB3460, 36963310513694464, 231462342, 231462346, 4, 640x360 
0x12CB3460, 36963310514013944, 231462382, 231462385, 3, 640x360 
0x12CB3460, 36963310514333080, 231462411, 231462414, 3, 640x360 
0x12CB3460, 36963310514654384, 231462443, 231462445, 2, 640x360 
0x12CB3460, 36963310514974720, 231462472, 231462476, 4, 640x360 
0x12CB3460, 36963310515294656, 231462512, 231462515, 3, 640x360 
0x12CB3460, 36963310515614296, 231462542, 231462544, 2, 640x360 
0x12CB3460, 36963310516096928, 231462592, 231462595, 3, 640x360 
0x12CB3460, 36963310516419152, 231462622, 231462625, 3, 640x360 
0x12CB3460, 36963310516733288, 231462653, 231462655, 2, 640x360 
0x12CB3460, 36963310517056008, 231462682, 231462685, 3, 640x360 
0x12CB3460, 36963310517375224, 231462712, 231462716, 4, 640x360 
0x12CB3460, 36963310517695968, 231462743, 231462746, 3, 640x360 
0x12CB3460, 36963310518015112, 231462782, 231462785, 3, 640x360 
0x12CB3460, 36963310518333464, 231462812, 231462814, 2, 640x360 
0x12CB3460, 36963310518655064, 231462842, 231462845, 3, 640x360 
0x12CB3460, 36963310518974392, 231462876, 231462880, 4, 640x360 
0x12CB3460, 36963310519294744, 231462902, 231462906, 4, 640x360 
0x12CB3460, 36963310519614384, 231462942, 231462944, 2, 640x360 
0x12CB3460, 36963310520094952, 231462992, 231462995, 3, 640x360 
0x12CB3460, 36963310520413984, 231463021, 231463030, 9, 640x360 
0x12CB3460, 36963310520734944, 231463052, 231463055, 3, 640x360 
0x12CB3460, 36963310521053160, 231463082, 231463085, 3, 640x360 
0x12CB3460, 36963310521373320, 231463113, 231463117, 4, 640x360 
0x12CB3460, 36963310521694576, 231463142, 231463147, 5, 640x360 
0x12CB3460, 36963310522013840, 231463181, 231463184, 3, 640x360 
0x12CB3460, 36963310522333472, 231463212, 231463215, 3, 640x360 
0x12CB3460, 36963310522654920, 231463242, 231463244, 2, 640x360 
0x12CB3460, 36963310522974840, 231463272, 231463276, 4, 640x360 
0x12CB3460, 36963310523294576, 231463312, 231463315, 3, 640x360 
0x12CB3460, 36963310523775744, 231463352, 231463355, 3, 640x360 
0x12CB3460, 36963310524097224, 231463383, 231463387, 4, 640x360 
0x12CB3460, 36963310524413472, 231463422, 231463430, 8, 640x360 
0x12CB3460, 36963310524735408, 231463453, 231463456, 3, 640x360 
0x12CB3460, 36963310525053832, 231463483, 231463486, 3, 640x360 
0x12CB3460, 36963310525374760, 231463512, 231463515, 3, 640x360 
0x12CB3460, 36963310525695064, 231463551, 231463554, 3, 640x360 
0x12CB3460, 36963310526014152, 231463583, 231463586, 3, 640x360 
0x12CB3460, 36963310526338288, 231463612, 231463615, 3, 640x360 
0x12CB3460, 36963310526654624, 231463642, 231463644, 2, 640x360 
0x12CB3460, 36963310526973960, 231463672, 231463675, 3, 640x360 
0x12CB3460, 36963310527296200, 231463712, 231463715, 3, 640x360 
0x12CB3460, 36963310527774824, 231463751, 231463755, 4, 640x360 
0x12CB3460, 36963310528093096, 231463792, 231463795, 3, 640x360 
0x12CB3460, 36963310528413280, 231463822, 231463824, 2, 640x360 
0x12CB3460, 36963310528733776, 231463869, 231463872, 3, 640x360 
0x12CB3460, 36963310529053352, 231463882, 231463884, 2, 640x360 
0x12CB3460, 36963310529374152, 231463912, 231463915, 3, 640x360 
0x12CB3460, 36963310529693704, 231463952, 231463955, 3, 640x360 
0x12CB3460, 36963310530014680, 231463982, 231463985, 3, 640x360 
0x12CB3460, 36963310530334032, 231464011, 231464014, 3, 640x360 
0x12CB3460, 36963310530656552, 231464043, 231464046, 3, 640x360 
0x12CB3460, 36963310530974912, 231464072, 231464075, 3, 640x360 
0x12CB3460, 36963310531294184, 231464102, 231464106, 4, 640x360 
0x12CB3460, 36963310531774200, 231464152, 231464155, 3, 640x360 
0x12CB3460, 36963310532092904, 231464183, 231464187, 4, 640x360 
0x12CB3460, 36963310532414312, 231464222, 231464224, 2, 640x360 
0x12CB3460, 36963310532733784, 231464252, 231464255, 3, 640x360 
0x12CB3460, 36963310533053536, 231464283, 231464286, 3, 640x360 
0x12CB3460, 36963310533373656, 231464312, 231464315, 3, 640x360 
0x12CB3460, 36963310533695920, 231464343, 231464346, 3, 640x360 
0x12CB3460, 36963310534016936, 231464382, 231464385, 3, 640x360 
0x12CB3460, 36963310534333456, 231464412, 231464415, 3, 640x360 
0x12CB3460, 36963310534655424, 231464442, 231464445, 3, 640x360 
0x12CB3460, 36963310534973712, 231464472, 231464475, 3, 640x360 
0x12CB3460, 36963310535455480, 231464522, 231464525, 3, 640x360 
0x12CB3460, 36963310535774176, 231464553, 231464556, 3, 640x360 
0x12CB3460, 36963310536094672, 231464592, 231464597, 5, 640x360 
0x12CB3460, 36963310536414224, 231464615, 231464619, 4, 640x360 
0x12CB3460, 36963310536735088, 231464651, 231464654, 3, 640x360 
0x12CB3460, 36963310537055776, 231464682, 231464685, 3, 640x360 
0x12CB3460, 36963310537375328, 231464712, 231464716, 4, 640x360 
0x12CB3460, 36963310537696136, 231464752, 231464755, 3, 640x360 
0x12CB3460, 36963310538014248, 231464782, 231464784, 2, 640x360 
0x12CB3460, 36963310538336024, 231464812, 231464815, 3, 640x360 
0x12CB3460, 36963310538656616, 231464842, 231464845, 3, 640x360 
0x12CB3460, 36963310538977040, 231464883, 231464886, 3, 640x360 
0x12CB3460, 36963310539454376, 231464922, 231464925, 3, 640x360 
0x12CB3460, 36963310539774808, 231464952, 231464958, 6, 640x360 
0x12CB3460, 36963310540094792, 231464992, 231464995, 3, 640x360 
0x12CB3460, 36963310540413312, 231465022, 231465031, 9, 640x360 
0x12CB3460, 36963310540735752, 231465052, 231465056, 4, 640x360 
0x12CB3460, 36963310541053104, 231465082, 231465085, 3, 640x360 
0x12CB3460, 36963310541373072, 231465112, 231465115, 3, 640x360 
0x12CB3460, 36963310541694296, 231465152, 231465155, 3, 640x360 
0x12CB3460, 36963310542014632, 231465182, 231465184, 2, 640x360 
0x12CB3460, 36963310542334656, 231465213, 231465216, 3, 640x360 
0x12CB3460, 36963310542656680, 231465242, 231465246, 4, 640x360 
0x12CB3460, 36963310542973344, 231465273, 231465275, 2, 640x360 
0x12CB3460, 36963310543454912, 231465321, 231465324, 3, 640x360 
0x12CB3460, 36963310543773760, 231465376, 231465380, 4, 640x360 
0x12CB3460, 36963310544095320, 231465391, 231465394, 3, 640x360 
0x12CB3460, 36963310544414440, 231465422, 231465425, 3, 640x360 
0x12CB3460, 36963310544735008, 231465452, 231465456, 4, 640x360 
0x12CB3460, 36963310545055344, 231465482, 231465485, 3, 640x360 
0x12CB3460, 36963310545374944, 231465511, 231465515, 4, 640x360 
0x12CB3460, 36963310545695912, 231465552, 231465555, 3, 640x360 
0x12CB3460, 36963310546013600, 231465582, 231465584, 2, 640x360 
0x12CB3460, 36963310546334336, 231465612, 231465617, 5, 640x360 
0x12CB3460, 36963310546653472, 231465643, 231465645, 2, 640x360 
0x12CB3460, 36963310547134256, 231465692, 231465694, 2, 640x360 
0x12CB3460, 36963310547454968, 231465722, 231465724, 2, 640x360 
0x12CB3460, 36963310547772624, 231465753, 231465756, 3, 640x360 
0x12CB3460, 36963310548093512, 231465782, 231465787, 5, 640x360 
0x12CB3460, 36963310548414400, 231465822, 231465825, 3, 640x360 
0x12CB3460, 36963310548734784, 231465872, 231465875, 3, 640x360 
0x12CB3460, 36963310549053528, 231465882, 231465884, 2, 640x360 
0x12CB3460, 36963310549373408, 231465912, 231465915, 3, 640x360 
0x12CB3460, 36963310549693272, 231465952, 231465955, 3, 640x360 
0x12CB3460, 36963310550015968, 231465981, 231465985, 4, 640x360 
0x12CB3460, 36963310550334432, 231466012, 231466015, 3, 640x360 
0x12CB3460, 36963310550656608, 231466043, 231466046, 3, 640x360 
0x12CB3460, 36963310551134816, 231466093, 231466095, 2, 640x360 
0x12CB3460, 36963310551456640, 231466122, 231466124, 2, 640x360 
0x12CB3460, 36963310551774432, 231466153, 231466156, 3, 640x360 
0x12CB3460, 36963310552093856, 231466182, 231466185, 3, 640x360 
0x12CB3460, 36963310552413856, 231466222, 231466225, 3, 640x360 
0x12CB3460, 36963310552734016, 231466252, 231466255, 3, 640x360 
0x12CB3460, 36963310553053848, 231466282, 231466287, 5, 640x360 
0x12CB3460, 36963310553374400, 231466312, 231466315, 3, 640x360 
0x12CB3460, 36963310553694024, 231466342, 231466345, 3, 640x360 
0x12CB3460, 36963310554014096, 231466383, 231466386, 3, 640x360 
0x12CB3460, 36963310554333184, 231466412, 231466415, 3, 640x360 
0x12CB3460, 36963310554816560, 231466461, 231466464, 3, 640x360 
0x12CB3460, 36963310555132792, 231466492, 231466494, 2, 640x360 
0x12CB3460, 36963310555455256, 231466521, 231466525, 4, 640x360 
0x12CB3460, 36963310555774448, 231466552, 231466556, 4, 640x360 
0x12CB3460, 36963310556095872, 231466592, 231466595, 3, 640x360 
0x12CB3460, 36963310556415512, 231466622, 231466625, 3, 640x360 
0x12CB3460, 36963310556733480, 231466651, 231466654, 3, 640x360 
0x12CB3460, 36963310557054408, 231466682, 231466685, 3, 640x360 
0x12CB3460, 36963310557375584, 231466712, 231466716, 4, 640x360 
0x12CB3460, 36963310557696488, 231466753, 231466757, 4, 640x360 
0x12CB3460, 36963310558017744, 231466783, 231466786, 3, 640x360 
0x12CB3460, 36963310558334288, 231466813, 231466816, 3, 640x360 
0x12CB3460, 36963310558813496, 231466868, 231466872, 4, 640x360 
0x12CB3460, 36963310559134280, 231466891, 231466894, 3, 640x360 
0x12CB3460, 36963310559454192, 231466922, 231466925, 3, 640x360 
0x12CB3460, 36963310559773688, 231466952, 231466955, 3, 640x360 
0x12CB3460, 36963310560095392, 231466992, 231466994, 2, 640x360 
0x12CB3460, 36963310560414664, 231467022, 231467025, 3, 640x360 
0x12CB3460, 36963310560734368, 231467052, 231467055, 3, 640x360 
0x12CB3460, 36963310561052712, 231467083, 231467086, 3, 640x360 
0x12CB3460, 36963310561374528, 231467112, 231467115, 3, 640x360 
0x12CB3460, 36963310561693576, 231467143, 231467147, 4, 640x360 
0x12CB3460, 36963310562014304, 231467182, 231467185, 3, 640x360 
0x12CB3460, 36963310562334864, 231467212, 231467215, 3, 640x360 
0x12CB3460, 36963310562812816, 231467263, 231467280, 17, 640x360 
0x12CB3460, 36963310563135144, 231467293, 231467296, 3, 640x360 
0x12CB3460, 36963310563453592, 231467322, 231467325, 3, 640x360 
0x12CB3460, 36963310563774544, 231467378, 231467383, 5, 640x360 
0x12CB3460, 36963310564093712, 231467384, 231467388, 4, 640x360 
0x12CB3460, 36963310564413408, 231467423, 231467425, 2, 640x360 
0x12CB3460, 36963310564733392, 231467451, 231467454, 3, 640x360 
0x12CB3460, 36963310565055760, 231467483, 231467486, 3, 640x360 
0x12CB3460, 36963310565375272, 231467513, 231467517, 4, 640x360 
0x12CB3460, 36963310565698128, 231467553, 231467558, 5, 640x360 
0x12CB3460, 36963310566019280, 231467585, 231467589, 4, 640x360 
0x12CB3460, 36963310566497304, 231467632, 231467635, 3, 640x360 
0x12CB3460, 36963310566814488, 231467662, 231467680, 18, 640x360 
0x12CB3460, 36963310567133560, 231467691, 231467694, 3, 640x360 
0x12CB3460, 36963310567456792, 231467724, 231467727, 3, 640x360 
0x12CB3460, 36963310567774536, 231467753, 231467755, 2, 640x360 
0x12CB3460, 36963310568094752, 231467784, 231467787, 3, 640x360 
0x12CB3460, 36963310568414424, 231467821, 231467824, 3, 640x360 
0x12CB3460, 36963310568734184, 231467877, 231467881, 4, 640x360 
0x12CB3460, 36963310569054648, 231467892, 231467895, 3, 640x360 
0x12CB3460, 36963310569372768, 231467913, 231467915, 2, 640x360 
0x12CB3460, 36963310569694368, 231467942, 231467945, 3, 640x360 
0x12CB3460, 36963310570015616, 231467981, 231467985, 4, 640x360 
0x12CB3460, 36963310570494520, 231468033, 231468036, 3, 640x360 
0x12CB3460, 36963310570815704, 231468062, 231468065, 3, 640x360 
0x12CB3460, 36963310571132944, 231468091, 231468094, 3, 640x360 
0x12CB3460, 36963310571454104, 231468122, 231468124, 2, 640x360 
0x12CB3460, 36963310571773968, 231468151, 231468155, 4, 640x360 
0x12CB3460, 36963310572094472, 231468192, 231468195, 3, 640x360 
0x12CB3460, 36963310572413304, 231468222, 231468225, 3, 640x360 
0x12CB3460, 36963310572733592, 231468252, 231468255, 3, 640x360 
0x12CB3460, 36963310573054216, 231468281, 231468284, 3, 640x360 
0x12CB3460, 36963310573374840, 231468312, 231468315, 3, 640x360 
0x12CB3460, 36963310573695088, 231468377, 231468380, 3, 640x360 
0x12CB3460, 36963310574496136, 231468433, 231468436, 3, 640x360 
0x12CB3460, 36963310574813888, 231468462, 231468465, 3, 640x360 
0x12CB3460, 36963310575133728, 231468492, 231468495, 3, 640x360 
0x12CB3460, 36963310575453224, 231468522, 231468524, 2, 640x360 
0x12CB3460, 36963310575775344, 231468552, 231468555, 3, 640x360 
0x12CB3460, 36963310576095784, 231468583, 231468586, 3, 640x360 
0x12CB3460, 36963310576415736, 231468622, 231468627, 5, 640x360 
0x12CB3460, 36963310576734048, 231468651, 231468654, 3, 640x360 
0x12CB3460, 36963310577055088, 231468683, 231468686, 3, 640x360 
0x12CB3460, 36963310577374160, 231468712, 231468715, 3, 640x360 
0x12CB3460, 36963310577694744, 231468753, 231468756, 3, 640x360 
0x12CB3460, 36963310578175040, 231468792, 231468796, 4, 640x360 
0x12CB3460, 36963310578494912, 231468832, 231468835, 3, 640x360 
0x12CB3460, 36963310578814384, 231468875, 231468878, 3, 640x360 
0x12CB3460, 36963310579132632, 231468892, 231468895, 3, 640x360 
0x12CB3460, 36963310579453456, 231468922, 231468924, 2, 640x360 
0x12CB3460, 36963310579774544, 231468952, 231468955, 3, 640x360 
0x12CB3460, 36963310580093616, 231468992, 231468995, 3, 640x360 
0x12CB3460, 36963310580414816, 231469022, 231469024, 2, 640x360 
0x12CB3460, 36963310580734712, 231469053, 231469056, 3, 640x360 
0x12CB3460, 36963310581053728, 231469082, 231469085, 3, 640x360 
0x12CB3460, 36963310581373536, 231469112, 231469115, 3, 640x360 
0x12CB3460, 36963310581693408, 231469142, 231469145, 3, 640x360 
0x12CB3460, 36963310582175136, 231469191, 231469195, 4, 640x360 
0x12CB3460, 36963310582496224, 231469232, 231469235, 3, 640x360 
0x12CB3460, 36963310582813992, 231469262, 231469265, 3, 640x360 
0x12CB3460, 36963310583133176, 231469292, 231469295, 3, 640x360 
0x12CB3460, 36963310583454560, 231469321, 231469324, 3, 640x360 
0x12CB3460, 36963310583774728, 231469352, 231469355, 3, 640x360 
0x12CB3460, 36963310584094120, 231469392, 231469395, 3, 640x360 
0x12CB3460, 36963310584414336, 231469422, 231469424, 2, 640x360 
0x12CB3460, 36963310584736712, 231469453, 231469456, 3, 640x360 
0x12CB3460, 36963310585053752, 231469482, 231469485, 3, 640x360 
0x12CB3460, 36963310585374536, 231469511, 231469515, 4, 640x360 
0x12CB3460, 36963310585695656, 231469552, 231469555, 3, 640x360 
0x12CB3460, 36963310586177096, 231469592, 231469596, 4, 640x360 
0x12CB3460, 36963310586497792, 231469624, 231469628, 4, 640x360 
0x12CB3460, 36963310586814488, 231469662, 231469665, 3, 640x360 
0x12CB3460, 36963310587135152, 231469692, 231469695, 3, 640x360 
0x12CB3460, 36963310587453872, 231469722, 231469725, 3, 640x360 
0x12CB3460, 36963310587773736, 231469752, 231469755, 3, 640x360 
0x12CB3460, 36963310588094160, 231469783, 231469786, 3, 640x360 
0x12CB3460, 36963310588412696, 231469821, 231469824, 3, 640x360 
0x12CB3460, 36963310588733312, 231469870, 231469873, 3, 640x360 
0x12CB3460, 36963310589054112, 231469882, 231469885, 3, 640x360 
0x12CB3460, 36963310589374392, 231469913, 231469915, 2, 640x360 
0x12CB3460, 36963310589854808, 231469962, 231469965, 3, 640x360 
0x12CB3460, 36963310590175136, 231469993, 231469996, 3, 640x360 
0x12CB3460, 36963310590495032, 231470032, 231470035, 3, 640x360 
0x12CB3460, 36963310590814336, 231470062, 231470065, 3, 640x360 
0x12CB3460, 36963310591133000, 231470091, 231470094, 3, 640x360 
0x12CB3460, 36963310591454272, 231470122, 231470127, 5, 640x360 
0x12CB3460, 36963310591773840, 231470151, 231470154, 3, 640x360 
0x12CB3460, 36963310592093560, 231470182, 231470185, 3, 640x360 
0x12CB3460, 36963310592412776, 231470222, 231470225, 3, 640x360 
0x12CB3460, 36963310592732680, 231470252, 231470254, 2, 640x360 
0x12CB3460, 36963310593055392, 231470282, 231470285, 3, 640x360 
0x12CB3460, 36963310593375176, 231470312, 231470315, 3, 640x360 
0x12CB3460, 36963310593858216, 231470380, 231470383, 3, 640x360 
0x12CB3460, 36963310594173632, 231470392, 231470395, 3, 640x360 
0x12CB3460, 36963310594494304, 231470432, 231470435, 3, 640x360 
0x12CB3460, 36963310594814304, 231470462, 231470464, 2, 640x360 
0x12CB3460, 36963310595134616, 231470492, 231470495, 3, 640x360 
0x12CB3460, 36963310595455040, 231470522, 231470524, 2, 640x360 
0x12CB3460, 36963310595774400, 231470553, 231470557, 4, 640x360 
0x12CB3460, 36963310596094176, 231470584, 231470588, 4, 640x360 
0x12CB3460, 36963310596413336, 231470622, 231470627, 5, 640x360 
0x12CB3460, 36963310596734184, 231470651, 231470654, 3, 640x360 
0x12CB3460, 36963310597053792, 231470682, 231470685, 3, 640x360 
0x12CB3460, 36963310597533616, 231470732, 231470735, 3, 640x360 
0x12CB3460, 36963310597854112, 231470761, 231470764, 3, 640x360 
0x12CB3460, 36963310598174648, 231470793, 231470796, 3, 640x360 
0x12CB3460, 36963310598493344, 231470823, 231470827, 4, 640x360 
0x12CB3460, 36963310598812808, 231470881, 231470884, 3, 640x360 
0x12CB3460, 36963310599133184, 231470892, 231470895, 3, 640x360 
0x12CB3460, 36963310599453528, 231470922, 231470925, 3, 640x360 
0x12CB3460, 36963310599772744, 231470952, 231470955, 3, 640x360 
0x12CB3460, 36963310600094600, 231470983, 231470987, 4, 640x360 
0x12CB3460, 36963310600413384, 231471021, 231471024, 3, 640x360 
0x12CB3460, 36963310600735848, 231471052, 231471055, 3, 640x360 
0x12CB3460, 36963310601052928, 231471082, 231471085, 3, 640x360 
0x12CB3460, 36963310601536480, 231471132, 231471135, 3, 640x360 
0x12CB3460, 36963310601855200, 231471161, 231471180, 19, 640x360 
0x12CB3460, 36963310602174816, 231471191, 231471195, 4, 640x360 
0x12CB3460, 36963310602493416, 231471232, 231471237, 5, 640x360 
0x12CB3460, 36963310602813240, 231471262, 231471264, 2, 640x360 
0x12CB3460, 36963310603134360, 231471292, 231471295, 3, 640x360 
0x12CB3460, 36963310603453432, 231471322, 231471324, 2, 640x360 
0x12CB3460, 36963310603775216, 231471377, 231471383, 6, 640x360 
0x12CB3460, 36963310604093880, 231471383, 231471387, 4, 640x360 
0x12CB3460, 36963310604414824, 231471422, 231471425, 3, 640x360 
0x12CB3460, 36963310604733608, 231471452, 231471455, 3, 640x360 
0x12CB3460, 36963310605055264, 231471482, 231471485, 3, 640x360 
0x12CB3460, 36963310605533416, 231471532, 231471534, 2, 640x360 
0x12CB3460, 36963310605853168, 231471562, 231471565, 3, 640x360 
0x12CB3460, 36963310606174416, 231471592, 231471595, 3, 640x360 
0x12CB3460, 36963310606495240, 231471632, 231471635, 3, 640x360 
0x12CB3460, 36963310606813200, 231471662, 231471664, 2, 640x360 
0x12CB3460, 36963310607135496, 231471692, 231471696, 4, 640x360 
0x12CB3460, 36963310607454992, 231471722, 231471725, 3, 640x360 
0x12CB3460, 36963310607772704, 231471753, 231471756, 3, 640x360 
0x12CB3460, 36963310608094912, 231471783, 231471787, 4, 640x360 
0x12CB3460, 36963310608413760, 231471822, 231471825, 3, 640x360 
0x12CB3460, 36963310608735144, 231471873, 231471877, 4, 640x360 
0x12CB3460, 36963310609214400, 231471901, 231471904, 3, 640x360 
0x12CB3460, 36963310609532672, 231471932, 231471935, 3, 640x360 
0x12CB3460, 36963310609853824, 231471962, 231471965, 3, 640x360 
0x12CB3460, 36963310610172776, 231471992, 231471995, 3, 640x360 
0x12CB3460, 36963310610493952, 231472032, 231472035, 3, 640x360 
0x12CB3460, 36963310610813824, 231472062, 231472064, 2, 640x360 
0x12CB3460, 36963310611134296, 231472093, 231472096, 3, 640x360 
0x12CB3460, 36963310611453224, 231472122, 231472126, 4, 640x360 
0x12CB3460, 36963310611772816, 231472153, 231472156, 3, 640x360 
0x12CB3460, 36963310612094120, 231472183, 231472201, 18, 640x360 
0x12CB3460, 36963310612414216, 231472222, 231472225, 3, 640x360 
0x12CB3460, 36963310612732928, 231472252, 231472255, 3, 640x360 
0x12CB3460, 36963310613212864, 231472302, 231472305, 3, 640x360 
0x12CB3460, 36963310613534136, 231472333, 231472335, 2, 640x360 
0x12CB3460, 36963310613855912, 231472377, 231472381, 4, 640x360 
0x12CB3460, 36963310614173040, 231472391, 231472395, 4, 640x360 
0x12CB3460, 36963310614493912, 231472422, 231472425, 3, 640x360 
0x12CB3460, 36963310614813512, 231472462, 231472465, 3, 640x360 
0x12CB3460, 36963310615134048, 231472491, 231472494, 3, 640x360 
0x12CB3460, 36963310615454680, 231472522, 231472525, 3, 640x360 
0x12CB3460, 36963310615774184, 231472552, 231472556, 4, 640x360 
0x12CB3460, 36963310616094912, 231472593, 231472597, 4, 640x360 
0x12CB3460, 36963310616416736, 231472622, 231472625, 3, 640x360 
0x12CB3460, 36963310616735872, 231472652, 231472655, 3, 640x360 
0x12CB3460, 36963310617212816, 231472702, 231472705, 3, 640x360 
0x12CB3460, 36963310617533984, 231472733, 231472737, 4, 640x360 
0x12CB3460, 36963310617854312, 231472762, 231472765, 3, 640x360 
0x12CB3460, 36963310618173184, 231472792, 231472795, 3, 640x360 
0x12CB3460, 36963310618494752, 231472823, 231472827, 4, 640x360 
0x12CB3460, 36963310618814336, 231472876, 231472878, 2, 640x360 
0x12CB3460, 36963310619132416, 231472891, 231472894, 3, 640x360 
0x12CB3460, 36963310619453784, 231472922, 231472925, 3, 640x360 
0x12CB3460, 36963310619772624, 231472951, 231472955, 4, 640x360 
0x12CB3460, 36963310620093664, 231472992, 231472995, 3, 640x360 
0x12CB3460, 36963310620414184, 231473022, 231473025, 3, 640x360 
0x12CB3460, 36963310620892536, 231473072, 231473075, 3, 640x360 
0x12CB3460, 36963310621212168, 231473101, 231473104, 3, 640x360 
0x12CB3460, 36963310621532328, 231473133, 231473137, 4, 640x360 
0x12CB3460, 36963310621853464, 231473162, 231473165, 3, 640x360 
0x12CB3460, 36963310622174792, 231473191, 231473195, 4, 640x360 
0x12CB3460, 36963310622496032, 231473232, 231473235, 3, 640x360 
0x12CB3460, 36963310622812944, 231473262, 231473265, 3, 640x360 
0x12CB3460, 36963310623134400, 231473291, 231473294, 3, 640x360 
0x12CB3460, 36963310623454160, 231473322, 231473331, 9, 640x360 
0x12CB3460, 36963310623774176, 231473376, 231473379, 3, 640x360 
0x12CB3460, 36963310624093968, 231473383, 231473387, 4, 640x360 
0x12CB3460, 36963310624414216, 231473422, 231473425, 3, 640x360 
0x12CB3460, 36963310624894784, 231473464, 231473467, 3, 640x360 
0x12CB3460, 36963310625212760, 231473502, 231473505, 3, 640x360 
0x12CB3460, 36963310625534720, 231473532, 231473535, 3, 640x360 
0x12CB3460, 36963310625855936, 231473563, 231473566, 3, 640x360 
0x12CB3460, 36963310626176632, 231473593, 231473598, 5, 640x360 
0x12CB3460, 36963310626492496, 231473622, 231473626, 4, 640x360 
0x12CB3460, 36963310626813128, 231473662, 231473665, 3, 640x360 
0x12CB3460, 36963310627135336, 231473692, 231473695, 3, 640x360 
0x12CB3460, 36963310627455016, 231473722, 231473725, 3, 640x360 
0x12CB3460, 36963310627774104, 231473752, 231473755, 3, 640x360 
0x12CB3460, 36963310628093440, 231473783, 231473786, 3, 640x360 
0x12CB3460, 36963310628574320, 231473833, 231473835, 2, 640x360 
0x12CB3460, 36963310628896424, 231473876, 231473883, 7, 640x360 
0x12CB3460, 36963310629212528, 231473902, 231473904, 2, 640x360 
0x12CB3460, 36963310629532728, 231473932, 231473935, 3, 640x360 
0x12CB3460, 36963310629854192, 231473962, 231473965, 3, 640x360 
0x12CB3460, 36963310630174720, 231473991, 231473995, 4, 640x360 
0x12CB3460, 36963310630495736, 231474032, 231474035, 3, 640x360 
0x12CB3460, 36963310630814944, 231474061, 231474064, 3, 640x360 
0x12CB3460, 36963310631132616, 231474092, 231474095, 3, 640x360 
0x12CB3460, 36963310631453136, 231474121, 231474124, 3, 640x360 
0x12CB3460, 36963310631773440, 231474152, 231474154, 2, 640x360 
0x12CB3460, 36963310632093912, 231474182, 231474186, 4, 640x360 
0x12CB3460, 36963310632573752, 231474232, 231474236, 4, 640x360 
0x12CB3460, 36963310632893656, 231474263, 231474267, 4, 640x360 
0x12CB3460, 36963310633215160, 231474301, 231474304, 3, 640x360 
0x12CB3460, 36963310633532800, 231474332, 231474335, 3, 640x360 
0x12CB3460, 36963310633854216, 231474376, 231474378, 2, 640x360 
0x12CB3460, 36963310634173608, 231474392, 231474395, 3, 640x360 
0x12CB3460, 36963310634494120, 231474432, 231474435, 3, 640x360 
0x12CB3460, 36963310634813992, 231474462, 231474465, 3, 640x360 
0x12CB3460, 36963310635133696, 231474492, 231474495, 3, 640x360 
0x12CB3460, 36963310635454480, 231474522, 231474531, 9, 640x360 
0x12CB3460, 36963310635775344, 231474552, 231474555, 3, 640x360 
0x12CB3460, 36963310636095448, 231474593, 231474596, 3, 640x360 
0x12CB3460, 36963310636574464, 231474632, 231474635, 3, 640x360 
0x12CB3460, 36963310636895176, 231474672, 231474675, 3, 640x360 
0x12CB3460, 36963310637215368, 231474702, 231474705, 3, 640x360 
0x12CB3460, 36963310637537464, 231474733, 231474737, 4, 640x360 
0x12CB3460, 36963310637852320, 231474761, 231474764, 3, 640x360 
0x12CB3460, 36963310638174408, 231474793, 231474796, 3, 640x360 
0x12CB3460, 36963310638493576, 231474832, 231474835, 3, 640x360 
0x12CB3460, 36963310638814152, 231474876, 231474879, 3, 640x360 
0x12CB3460, 36963310639132736, 231474892, 231474895, 3, 640x360 
0x12CB3460, 36963310639452648, 231474921, 231474924, 3, 640x360 
0x12CB3460, 36963310639774072, 231474952, 231474955, 3, 640x360 
0x12CB3460, 36963310640253336, 231475001, 231475004, 3, 640x360 
0x12CB3460, 36963310640574176, 231475033, 231475035, 2, 640x360 
0x12CB3460, 36963310640893288, 231475063, 231475067, 4, 640x360 
0x12CB3460, 36963310641214992, 231475102, 231475106, 4, 640x360 
0x12CB3460, 36963310641532480, 231475131, 231475134, 3, 640x360 
0x12CB3460, 36963310641854792, 231475162, 231475165, 3, 640x360 
0x12CB3460, 36963310642172904, 231475192, 231475198, 6, 640x360 
0x12CB3460, 36963310642492088, 231475223, 231475227, 4, 640x360 
0x12CB3460, 36963310642813680, 231475263, 231475266, 3, 640x360 
0x12CB3460, 36963310643134648, 231475292, 231475295, 3, 640x360 
0x12CB3460, 36963310643455040, 231475322, 231475325, 3, 640x360 
0x12CB3460, 36963310643775960, 231475354, 231475358, 4, 640x360 
0x12CB3460, 36963310644254040, 231475402, 231475405, 3, 640x360 
0x12CB3460, 36963310644573872, 231475433, 231475435, 2, 640x360 
0x12CB3460, 36963310644892768, 231475472, 231475475, 3, 640x360 
0x12CB3460, 36963310645214584, 231475495, 231475499, 4, 640x360 
0x12CB3460, 36963310645534064, 231475532, 231475535, 3, 640x360 
0x12CB3460, 36963310645854680, 231475563, 231475566, 3, 640x360 
0x12CB3460, 36963310646175904, 231475593, 231475597, 4, 640x360 
0x12CB3460, 36963310646492536, 231475622, 231475625, 3, 640x360 
0x12CB3460, 36963310646812792, 231475662, 231475665, 3, 640x360 
0x12CB3460, 36963310647133824, 231475691, 231475694, 3, 640x360 
0x12CB3460, 36963310647453568, 231475722, 231475725, 3, 640x360 
0x12CB3460, 36963310647773344, 231475752, 231475755, 3, 640x360 
0x12CB3460, 36963310648253920, 231475803, 231475806, 3, 640x360 
0x12CB3460, 36963310648572248, 231475832, 231475835, 3, 640x360 
0x12CB3460, 36963310648895344, 231475874, 231475881, 7, 640x360 
0x12CB3460, 36963310649213240, 231475901, 231475904, 3, 640x360 
0x12CB3460, 36963310649534296, 231475932, 231475934, 2, 640x360 
0x12CB3460, 36963310649852832, 231475961, 231475964, 3, 640x360 
0x12CB3460, 36963310650174720, 231475992, 231475996, 4, 640x360 
0x12CB3460, 36963310650493064, 231476032, 231476035, 3, 640x360 
0x12CB3460, 36963310650814744, 231476061, 231476064, 3, 640x360 
0x12CB3460, 36963310651133712, 231476092, 231476095, 3, 640x360 
0x12CB3460, 36963310651453912, 231476122, 231476125, 3, 640x360 
0x12CB3460, 36963310651933600, 231476172, 231476175, 3, 640x360 
0x12CB3460, 36963310652253360, 231476202, 231476204, 2, 640x360 
0x12CB3460, 36963310652573744, 231476233, 231476236, 3, 640x360 
0x12CB3460, 36963310652893816, 231476263, 231476266, 3, 640x360 
0x12CB3460, 36963310653214536, 231476301, 231476304, 3, 640x360 
0x12CB3460, 36963310653533144, 231476332, 231476335, 3, 640x360 
0x12CB3460, 36963310653858032, 231476370, 231476373, 3, 640x360 
0x12CB3460, 36963310654172032, 231476392, 231476395, 3, 640x360 
0x12CB3460, 36963310654493624, 231476423, 231476426, 3, 640x360 
0x12CB3460, 36963310654813184, 231476462, 231476465, 3, 640x360 
0x12CB3460, 36963310655135584, 231476492, 231476495, 3, 640x360 
0x12CB3460, 36963310655453784, 231476522, 231476531, 9, 640x360 
0x12CB3460, 36963310655932336, 231476572, 231476575, 3, 640x360 
0x12CB3460, 36963310656253936, 231476603, 231476605, 2, 640x360 
0x12CB3460, 36963310656573664, 231476631, 231476635, 4, 640x360 
0x12CB3460, 36963310656894184, 231476663, 231476666, 3, 640x360 
0x12CB3460, 36963310657213320, 231476702, 231476706, 4, 640x360 
0x12CB3460, 36963310657533440, 231476731, 231476734, 3, 640x360 
0x12CB3460, 36963310657853480, 231476763, 231476766, 3, 640x360 
0x12CB3460, 36963310658173224, 231476792, 231476795, 3, 640x360 
0x12CB3460, 36963310658494280, 231476832, 231476835, 3, 640x360 
0x12CB3460, 36963310658813200, 231476882, 231476886, 4, 640x360 
0x12CB3460, 36963310659133256, 231476892, 231476895, 3, 640x360 
0x12CB3460, 36963310659453808, 231476922, 231476924, 2, 640x360 
0x12CB3460, 36963310659932216, 231476972, 231476975, 3, 640x360 
0x12CB3460, 36963310660252216, 231477001, 231477004, 3, 640x360 
0x12CB3460, 36963310660572416, 231477032, 231477035, 3, 640x360 
0x12CB3460, 36963310660892072, 231477072, 231477075, 3, 640x360 
0x12CB3460, 36963310661212800, 231477101, 231477104, 3, 640x360 
0x12CB3460, 36963310661534248, 231477133, 231477135, 2, 640x360 
0x12CB3460, 36963310661856112, 231477162, 231477164, 2, 640x360 
0x12CB3460, 36963310662173520, 231477192, 231477195, 3, 640x360 
0x12CB3460, 36963310662493248, 231477232, 231477235, 3, 640x360 
0x12CB3460, 36963310662812848, 231477262, 231477265, 3, 640x360 
0x12CB3460, 36963310663134560, 231477292, 231477295, 3, 640x360 
0x12CB3460, 36963310663613384, 231477341, 231477344, 3, 640x360 
0x12CB3460, 36963310663932344, 231477374, 231477378, 4, 640x360 
0x12CB3460, 36963310664253592, 231477401, 231477404, 3, 640x360 
0x12CB3460, 36963310664574208, 231477433, 231477436, 3, 640x360 
0x12CB3460, 36963310664894504, 231477463, 231477466, 3, 640x360 
0x12CB3460, 36963310665212704, 231477501, 231477504, 3, 640x360 
0x12CB3460, 36963310665532960, 231477532, 231477534, 2, 640x360 
0x12CB3460, 36963310665854864, 231477562, 231477565, 3, 640x360 
0x12CB3460, 36963310666173528, 231477592, 231477595, 3, 640x360 
0x12CB3460, 36963310666494320, 231477624, 231477627, 3, 640x360 
0x12CB3460, 36963310666814344, 231477661, 231477665, 4, 640x360 
0x12CB3460, 36963310667134280, 231477692, 231477695, 3, 640x360 
0x12CB3460, 36963310667614616, 231477735, 231477739, 4, 640x360 
0x12CB3460, 36963310667933600, 231477772, 231477782, 10, 640x360 
0x12CB3460, 36963310668255136, 231477802, 231477804, 2, 640x360 
0x12CB3460, 36963310668574552, 231477833, 231477836, 3, 640x360 
0x12CB3460, 36963310668893656, 231477876, 231477879, 3, 640x360 
0x12CB3460, 36963310669213024, 231477902, 231477904, 2, 640x360 
0x12CB3460, 36963310669534248, 231477933, 231477935, 2, 640x360 
0x12CB3460, 36963310669853224, 231477961, 231477964, 3, 640x360 
0x12CB3460, 36963310670177200, 231477992, 231477996, 4, 640x360 
0x12CB3460, 36963310670494880, 231478033, 231478036, 3, 640x360 
0x12CB3460, 36963310670813800, 231478062, 231478065, 3, 640x360 
0x12CB3460, 36963310671293760, 231478102, 231478122, 20, 640x360 
0x12CB3460, 36963310671612448, 231478142, 231478146, 4, 640x360 
0x12CB3460, 36963310671931904, 231478172, 231478175, 3, 640x360 
0x12CB3460, 36963310672252192, 231478202, 231478205, 3, 640x360 
0x12CB3460, 36963310672572488, 231478232, 231478235, 3, 640x360 
0x12CB3460, 36963310672893320, 231478263, 231478266, 3, 640x360 
0x12CB3460, 36963310673212496, 231478302, 231478305, 3, 640x360 
0x12CB3460, 36963310673532208, 231478332, 231478334, 2, 640x360 
0x12CB3460, 36963310673857648, 231478382, 231478385, 3, 640x360 
0x12CB3460, 36963310674172048, 231478392, 231478395, 3, 640x360 
0x12CB3460, 36963310674493640, 231478432, 231478436, 4, 640x360 
0x12CB3460, 36963310674814568, 231478462, 231478464, 2, 640x360 
0x12CB3460, 36963310675294336, 231478503, 231478507, 4, 640x360 
0x12CB3460, 36963310675613264, 231478541, 231478544, 3, 640x360 
0x12CB3460, 36963310675936224, 231478572, 231478582, 10, 640x360 
0x12CB3460, 36963310676255640, 231478603, 231478605, 2, 640x360 
0x12CB3460, 36963310676574976, 231478632, 231478636, 4, 640x360 
0x12CB3460, 36963310676894048, 231478672, 231478675, 3, 640x360 
0x12CB3460, 36963310677215336, 231478702, 231478706, 4, 640x360 
0x12CB3460, 36963310677533744, 231478733, 231478736, 3, 640x360 
0x12CB3460, 36963310677857384, 231478763, 231478765, 2, 640x360 
0x12CB3460, 36963310678173928, 231478793, 231478796, 3, 640x360 
0x12CB3460, 36963310678493816, 231478832, 231478835, 3, 640x360 
0x12CB3460, 36963310678814920, 231478875, 231478878, 3, 640x360 
0x12CB3460, 36963310679293112, 231478902, 231478906, 4, 640x360 
0x12CB3460, 36963310679613144, 231478942, 231478945, 3, 640x360 
0x12CB3460, 36963310679933912, 231478972, 231478975, 3, 640x360 
0x12CB3460, 36963310680253520, 231479002, 231479006, 4, 640x360 
0x12CB3460, 36963310680572416, 231479033, 231479035, 2, 640x360 
0x12CB3460, 36963310680892200, 231479062, 231479065, 3, 640x360 
0x12CB3460, 36963310681214008, 231479102, 231479104, 2, 640x360 
0x12CB3460, 36963310681533824, 231479132, 231479135, 3, 640x360 
0x12CB3460, 36963310681855232, 231479162, 231479164, 2, 640x360 
0x12CB3460, 36963310682175192, 231479192, 231479196, 4, 640x360 
0x12CB3460, 36963310682493472, 231479232, 231479235, 3, 640x360 
0x12CB3460, 36963310682973432, 231479272, 231479274, 2, 640x360 
0x12CB3460, 36963310683294344, 231479312, 231479314, 2, 640x360 
0x12CB3460, 36963310683612464, 231479341, 231479344, 3, 640x360 
0x12CB3460, 36963310683934096, 231479374, 231479377, 3, 640x360 
0x12CB3460, 36963310684251920, 231479402, 231479404, 2, 640x360 
0x12CB3460, 36963310684572464, 231479433, 231479435, 2, 640x360 
0x12CB3460, 36963310684893632, 231479473, 231479475, 2, 640x360 
0x12CB3460, 36963310685212656, 231479502, 231479504, 2, 640x360 
0x12CB3460, 36963310685534544, 231479532, 231479535, 3, 640x360 
0x12CB3460, 36963310685854184, 231479563, 231479565, 2, 640x360 
0x12CB3460, 36963310686173760, 231479592, 231479595, 3, 640x360 
0x12CB3460, 36963310686494432, 231479632, 231479635, 3, 640x360 
0x12CB3460, 36963310686972408, 231479671, 231479675, 4, 640x360 
0x12CB3460, 36963310687295736, 231479712, 231479715, 3, 640x360 
0x12CB3460, 36963310687614080, 231479741, 231479744, 3, 640x360 
0x12CB3460, 36963310687933568, 231479772, 231479775, 3, 640x360 
0x12CB3460, 36963310688254000, 231479802, 231479805, 3, 640x360 
0x12CB3460, 36963310688573944, 231479832, 231479835, 3, 640x360 
0x12CB3460, 36963310688894224, 231479866, 231479870, 4, 640x360 
0x12CB3460, 36963310689212464, 231479901, 231479906, 5, 640x360 
0x12CB3460, 36963310689533328, 231479932, 231479935, 3, 640x360 
0x12CB3460, 36963310689853688, 231479962, 231479965, 3, 640x360 
0x12CB3460, 36963310690174576, 231479992, 231479995, 3, 640x360 
0x12CB3460, 36963310690495784, 231480033, 231480037, 4, 640x360 
0x12CB3460, 36963310690973424, 231480071, 231480074, 3, 640x360 
0x12CB3460, 36963310691293064, 231480103, 231480107, 4, 640x360 
0x12CB3460, 36963310691615632, 231480142, 231480144, 2, 640x360 
0x12CB3460, 36963310691932840, 231480171, 231480174, 3, 640x360 
0x12CB3460, 36963310692251904, 231480202, 231480205, 3, 640x360 
0x12CB3460, 36963310692572568, 231480231, 231480250, 19, 640x360 
0x12CB3460, 36963310692893472, 231480263, 231480267, 4, 640x360 
0x12CB3460, 36963310693213680, 231480303, 231480305, 2, 640x360 
0x12CB3460, 36963310693532416, 231480332, 231480334, 2, 640x360 
0x12CB3460, 36963310693854712, 231480371, 231480374, 3, 640x360 
0x12CB3460, 36963310694172968, 231480392, 231480394, 2, 640x360 
0x12CB3460, 36963310694652944, 231480442, 231480445, 3, 640x360 
0x12CB3460, 36963310694971912, 231480471, 231480475, 4, 640x360 
0x12CB3460, 36963310695292920, 231480502, 231480506, 4, 640x360 
0x12CB3460, 36963310695613440, 231480542, 231480545, 3, 640x360 
0x12CB3460, 36963310695934152, 231480571, 231480574, 3, 640x360 
0x12CB3460, 36963310696252608, 231480602, 231480605, 3, 640x360 
0x12CB3460, 36963310696572824, 231480632, 231480635, 3, 640x360 
0x12CB3460, 36963310696893664, 231480672, 231480674, 2, 640x360 
0x12CB3460, 36963310697213752, 231480702, 231480705, 3, 640x360 
0x12CB3460, 36963310697535448, 231480732, 231480735, 3, 640x360 
0x12CB3460, 36963310697854136, 231480762, 231480779, 17, 640x360 
0x12CB3460, 36963310698173784, 231480793, 231480806, 13, 640x360 
0x12CB3460, 36963310698651928, 231480842, 231480845, 3, 640x360 
0x12CB3460, 36963310698973216, 231480884, 231480888, 4, 640x360 
0x12CB3460, 36963310699293296, 231480902, 231480906, 4, 640x360 
0x12CB3460, 36963310699613984, 231480942, 231480945, 3, 640x360 
0x12CB3460, 36963310699934400, 231480972, 231480974, 2, 640x360 
0x12CB3460, 36963310700256304, 231481002, 231481006, 4, 640x360 
0x12CB3460, 36963310700573976, 231481031, 231481035, 4, 640x360 
0x12CB3460, 36963310700893112, 231481063, 231481067, 4, 640x360 
0x12CB3460, 36963310701212328, 231481102, 231481106, 4, 640x360 
0x12CB3460, 36963310701533168, 231481131, 231481134, 3, 640x360 
0x12CB3460, 36963310701854728, 231481162, 231481164, 2, 640x360 
0x12CB3460, 36963310702174232, 231481191, 231481196, 5, 640x360 
0x12CB3460, 36963310702653240, 231481241, 231481244, 3, 640x360 
0x12CB3460, 36963310702971976, 231481272, 231481275, 3, 640x360 
0x12CB3460, 36963310703296120, 231481312, 231481315, 3, 640x360 
0x12CB3460, 36963310703613264, 231481342, 231481345, 3, 640x360 
0x12CB3460, 36963310703937840, 231481388, 231481391, 3, 640x360 
0x12CB3460, 36963310704252048, 231481402, 231481404, 2, 640x360 
0x12CB3460, 36963310704573168, 231481433, 231481436, 3, 640x360 
0x12CB3460, 36963310704893072, 231481462, 231481466, 4, 640x360 
0x12CB3460, 36963310705212688, 231481502, 231481505, 3, 640x360 
0x12CB3460, 36963310705533232, 231481532, 231481535, 3, 640x360 
0x12CB3460, 36963310705854472, 231481562, 231481565, 3, 640x360 
0x12CB3460, 36963310706335312, 231481611, 231481614, 3, 640x360 
0x12CB3460, 36963310706652552, 231481641, 231481656, 15, 640x360 
0x12CB3460, 36963310706973720, 231481672, 231481675, 3, 640x360 
0x12CB3460, 36963310707292768, 231481712, 231481714, 2, 640x360 
0x12CB3460, 36963310707614144, 231481741, 231481744, 3, 640x360 
0x12CB3460, 36963310707933400, 231481772, 231481774, 2, 640x360 
0x12CB3460, 36963310708253776, 231481802, 231481805, 3, 640x360 
0x12CB3460, 36963310708572776, 231481833, 231481836, 3, 640x360 
0x12CB3460, 36963310708894440, 231481875, 231481879, 4, 640x360 
0x12CB3460, 36963310709212320, 231481901, 231481904, 3, 640x360 
0x12CB3460, 36963310709533144, 231481932, 231481950, 18, 640x360 
0x12CB3460, 36963310709853064, 231481962, 231481965, 3, 640x360 
0x12CB3460, 36963310710331248, 231482011, 231482014, 3, 640x360 
0x12CB3460, 36963310710653504, 231482041, 231482056, 15, 640x360 
0x12CB3460, 36963310710971736, 231482071, 231482074, 3, 640x360 
0x12CB3460, 36963310711292280, 231482113, 231482116, 3, 640x360 
0x12CB3460, 36963310711612320, 231482142, 231482145, 3, 640x360 
0x12CB3460, 36963310711933312, 231482172, 231482174, 2, 640x360 
0x12CB3460, 36963310712254368, 231482202, 231482205, 3, 640x360 
0x12CB3460, 36963310712571944, 231482233, 231482236, 3, 640x360 
0x12CB3460, 36963310712892896, 231482262, 231482266, 4, 640x360 
0x12CB3460, 36963310713212808, 231482301, 231482304, 3, 640x360 
0x12CB3460, 36963310713532936, 231482332, 231482335, 3, 640x360 
0x12CB3460, 36963310714011456, 231482382, 231482384, 2, 640x360 
0x12CB3460, 36963310714334304, 231482411, 231482414, 3, 640x360 
0x12CB3460, 36963310714653928, 231482442, 231482445, 3, 640x360 
0x12CB3460, 36963310714972360, 231482472, 231482475, 3, 640x360 
0x12CB3460, 36963310715296152, 231482503, 231482509, 6, 640x360 
0x12CB3460, 36963310715613736, 231482541, 231482544, 3, 640x360 
0x12CB3460, 36963310715933768, 231482572, 231482575, 3, 640x360 
0x12CB3460, 36963310716252992, 231482602, 231482604, 2, 640x360 
0x12CB3460, 36963310716573488, 231482633, 231482636, 3, 640x360 
0x12CB3460, 36963310716894416, 231482672, 231482675, 3, 640x360 
0x12CB3460, 36963310717214880, 231482702, 231482705, 3, 640x360 
0x12CB3460, 36963310717533752, 231482732, 231482735, 3, 640x360 
0x12CB3460, 36963310718011880, 231482782, 231482785, 3, 640x360 
0x12CB3460, 36963310718331696, 231482811, 231482814, 3, 640x360 
0x12CB3460, 36963310718652200, 231482842, 231482845, 3, 640x360 
0x12CB3460, 36963310718973304, 231482884, 231482887, 3, 640x360 
0x12CB3460, 36963310719293160, 231482902, 231482906, 4, 640x360 
0x12CB3460, 36963310719612688, 231482942, 231482945, 3, 640x360 
0x12CB3460, 36963310719933832, 231482972, 231482978, 6, 640x360 
0x12CB3460, 36963310720251568, 231483001, 231483004, 3, 640x360 
0x12CB3460, 36963310720572384, 231483032, 231483035, 3, 640x360 
0x12CB3460, 36963310720891816, 231483071, 231483074, 3, 640x360 
0x12CB3460, 36963310721212688, 231483101, 231483104, 3, 640x360 
0x12CB3460, 36963310721533672, 231483132, 231483135, 3, 640x360 
0x12CB3460, 36963310722014688, 231483182, 231483184, 2, 640x360 
0x12CB3460, 36963310722334680, 231483213, 231483215, 2, 640x360 
0x12CB3460, 36963310722652592, 231483242, 231483245, 3, 640x360 
0x12CB3460, 36963310722972480, 231483273, 231483282, 9, 640x360 
0x12CB3460, 36963310723292024, 231483302, 231483305, 3, 640x360 
0x12CB3460, 36963310723614328, 231483342, 231483345, 3, 640x360 
0x12CB3460, 36963310723934576, 231483382, 231483384, 2, 640x360 
0x12CB3460, 36963310724251632, 231483401, 231483404, 3, 640x360 
0x12CB3460, 36963310724573160, 231483432, 231483435, 3, 640x360 
0x12CB3460, 36963310724894000, 231483472, 231483474, 2, 640x360 
0x12CB3460, 36963310725214472, 231483502, 231483504, 2, 640x360 
0x12CB3460, 36963310725693480, 231483552, 231483555, 3, 640x360 
0x12CB3460, 36963310726012440, 231483582, 231483585, 3, 640x360 
0x12CB3460, 36963310726333512, 231483614, 231483616, 2, 640x360 
0x12CB3460, 36963310726654256, 231483642, 231483645, 3, 640x360 
0x12CB3460, 36963310726972888, 231483671, 231483675, 4, 640x360 
0x12CB3460, 36963310727293344, 231483712, 231483715, 3, 640x360 
0x12CB3460, 36963310727613776, 231483742, 231483745, 3, 640x360 
0x12CB3460, 36963310727932936, 231483771, 231483774, 3, 640x360 
0x12CB3460, 36963310728254336, 231483803, 231483805, 2, 640x360 
0x12CB3460, 36963310728572576, 231483832, 231483835, 3, 640x360 
0x12CB3460, 36963310728894672, 231483868, 231483871, 3, 640x360 
0x12CB3460, 36963310729212840, 231483903, 231483905, 2, 640x360 
0x12CB3460, 36963310729693840, 231483953, 231483957, 4, 640x360 
0x12CB3460, 36963310730014008, 231483982, 231483984, 2, 640x360 
0x12CB3460, 36963310730333168, 231484012, 231484014, 2, 640x360 
0x12CB3460, 36963310730654152, 231484042, 231484045, 3, 640x360 
0x12CB3460, 36963310730971760, 231484072, 231484075, 3, 640x360 
0x12CB3460, 36963310731293344, 231484103, 231484107, 4, 640x360 
0x12CB3460, 36963310731613936, 231484142, 231484144, 2, 640x360 
0x12CB3460, 36963310731932192, 231484171, 231484174, 3, 640x360 
0x12CB3460, 36963310732252456, 231484202, 231484205, 3, 640x360 
0x12CB3460, 36963310732572568, 231484232, 231484235, 3, 640x360 
0x12CB3460, 36963310732895088, 231484263, 231484267, 4, 640x360 
0x12CB3460, 36963310733213016, 231484302, 231484305, 3, 640x360 
0x12CB3460, 36963310733693312, 231484342, 231484346, 4, 640x360 
0x12CB3460, 36963310734012512, 231484384, 231484387, 3, 640x360 
0x12CB3460, 36963310734333040, 231484411, 231484414, 3, 640x360 
0x12CB3460, 36963310734653472, 231484442, 231484445, 3, 640x360 
0x12CB3460, 36963310734973592, 231484472, 231484477, 5, 640x360 
0x12CB3460, 36963310735293032, 231484502, 231484505, 3, 640x360 
0x12CB3460, 36963310735614536, 231484543, 231484546, 3, 640x360 
0x12CB3460, 36963310735934064, 231484572, 231484575, 3, 640x360 
0x12CB3460, 36963310736255040, 231484602, 231484605, 3, 640x360 
0x12CB3460, 36963310736575960, 231484634, 231484637, 3, 640x360 
0x12CB3460, 36963310736893160, 231484662, 231484666, 4, 640x360 
0x12CB3460, 36963310737374216, 231484711, 231484715, 4, 640x360 
0x12CB3460, 36963310737693272, 231484743, 231484747, 4, 640x360 
0x12CB3460, 36963310738013672, 231484782, 231484784, 2, 640x360 
0x12CB3460, 36963310738336112, 231484812, 231484815, 3, 640x360 
0x12CB3460, 36963310738655280, 231484842, 231484844, 2, 640x360 
0x12CB3460, 36963310738972600, 231484882, 231484885, 3, 640x360 
0x12CB3460, 36963310739292432, 231484902, 231484905, 3, 640x360 
0x12CB3460, 36963310739612272, 231484941, 231484944, 3, 640x360 
0x12CB3460, 36963310739931704, 231484972, 231484974, 2, 640x360 
0x12CB3460, 36963310740252680, 231485001, 231485005, 4, 640x360 
0x12CB3460, 36963310740572624, 231485032, 231485035, 3, 640x360 
0x12CB3460, 36963310740892160, 231485062, 231485066, 4, 640x360 
0x12CB3460, 36963310741373536, 231485113, 231485116, 3, 640x360 
0x12CB3460, 36963310741694248, 231485143, 231485146, 3, 640x360 
0x12CB3460, 36963310742013344, 231485181, 231485184, 3, 640x360 
0x12CB3460, 36963310742332240, 231485211, 231485214, 3, 640x360 
0x12CB3460, 36963310742653256, 231485242, 231485245, 3, 640x360 
0x12CB3460, 36963310742972632, 231485272, 231485275, 3, 640x360 
0x12CB3460, 36963310743295168, 231485313, 231485316, 3, 640x360 
0x12CB3460, 36963310743618512, 231485341, 231485344, 3, 640x360 
0x12CB3460, 36963310743933520, 231485375, 231485378, 3, 640x360 
0x12CB3460, 36963310744251792, 231485401, 231485404, 3, 640x360 
0x12CB3460, 36963310744572376, 231485432, 231485435, 3, 640x360 
0x12CB3460, 36963310745054888, 231485482, 231485484, 2, 640x360 
0x12CB3460, 36963310745373248, 231485512, 231485515, 3, 640x360 
0x12CB3460, 36963310745692160, 231485552, 231485555, 3, 640x360 
0x12CB3460, 36963310746013608, 231485582, 231485585, 3, 640x360 
0x12CB3460, 36963310746332192, 231485612, 231485614, 2, 640x360 
0x12CB3460, 36963310746652632, 231485643, 231485646, 3, 640x360 
0x12CB3460, 36963310746972864, 231485672, 231485674, 2, 640x360 
0x12CB3460, 36963310747291360, 231485702, 231485706, 4, 640x360 
0x12CB3460, 36963310747612320, 231485742, 231485744, 2, 640x360 
0x12CB3460, 36963310747933408, 231485771, 231485774, 3, 640x360 
0x12CB3460, 36963310748252640, 231485802, 231485806, 4, 640x360 
0x12CB3460, 36963310748572880, 231485833, 231485836, 3, 640x360 
0x12CB3460, 36963310749053464, 231485882, 231485885, 3, 640x360 
0x12CB3460, 36963310749371304, 231485912, 231485915, 3, 640x360 
0x12CB3460, 36963310749693480, 231485942, 231485945, 3, 640x360 
0x12CB3460, 36963310750012408, 231485982, 231485985, 3, 640x360 
0x12CB3460, 36963310750333192, 231486012, 231486015, 3, 640x360 
0x12CB3460, 36963310750653616, 231486042, 231486057, 15, 640x360 
0x12CB3460, 36963310750972248, 231486071, 231486074, 3, 640x360 
0x12CB3460, 36963310751293192, 231486102, 231486106, 4, 640x360 
0x12CB3460, 36963310751612296, 231486141, 231486144, 3, 640x360 
0x12CB3460, 36963310751935192, 231486172, 231486174, 2, 640x360 
0x12CB3460, 36963310752253232, 231486202, 231486205, 3, 640x360 
0x12CB3460, 36963310752573680, 231486232, 231486236, 4, 640x360 
0x12CB3460, 36963310753051472, 231486281, 231486284, 3, 640x360 
0x12CB3460, 36963310753373152, 231486312, 231486316, 4, 640x360 
0x12CB3460, 36963310753691624, 231486377, 231486381, 4, 640x360 
0x12CB3460, 36963310754331544, 231486412, 231486415, 3, 640x360 
0x12CB3460, 36963310754653448, 231486442, 231486445, 3, 640x360 
0x12CB3460, 36963310754972536, 231486472, 231486475, 3, 640x360 
0x12CB3460, 36963310755293600, 231486512, 231486515, 3, 640x360 
0x12CB3460, 36963310755613936, 231486542, 231486545, 3, 640x360 
0x12CB3460, 36963310755934392, 231486571, 231486574, 3, 640x360 
0x12CB3460, 36963310756252680, 231486602, 231486605, 3, 640x360 
0x12CB3460, 36963310756732368, 231486652, 231486655, 3, 640x360 
0x12CB3460, 36963310757053712, 231486683, 231486685, 2, 640x360 
0x12CB3460, 36963310757374648, 231486712, 231486715, 3, 640x360 
0x12CB3460, 36963310757692632, 231486742, 231486746, 4, 640x360 
0x12CB3460, 36963310758013016, 231486782, 231486785, 3, 640x360 
0x12CB3460, 36963310758333296, 231486811, 231486814, 3, 640x360 
0x12CB3460, 36963310758653216, 231486842, 231486844, 2, 640x360 
0x12CB3460, 36963310758971832, 231486882, 231486885, 3, 640x360 
0x12CB3460, 36963310759292544, 231486902, 231486921, 19, 640x360 
0x12CB3460, 36963310759612592, 231486942, 231486945, 3, 640x360 
0x12CB3460, 36963310759933216, 231486972, 231486974, 2, 640x360 
0x12CB3460, 36963310760252616, 231487002, 231487005, 3, 640x360 
0x12CB3460, 36963310760734328, 231487052, 231487055, 3, 640x360 
0x12CB3460, 36963310761051464, 231487081, 231487084, 3, 640x360 
0x12CB3460, 36963310761371640, 231487112, 231487116, 4, 640x360 
0x12CB3460, 36963310761692616, 231487142, 231487146, 4, 640x360 
0x12CB3460, 36963310762012080, 231487183, 231487185, 2, 640x360 
0x12CB3460, 36963310762333496, 231487212, 231487215, 3, 640x360 
0x12CB3460, 36963310762655112, 231487242, 231487245, 3, 640x360 
0x12CB3460, 36963310762971952, 231487273, 231487276, 3, 640x360 
0x12CB3460, 36963310763294272, 231487304, 231487308, 4, 640x360 
0x12CB3460, 36963310763612096, 231487342, 231487344, 2, 640x360 
0x12CB3460, 36963310763935376, 231487381, 231487385, 4, 640x360 
0x12CB3460, 36963310764251816, 231487402, 231487404, 2, 640x360 
0x12CB3460, 36963310764731856, 231487452, 231487455, 3, 640x360 
0x12CB3460, 36963310765053768, 231487483, 231487487, 4, 640x360 
0x12CB3460, 36963310765371664, 231487511, 231487515, 4, 640x360 
0x12CB3460, 36963310765693392, 231487551, 231487554, 3, 640x360 
0x12CB3460, 36963310766012704, 231487582, 231487585, 3, 640x360 
0x12CB3460, 36963310766332624, 231487613, 231487615, 2, 640x360 
0x12CB3460, 36963310766653984, 231487643, 231487646, 3, 640x360 
0x12CB3460, 36963310766972328, 231487671, 231487675, 4, 640x360 
0x12CB3460, 36963310767294848, 231487712, 231487714, 2, 640x360 
0x12CB3460, 36963310767613080, 231487743, 231487746, 3, 640x360 
0x12CB3460, 36963310767932560, 231487772, 231487775, 3, 640x360 
0x12CB3460, 36963310768411808, 231487821, 231487824, 3, 640x360 
0x12CB3460, 36963310768732480, 231487869, 231487872, 3, 640x360 
0x12CB3460, 36963310769051192, 231487882, 231487884, 2, 640x360 
0x12CB3460, 36963310769373496, 231487912, 231487915, 3, 640x360 
0x12CB3460, 36963310769692952, 231487942, 231487946, 4, 640x360 
0x12CB3460, 36963310770012368, 231487981, 231487984, 3, 640x360 
0x12CB3460, 36963310770331960, 231488011, 231488014, 3, 640x360 
0x12CB3460, 36963310770653728, 231488042, 231488045, 3, 640x360 
0x12CB3460, 36963310770972360, 231488071, 231488075, 4, 640x360 
0x12CB3460, 36963310771292680, 231488103, 231488107, 4, 640x360 
0x12CB3460, 36963310771613136, 231488142, 231488145, 3, 640x360 
0x12CB3460, 36963310771937440, 231488171, 231488174, 3, 640x360 
0x12CB3460, 36963310772411384, 231488222, 231488225, 3, 640x360 
0x12CB3460, 36963310772731528, 231488251, 231488254, 3, 640x360 
0x12CB3460, 36963310773051208, 231488282, 231488284, 2, 640x360 
0x12CB3460, 36963310773371216, 231488312, 231488314, 2, 640x360 
0x12CB3460, 36963310773692256, 231488342, 231488347, 5, 640x360 
0x12CB3460, 36963310774012320, 231488382, 231488385, 3, 640x360 
0x12CB3460, 36963310774331824, 231488411, 231488414, 3, 640x360 
0x12CB3460, 36963310774653712, 231488443, 231488445, 2, 640x360 
0x12CB3460, 36963310774972336, 231488472, 231488475, 3, 640x360 
0x12CB3460, 36963310775294776, 231488512, 231488515, 3, 640x360 
0x12CB3460, 36963310775614096, 231488542, 231488544, 2, 640x360 
0x12CB3460, 36963310775936448, 231488573, 231488577, 4, 640x360 
0x12CB3460, 36963310776415736, 231488624, 231488627, 3, 640x360 
0x12CB3460, 36963310776733864, 231488653, 231488656, 3, 640x360 
0x12CB3460, 36963310777054680, 231488682, 231488685, 3, 640x360 
0x12CB3460, 36963310777374336, 231488713, 231488716, 3, 640x360 
0x12CB3460, 36963310777692488, 231488743, 231488747, 4, 640x360 
0x12CB3460, 36963310778012328, 231488783, 231488786, 3, 640x360 
0x12CB3460, 36963310778332464, 231488812, 231488815, 3, 640x360 
0x12CB3460, 36963310778652648, 231488842, 231488847, 5, 640x360 
0x12CB3460, 36963310778974104, 231488884, 231488887, 3, 640x360 
0x12CB3460, 36963310779292792, 231488902, 231488906, 4, 640x360 
0x12CB3460, 36963310779615912, 231488941, 231488944, 3, 640x360 
0x12CB3460, 36963310780090976, 231488982, 231488986, 4, 640x360 
0x12CB3460, 36963310780412888, 231489021, 231489032, 11, 640x360 
0x12CB3460, 36963310780734248, 231489052, 231489055, 3, 640x360 
0x12CB3460, 36963310781051264, 231489081, 231489084, 3, 640x360 
0x12CB3460, 36963310781373272, 231489112, 231489115, 3, 640x360 
0x12CB3460, 36963310781693472, 231489153, 231489155, 2, 640x360 
0x12CB3460, 36963310782012784, 231489182, 231489187, 5, 640x360 
0x12CB3460, 36963310782331528, 231489211, 231489214, 3, 640x360 
0x12CB3460, 36963310782653424, 231489242, 231489245, 3, 640x360 
0x12CB3460, 36963310782974448, 231489272, 231489276, 4, 640x360 
0x12CB3460, 36963310783293360, 231489303, 231489306, 3, 640x360 
0x12CB3460, 36963310783613352, 231489342, 231489345, 3, 640x360 
0x12CB3460, 36963310784092936, 231489384, 231489388, 4, 640x360 
0x12CB3460, 36963310784412688, 231489421, 231489424, 3, 640x360 
0x12CB3460, 36963310784733608, 231489451, 231489455, 4, 640x360 
0x12CB3460, 36963310785051792, 231489482, 231489484, 2, 640x360 
0x12CB3460, 36963310785372512, 231489512, 231489517, 5, 640x360 
0x12CB3460, 36963310785693704, 231489552, 231489555, 3, 640x360 
0x12CB3460, 36963310786015256, 231489582, 231489585, 3, 640x360 
0x12CB3460, 36963310786332528, 231489612, 231489615, 3, 640x360 
0x12CB3460, 36963310786653216, 231489642, 231489645, 3, 640x360 
0x12CB3460, 36963310786973296, 231489672, 231489675, 3, 640x360 
0x12CB3460, 36963310787291928, 231489702, 231489707, 5, 640x360 
0x12CB3460, 36963310787773080, 231489751, 231489754, 3, 640x360 
0x12CB3460, 36963310788092280, 231489783, 231489787, 4, 640x360 
0x12CB3460, 36963310788413592, 231489816, 231489821, 5, 640x360 
0x12CB3460, 36963310788733416, 231489866, 231489869, 3, 640x360 
0x12CB3460, 36963310789051288, 231489881, 231489884, 3, 640x360 
0x12CB3460, 36963310789372824, 231489912, 231489914, 2, 640x360 
0x12CB3460, 36963310789693480, 231489943, 231489947, 4, 640x360 
0x12CB3460, 36963310790013520, 231489981, 231489984, 3, 640x360 
0x12CB3460, 36963310790332288, 231490012, 231490014, 2, 640x360 
0x12CB3460, 36963310790652336, 231490041, 231490044, 3, 640x360 
0x12CB3460, 36963310790972488, 231490071, 231490074, 3, 640x360 
0x12CB3460, 36963310791292984, 231490102, 231490106, 4, 640x360 
0x12CB3460, 36963310791772696, 231490152, 231490155, 3, 640x360 
0x12CB3460, 36963310792090888, 231490183, 231490187, 4, 640x360 
0x12CB3460, 36963310792413032, 231490222, 231490225, 3, 640x360 
0x12CB3460, 36963310792732792, 231490252, 231490254, 2, 640x360 
0x12CB3460, 36963310793051800, 231490281, 231490284, 3, 640x360 
0x12CB3460, 36963310793373088, 231490312, 231490315, 3, 640x360 
0x12CB3460, 36963310793693008, 231490353, 231490356, 3, 640x360 
0x12CB3460, 36963310794012208, 231490387, 231490391, 4, 640x360 
0x12CB3460, 36963310794331984, 231490411, 231490414, 3, 640x360 
0x12CB3460, 36963310794652968, 231490442, 231490445, 3, 640x360 
0x12CB3460, 36963310794971496, 231490472, 231490482, 10, 640x360 
0x12CB3460, 36963310795293288, 231490503, 231490507, 4, 640x360 
0x12CB3460, 36963310795770856, 231490551, 231490554, 3, 640x360 
0x12CB3460, 36963310796091168, 231490583, 231490586, 3, 640x360 
0x12CB3460, 36963310796411848, 231490621, 231490624, 3, 640x360 
0x12CB3460, 36963310796733224, 231490652, 231490655, 3, 640x360 
0x12CB3460, 36963310797051800, 231490681, 231490684, 3, 640x360 
0x12CB3460, 36963310797373328, 231490713, 231490715, 2, 640x360 
0x12CB3460, 36963310797695120, 231490743, 231490748, 5, 640x360 
0x12CB3460, 36963310798011984, 231490782, 231490784, 2, 640x360 
0x12CB3460, 36963310798333336, 231490812, 231490815, 3, 640x360 
0x12CB3460, 36963310798653928, 231490842, 231490845, 3, 640x360 
0x12CB3460, 36963310798972352, 231490873, 231490876, 3, 640x360 
0x12CB3460, 36963310799452960, 231490921, 231490924, 3, 640x360 
0x12CB3460, 36963310799771560, 231490953, 231490956, 3, 640x360 
0x12CB3460, 36963310800090872, 231490983, 231490986, 3, 640x360 
0x12CB3460, 36963310800412960, 231491022, 231491024, 2, 640x360 
0x12CB3460, 36963310800734032, 231491051, 231491055, 4, 640x360 
0x12CB3460, 36963310801051304, 231491082, 231491085, 3, 640x360 
0x12CB3460, 36963310801372736, 231491112, 231491115, 3, 640x360 
0x12CB3460, 36963310801692440, 231491142, 231491146, 4, 640x360 
0x12CB3460, 36963310802012128, 231491182, 231491185, 3, 640x360 
0x12CB3460, 36963310802331216, 231491212, 231491214, 2, 640x360 
0x12CB3460, 36963310802653120, 231491242, 231491245, 3, 640x360 
0x12CB3460, 36963310802973288, 231491272, 231491282, 10, 640x360 
0x12CB3460, 36963310803454544, 231491322, 231491326, 4, 640x360 
0x12CB3460, 36963310803772440, 231491374, 231491377, 3, 640x360 
0x12CB3460, 36963310804093272, 231491383, 231491387, 4, 640x360 
0x12CB3460, 36963310804413872, 231491421, 231491424, 3, 640x360 
0x12CB3460, 36963310804736792, 231491453, 231491458, 5, 640x360 
0x12CB3460, 36963310805051616, 231491481, 231491484, 3, 640x360 
0x12CB3460, 36963310805373240, 231491512, 231491515, 3, 640x360 
0x12CB3460, 36963310805692528, 231491552, 231491555, 3, 640x360 
0x12CB3460, 36963310806012496, 231491582, 231491584, 2, 640x360 
0x12CB3460, 36963310806332472, 231491612, 231491615, 3, 640x360 
0x12CB3460, 36963310806654128, 231491642, 231491645, 3, 640x360 
0x12CB3460, 36963310806972728, 231491671, 231491675, 4, 640x360 
0x12CB3460, 36963310807453792, 231491722, 231491725, 3, 640x360 
0x12CB3460, 36963310807772616, 231491751, 231491754, 3, 640x360 
0x12CB3460, 36963310808091960, 231491783, 231491787, 4, 640x360 
0x12CB3460, 36963310808414088, 231491823, 231491826, 3, 640x360 
0x12CB3460, 36963310808731944, 231491876, 231491881, 5, 640x360 
0x12CB3460, 36963310809051976, 231491893, 231491896, 3, 640x360 
0x12CB3460, 36963310809371632, 231491912, 231491915, 3, 640x360 
0x12CB3460, 36963310809693032, 231491953, 231491956, 3, 640x360 
0x12CB3460, 36963310810011360, 231491982, 231491985, 3, 640x360 
0x12CB3460, 36963310810332744, 231492012, 231492015, 3, 640x360 
0x12CB3460, 36963310810652960, 231492042, 231492045, 3, 640x360 
0x12CB3460, 36963310811132128, 231492092, 231492094, 2, 640x360 
0x12CB3460, 36963310811453248, 231492121, 231492124, 3, 640x360 
0x12CB3460, 36963310811770848, 231492152, 231492155, 3, 640x360 
0x12CB3460, 36963310812091824, 231492192, 231492194, 2, 640x360 
0x12CB3460, 36963310812411592, 231492221, 231492224, 3, 640x360 
0x12CB3460, 36963310812733736, 231492252, 231492255, 3, 640x360 
0x12CB3460, 36963310813052944, 231492282, 231492285, 3, 640x360 
0x12CB3460, 36963310813373208, 231492312, 231492315, 3, 640x360 
0x12CB3460, 36963310813692744, 231492342, 231492345, 3, 640x360 
0x12CB3460, 36963310814012832, 231492392, 231492395, 3, 640x360 
0x12CB3460, 36963310814332712, 231492411, 231492414, 3, 640x360 
0x12CB3460, 36963310814652368, 231492442, 231492445, 3, 640x360 
0x12CB3460, 36963310815132344, 231492491, 231492494, 3, 640x360 
0x12CB3460, 36963310815450976, 231492521, 231492524, 3, 640x360 
0x12CB3460, 36963310815771976, 231492552, 231492557, 5, 640x360 
0x12CB3460, 36963310816093392, 231492592, 231492594, 2, 640x360 
0x12CB3460, 36963310816411664, 231492621, 231492624, 3, 640x360 
0x12CB3460, 36963310816733160, 231492652, 231492655, 3, 640x360 
0x12CB3460, 36963310817054352, 231492682, 231492685, 3, 640x360 
0x12CB3460, 36963310817372208, 231492712, 231492715, 3, 640x360 
0x12CB3460, 36963310817691584, 231492742, 231492746, 4, 640x360 
0x12CB3460, 36963310818011712, 231492782, 231492799, 17, 640x360 
0x12CB3460, 36963310818333016, 231492812, 231492814, 2, 640x360 
0x12CB3460, 36963310818653640, 231492841, 231492844, 3, 640x360 
0x12CB3460, 36963310819132168, 231492892, 231492895, 3, 640x360 
0x12CB3460, 36963310819452976, 231492921, 231492932, 11, 640x360 
0x12CB3460, 36963310819772064, 231492953, 231492957, 4, 640x360 
0x12CB3460, 36963310820093536, 231492983, 231492986, 3, 640x360 
0x12CB3460, 36963310820412040, 231493022, 231493025, 3, 640x360 
0x12CB3460, 36963310820733352, 231493052, 231493055, 3, 640x360 
0x12CB3460, 36963310821051248, 231493082, 231493099, 17, 640x360 
0x12CB3460, 36963310821371376, 231493112, 231493115, 3, 640x360 
0x12CB3460, 36963310821692072, 231493142, 231493146, 4, 640x360 
0x12CB3460, 36963310822015712, 231493182, 231493185, 3, 640x360 
0x12CB3460, 36963310822331336, 231493212, 231493214, 2, 640x360 
0x12CB3460, 36963310822811048, 231493262, 231493264, 2, 640x360 
0x12CB3460, 36963310823132024, 231493292, 231493295, 3, 640x360 
0x12CB3460, 36963310823451328, 231493322, 231493325, 3, 640x360 
0x12CB3460, 36963310823770784, 231493352, 231493355, 3, 640x360 
0x12CB3460, 36963310824093880, 231493392, 231493395, 3, 640x360 
0x12CB3460, 36963310824412768, 231493421, 231493424, 3, 640x360 
0x12CB3460, 36963310824733272, 231493453, 231493457, 4, 640x360 
0x12CB3460, 36963310825051464, 231493481, 231493484, 3, 640x360 
0x12CB3460, 36963310825373536, 231493512, 231493515, 3, 640x360 
0x12CB3460, 36963310825692408, 231493552, 231493554, 2, 640x360 
0x12CB3460, 36963310826013504, 231493582, 231493585, 3, 640x360 
0x12CB3460, 36963310826333072, 231493613, 231493615, 2, 640x360 
0x12CB3460, 36963310826812088, 231493661, 231493665, 4, 640x360 
0x12CB3460, 36963310827133648, 231493692, 231493695, 3, 640x360 
0x12CB3460, 36963310827454392, 231493722, 231493725, 3, 640x360 
0x12CB3460, 36963310827776880, 231493753, 231493757, 4, 640x360 
0x12CB3460, 36963310828095328, 231493792, 231493795, 3, 640x360 
0x12CB3460, 36963310828414224, 231493826, 231493829, 3, 640x360 
0x12CB3460, 36963310828732624, 231493883, 231493887, 4, 640x360 
0x12CB3460, 36963310829371392, 231493912, 231493915, 3, 640x360 
0x12CB3460, 36963310829691720, 231493953, 231493955, 2, 640x360 
0x12CB3460, 36963310830013912, 231493983, 231493986, 3, 640x360 
0x12CB3460, 36963310830494584, 231494031, 231494050, 19, 640x360 
0x12CB3460, 36963310830813152, 231494061, 231494064, 3, 640x360 
0x12CB3460, 36963310831132000, 231494092, 231494095, 3, 640x360 
0x12CB3460, 36963310831452888, 231494122, 231494125, 3, 640x360 
0x12CB3460, 36963310831771448, 231494153, 231494156, 3, 640x360 
0x12CB3460, 36963310832091288, 231494183, 231494187, 4, 640x360 
0x12CB3460, 36963310832412568, 231494222, 231494224, 2, 640x360 
0x12CB3460, 36963310832730960, 231494251, 231494254, 3, 640x360 
0x12CB3460, 36963310833051864, 231494282, 231494284, 2, 640x360 
0x12CB3460, 36963310833372336, 231494312, 231494315, 3, 640x360 
0x12CB3460, 36963310833693136, 231494342, 231494361, 19, 640x360 
0x12CB3460, 36963310834011824, 231494375, 231494379, 4, 640x360 
0x12CB3460, 36963310834492200, 231494422, 231494425, 3, 640x360 
0x12CB3460, 36963310834810856, 231494462, 231494464, 2, 640x360 
0x12CB3460, 36963310835132872, 231494493, 231494497, 4, 640x360 
0x12CB3460, 36963310835452952, 231494522, 231494524, 2, 640x360 
0x12CB3460, 36963310835772008, 231494552, 231494555, 3, 640x360 
0x12CB3460, 36963310836091552, 231494583, 231494586, 3, 640x360 
0x12CB3460, 36963310836413480, 231494621, 231494624, 3, 640x360 
0x12CB3460, 36963310836733416, 231494653, 231494656, 3, 640x360 
0x12CB3460, 36963310837052224, 231494681, 231494684, 3, 640x360 
0x12CB3460, 36963310837372920, 231494712, 231494715, 3, 640x360 
0x12CB3460, 36963310837692328, 231494751, 231494753, 2, 640x360 
0x12CB3460, 36963310838012464, 231494782, 231494785, 3, 640x360 
0x12CB3460, 36963310838494032, 231494831, 231494835, 4, 640x360 
0x12CB3460, 36963310838812536, 231494878, 231494881, 3, 640x360 
0x12CB3460, 36963310839132904, 231494891, 231494894, 3, 640x360 
0x12CB3460, 36963310839452576, 231494922, 231494924, 2, 640x360 
0x12CB3460, 36963310839773392, 231494952, 231494955, 3, 640x360 
0x12CB3460, 36963310840093424, 231494983, 231494987, 4, 640x360 
0x12CB3460, 36963310840413240, 231495022, 231495024, 2, 640x360 
0x12CB3460, 36963310840733328, 231495051, 231495054, 3, 640x360 
0x12CB3460, 36963310841051280, 231495082, 231495085, 3, 640x360 
0x12CB3460, 36963310841372456, 231495112, 231495114, 2, 640x360 
0x12CB3460, 36963310841692984, 231495143, 231495147, 4, 640x360 
0x12CB3460, 36963310842172304, 231495191, 231495194, 3, 640x360 
0x12CB3460, 36963310842492344, 231495222, 231495226, 4, 640x360 
0x12CB3460, 36963310842812056, 231495261, 231495264, 3, 640x360 
0x12CB3460, 36963310843131744, 231495291, 231495294, 3, 640x360 
0x12CB3460, 36963310843451848, 231495322, 231495324, 2, 640x360 
0x12CB3460, 36963310843774368, 231495372, 231495375, 3, 640x360 
0x12CB3460, 36963310844092352, 231495383, 231495387, 4, 640x360 
0x12CB3460, 36963310844412400, 231495422, 231495425, 3, 640x360 
0x12CB3460, 36963310844731688, 231495452, 231495456, 4, 640x360 
0x12CB3460, 36963310845052208, 231495482, 231495485, 3, 640x360 
0x12CB3460, 36963310845372824, 231495513, 231495517, 4, 640x360 
0x12CB3460, 36963310845694104, 231495552, 231495555, 3, 640x360 
0x12CB3460, 36963310846172384, 231495592, 231495596, 4, 640x360 
0x12CB3460, 36963310846493480, 231495632, 231495635, 3, 640x360 
0x12CB3460, 36963310846812160, 231495662, 231495665, 3, 640x360 
0x12CB3460, 36963310847132912, 231495691, 231495694, 3, 640x360 
0x12CB3460, 36963310847452368, 231495722, 231495725, 3, 640x360 
0x12CB3460, 36963310847772112, 231495752, 231495755, 3, 640x360 
0x12CB3460, 36963310848091824, 231495783, 231495787, 4, 640x360 
0x12CB3460, 36963310848412056, 231495822, 231495825, 3, 640x360 
0x12CB3460, 36963310848731720, 231495866, 231495869, 3, 640x360 
0x12CB3460, 36963310849052072, 231495881, 231495884, 3, 640x360 
0x12CB3460, 36963310849371304, 231495912, 231495915, 3, 640x360 
0x12CB3460, 36963310849692656, 231495942, 231495946, 4, 640x360 
0x12CB3460, 36963310850172592, 231495992, 231495996, 4, 640x360 
0x12CB3460, 36963310850491184, 231496022, 231496025, 3, 640x360 
0x12CB3460, 36963310850813320, 231496062, 231496065, 3, 640x360 
0x12CB3460, 36963310851132032, 231496091, 231496094, 3, 640x360 
0x12CB3460, 36963310851452664, 231496122, 231496125, 3, 640x360 
0x12CB3460, 36963310851770960, 231496151, 231496155, 4, 640x360 
0x12CB3460, 36963310852092880, 231496192, 231496194, 2, 640x360 
0x12CB3460, 36963310852411768, 231496222, 231496225, 3, 640x360 
0x12CB3460, 36963310852731656, 231496251, 231496254, 3, 640x360 
0x12CB3460, 36963310853052816, 231496283, 231496301, 18, 640x360 
0x12CB3460, 36963310853372912, 231496313, 231496316, 3, 640x360 
0x12CB3460, 36963310853853248, 231496384, 231496387, 3, 640x360 
0x12CB3460, 36963310854172368, 231496393, 231496396, 3, 640x360 
0x12CB3460, 36963310854492208, 231496432, 231496434, 2, 640x360 
0x12CB3460, 36963310854811024, 231496462, 231496465, 3, 640x360 
0x12CB3460, 36963310855132072, 231496492, 231496495, 3, 640x360 
0x12CB3460, 36963310855451936, 231496522, 231496524, 2, 640x360 
0x12CB3460, 36963310855772440, 231496551, 231496554, 3, 640x360 
0x12CB3460, 36963310856093416, 231496584, 231496588, 4, 640x360 
0x12CB3460, 36963310856411272, 231496622, 231496625, 3, 640x360 
0x12CB3460, 36963310856731624, 231496652, 231496655, 3, 640x360 
0x12CB3460, 36963310857052168, 231496681, 231496684, 3, 640x360 
0x12CB3460, 36963310857371752, 231496712, 231496715, 3, 640x360 
0x12CB3460, 36963310857852152, 231496761, 231496764, 3, 640x360 
0x12CB3460, 36963310858172208, 231496791, 231496794, 3, 640x360 
0x12CB3460, 36963310858490528, 231496833, 231496836, 3, 640x360 
0x12CB3460, 36963310858811576, 231496873, 231496877, 4, 640x360 
0x12CB3460, 36963310859131760, 231496891, 231496894, 3, 640x360 
0x12CB3460, 36963310859451424, 231496922, 231496924, 2, 640x360 
0x12CB3460, 36963310859772720, 231496952, 231496956, 4, 640x360 
0x12CB3460, 36963310860091912, 231496992, 231496995, 3, 640x360 
0x12CB3460, 36963310860414016, 231497023, 231497028, 5, 640x360 
0x12CB3460, 36963310860732664, 231497052, 231497055, 3, 640x360 
0x12CB3460, 36963310861051752, 231497081, 231497084, 3, 640x360 
0x12CB3460, 36963310861532784, 231497131, 231497134, 3, 640x360 
0x12CB3460, 36963310861852696, 231497162, 231497164, 2, 640x360 
0x12CB3460, 36963310862170608, 231497192, 231497195, 3, 640x360 
0x12CB3460, 36963310862492880, 231497223, 231497227, 4, 640x360 
0x12CB3460, 36963310862812328, 231497261, 231497263, 2, 640x360 
0x12CB3460, 36963310863132608, 231497292, 231497294, 2, 640x360 
0x12CB3460, 36963310863452544, 231497321, 231497324, 3, 640x360 
0x12CB3460, 36963310863774824, 231497375, 231497378, 3, 640x360 
0x12CB3460, 36963310864091568, 231497383, 231497386, 3, 640x360 
0x12CB3460, 36963310864412520, 231497421, 231497424, 3, 640x360 
0x12CB3460, 36963310864732784, 231497453, 231497456, 3, 640x360 
0x12CB3460, 36963310865052496, 231497482, 231497484, 2, 640x360 
0x12CB3460, 36963310865532480, 231497533, 231497535, 2, 640x360 
0x12CB3460, 36963310865851216, 231497562, 231497564, 2, 640x360 
0x12CB3460, 36963310866172424, 231497591, 231497594, 3, 640x360 
0x12CB3460, 36963310866491264, 231497622, 231497627, 5, 640x360 
0x12CB3460, 36963310866812824, 231497663, 231497665, 2, 640x360 
0x12CB3460, 36963310867134224, 231497692, 231497695, 3, 640x360 
0x12CB3460, 36963310867450848, 231497722, 231497725, 3, 640x360 
0x12CB3460, 36963310867772520, 231497752, 231497755, 3, 640x360 
0x12CB3460, 36963310868093720, 231497783, 231497786, 3, 640x360 
0x12CB3460, 36963310868413440, 231497822, 231497824, 2, 640x360 
0x12CB3460, 36963310868731304, 231497851, 231497855, 4, 640x360 
0x12CB3460, 36963310869052040, 231497892, 231497895, 3, 640x360 
0x12CB3460, 36963310869532392, 231497932, 231497935, 3, 640x360 
0x12CB3460, 36963310869851168, 231497962, 231497964, 2, 640x360 
0x12CB3460, 36963310870172456, 231497992, 231497995, 3, 640x360 
0x12CB3460, 36963310870491552, 231498023, 231498027, 4, 640x360 
0x12CB3460, 36963310870811464, 231498062, 231498064, 2, 640x360 
0x12CB3460, 36963310871131672, 231498092, 231498095, 3, 640x360 
0x12CB3460, 36963310871451608, 231498122, 231498125, 3, 640x360 
0x12CB3460, 36963310871770952, 231498153, 231498155, 2, 640x360 
0x12CB3460, 36963310872092072, 231498192, 231498195, 3, 640x360 
0x12CB3460, 36963310872411984, 231498221, 231498224, 3, 640x360 
0x12CB3460, 36963310872731328, 231498252, 231498254, 2, 640x360 
0x12CB3460, 36963310873213096, 231498302, 231498305, 3, 640x360 
0x12CB3460, 36963310873532080, 231498333, 231498349, 16, 640x360 
0x12CB3460, 36963310873855200, 231498378, 231498381, 3, 640x360 
0x12CB3460, 36963310874171864, 231498391, 231498394, 3, 640x360 
0x12CB3460, 36963310874490736, 231498422, 231498425, 3, 640x360 
0x12CB3460, 36963310874811016, 231498462, 231498465, 3, 640x360 
0x12CB3460, 36963310875131800, 231498492, 231498495, 3, 640x360 
0x12CB3460, 36963310875452024, 231498521, 231498524, 3, 640x360 
0x12CB3460, 36963310875771344, 231498551, 231498554, 3, 640x360 
0x12CB3460, 36963310876093608, 231498583, 231498587, 4, 640x360 
0x12CB3460, 36963310876412200, 231498622, 231498625, 3, 640x360 
0x12CB3460, 36963310876730992, 231498652, 231498655, 3, 640x360 
0x12CB3460, 36963310877210784, 231498702, 231498705, 3, 640x360 
0x12CB3460, 36963310877532800, 231498731, 231498734, 3, 640x360 
0x12CB3460, 36963310877850496, 231498762, 231498764, 2, 640x360 
0x12CB3460, 36963310878172704, 231498792, 231498795, 3, 640x360 
0x12CB3460, 36963310878491544, 231498823, 231498826, 3, 640x360 
0x12CB3460, 36963310878811816, 231498873, 231498876, 3, 640x360 
0x12CB3460, 36963310879133504, 231498891, 231498894, 3, 640x360 
0x12CB3460, 36963310879452152, 231498922, 231498924, 2, 640x360 
0x12CB3460, 36963310879772840, 231498952, 231498955, 3, 640x360 
0x12CB3460, 36963310880094272, 231498984, 231498988, 4, 640x360 
0x12CB3460, 36963310880414560, 231499023, 231499027, 4, 640x360 
0x12CB3460, 36963310880732792, 231499052, 231499055, 3, 640x360 
0x12CB3460, 36963310881210864, 231499101, 231499104, 3, 640x360 
0x12CB3460, 36963310881532664, 231499132, 231499135, 3, 640x360 
0x12CB3460, 36963310881852632, 231499161, 231499164, 3, 640x360 
0x12CB3460, 36963310882171840, 231499193, 231499195, 2, 640x360 
0x12CB3460, 36963310882491888, 231499223, 231499227, 4, 640x360 
0x12CB3460, 36963310882811064, 231499261, 231499264, 3, 640x360 
0x12CB3460, 36963310883132944, 231499292, 231499295, 3, 640x360 
0x12CB3460, 36963310883451352, 231499322, 231499324, 2, 640x360 
0x12CB3460, 36963310883770696, 231499352, 231499355, 3, 640x360 
0x12CB3460, 36963310884090904, 231499382, 231499386, 4, 640x360 
0x12CB3460, 36963310884411472, 231499421, 231499424, 3, 640x360 
0x12CB3460, 36963310884892408, 231499462, 231499465, 3, 640x360 
0x12CB3460, 36963310885210968, 231499501, 231499504, 3, 640x360 
0x12CB3460, 36963310885532544, 231499533, 231499535, 2, 640x360 
0x12CB3460, 36963310885851648, 231499562, 231499565, 3, 640x360 
0x12CB3460, 36963310886174256, 231499591, 231499596, 5, 640x360 
0x12CB3460, 36963310886494472, 231499633, 231499636, 3, 640x360 
0x12CB3460, 36963310886815488, 231499662, 231499665, 3, 640x360 
0x12CB3460, 36963310887133192, 231499692, 231499695, 3, 640x360 
0x12CB3460, 36963310887450584, 231499721, 231499724, 3, 640x360 
0x12CB3460, 36963310887772600, 231499752, 231499755, 3, 640x360 
0x12CB3460, 36963310888092872, 231499792, 231499795, 3, 640x360 
0x12CB3460, 36963310888412144, 231499822, 231499825, 3, 640x360 
0x12CB3460, 36963310888893832, 231499879, 231499882, 3, 640x360 
0x12CB3460, 36963310889210328, 231499901, 231499904, 3, 640x360 
0x12CB3460, 36963310889532384, 231499932, 231499935, 3, 640x360 
0x12CB3460, 36963310889851208, 231499962, 231499965, 3, 640x360 
0x12CB3460, 36963310890172984, 231499993, 231499996, 3, 640x360 
0x12CB3460, 36963310890493376, 231500032, 231500035, 3, 640x360 
0x12CB3460, 36963310890811656, 231500062, 231500065, 3, 640x360 
0x12CB3460, 36963310891130464, 231500091, 231500094, 3, 640x360 
0x12CB3460, 36963310891452184, 231500123, 231500126, 3, 640x360 
0x12CB3460, 36963310891771808, 231500152, 231500155, 3, 640x360 
0x12CB3460, 36963310892092024, 231500183, 231500186, 3, 640x360 
0x12CB3460, 36963310892412496, 231500222, 231500225, 3, 640x360 
0x12CB3460, 36963310892891584, 231500262, 231500266, 4, 640x360 
0x12CB3460, 36963310893212592, 231500302, 231500304, 2, 640x360 
0x12CB3460, 36963310893531792, 231500331, 231500334, 3, 640x360 
0x12CB3460, 36963310893853624, 231500384, 231500387, 3, 640x360 
0x12CB3460, 36963310894172520, 231500392, 231500395, 3, 640x360 
0x12CB3460, 36963310894491976, 231500422, 231500426, 4, 640x360 
0x12CB3460, 36963310894812472, 231500462, 231500464, 2, 640x360 
0x12CB3460, 36963310895132224, 231500491, 231500494, 3, 640x360 
0x12CB3460, 36963310895451008, 231500522, 231500533, 11, 640x360 
0x12CB3460, 36963310895772536, 231500551, 231500555, 4, 640x360 
0x12CB3460, 36963310896093272, 231500583, 231500586, 3, 640x360 
0x12CB3460, 36963310896572976, 231500632, 231500635, 3, 640x360 
0x12CB3460, 36963310896894096, 231500671, 231500676, 5, 640x360 
0x12CB3460, 36963310897211248, 231500701, 231500708, 7, 640x360 
0x12CB3460, 36963310897531752, 231500732, 231500736, 4, 640x360 
0x12CB3460, 36963310897851376, 231500762, 231500765, 3, 640x360 
0x12CB3460, 36963310898173912, 231500792, 231500797, 5, 640x360 
0x12CB3460, 36963310898497808, 231500834, 231500838, 4, 640x360 
0x12CB3460, 36963310898811088, 231500886, 231500890, 4, 640x360 
0x12CB3460, 36963310899452432, 231500922, 231500924, 2, 640x360 
0x12CB3460, 36963310899770912, 231500953, 231500956, 3, 640x360 
0x12CB3460, 36963310900092080, 231500983, 231500987, 4, 640x360 
0x12CB3460, 36963310900570688, 231501032, 231501036, 4, 640x360 
0x12CB3460, 36963310900890480, 231501072, 231501078, 6, 640x360 
0x12CB3460, 36963310901210768, 231501101, 231501104, 3, 640x360 
0x12CB3460, 36963310901532456, 231501132, 231501135, 3, 640x360 
0x12CB3460, 36963310901851696, 231501162, 231501165, 3, 640x360 
0x12CB3460, 36963310902171168, 231501191, 231501194, 3, 640x360 
0x12CB3460, 36963310902491304, 231501222, 231501227, 5, 640x360 
0x12CB3460, 36963310902811848, 231501262, 231501265, 3, 640x360 
0x12CB3460, 36963310903130960, 231501292, 231501294, 2, 640x360 
0x12CB3460, 36963310903452312, 231501323, 231501326, 3, 640x360 
0x12CB3460, 36963310903773352, 231501375, 231501378, 3, 640x360 
0x12CB3460, 36963310904252120, 231501402, 231501405, 3, 640x360 
0x12CB3460, 36963310904572544, 231501431, 231501435, 4, 640x360 
0x12CB3460, 36963310904891128, 231501472, 231501474, 2, 640x360 
0x12CB3460, 36963310905213408, 231501502, 231501504, 2, 640x360 
0x12CB3460, 36963310905532080, 231501532, 231501535, 3, 640x360 
0x12CB3460, 36963310905850840, 231501561, 231501564, 3, 640x360 
0x12CB3460, 36963310906171088, 231501592, 231501595, 3, 640x360 
0x12CB3460, 36963310906491136, 231501622, 231501626, 4, 640x360 
0x12CB3460, 36963310906811368, 231501661, 231501664, 3, 640x360 
0x12CB3460, 36963310907131176, 231501692, 231501694, 2, 640x360 
0x12CB3460, 36963310907452032, 231501722, 231501733, 11, 640x360 
0x12CB3460, 36963310907771520, 231501752, 231501755, 3, 640x360 
0x12CB3460, 36963310908251504, 231501802, 231501805, 3, 640x360 
0x12CB3460, 36963310908573240, 231501832, 231501835, 3, 640x360 
0x12CB3460, 36963310908893496, 231501872, 231501875, 3, 640x360 
0x12CB3460, 36963310909211256, 231501902, 231501904, 2, 640x360 
0x12CB3460, 36963310909530200, 231501931, 231501937, 6, 640x360 
0x12CB3460, 36963310909853888, 231501962, 231501971, 9, 640x360 
0x12CB3460, 36963310910171272, 231501992, 231501995, 3, 640x360 
0x12CB3460, 36963310910492224, 231502031, 231502035, 4, 640x360 
0x12CB3460, 36963310910816800, 231502062, 231502065, 3, 640x360 
0x12CB3460, 36963310911131856, 231502091, 231502095, 4, 640x360 
0x12CB3460, 36963310911451272, 231502122, 231502125, 3, 640x360 
0x12CB3460, 36963310911771496, 231502152, 231502155, 3, 640x360 
0x12CB3460, 36963310912250144, 231502202, 231502210, 8, 640x360 
0x12CB3460, 36963310912570232, 231502234, 231502237, 3, 640x360 
0x12CB3460, 36963310912889952, 231502262, 231502266, 4, 640x360 
0x12CB3460, 36963310913212168, 231502302, 231502305, 3, 640x360 
0x12CB3460, 36963310913530104, 231502333, 231502339, 6, 640x360 
0x12CB3460, 36963310913851752, 231502384, 231502387, 3, 640x360 
0x12CB3460, 36963310914172752, 231502392, 231502396, 4, 640x360 
0x12CB3460, 36963310914491096, 231502423, 231502426, 3, 640x360 
0x12CB3460, 36963310914811432, 231502462, 231502465, 3, 640x360 
0x12CB3460, 36963310915131360, 231502491, 231502494, 3, 640x360 
0x12CB3460, 36963310915450544, 231502522, 231502525, 3, 640x360 
0x12CB3460, 36963310915930944, 231502571, 231502574, 3, 640x360 
0x12CB3460, 36963310916252032, 231502602, 231502604, 2, 640x360 
0x12CB3460, 36963310916570656, 231502632, 231502635, 3, 640x360 
0x12CB3460, 36963310916890800, 231502663, 231502667, 4, 640x360 
0x12CB3460, 36963310917212032, 231502701, 231502704, 3, 640x360 
0x12CB3460, 36963310917530984, 231502732, 231502736, 4, 640x360 
0x12CB3460, 36963310917850480, 231502761, 231502764, 3, 640x360 
0x12CB3460, 36963310918171320, 231502793, 231502796, 3, 640x360 
0x12CB3460, 36963310918492872, 231502832, 231502835, 3, 640x360 
0x12CB3460, 36963310918813160, 231502875, 231502880, 5, 640x360 
0x12CB3460, 36963310919131904, 231502892, 231502894, 2, 640x360 
0x12CB3460, 36963310919451832, 231502921, 231502924, 3, 640x360 
0x12CB3460, 36963310919932480, 231502972, 231502975, 3, 640x360 
0x12CB3460, 36963310920250584, 231503002, 231503004, 2, 640x360 
0x12CB3460, 36963310920574056, 231503034, 231503038, 4, 640x360 
0x12CB3460, 36963310920892064, 231503062, 231503066, 4, 640x360 
0x12CB3460, 36963310921211464, 231503102, 231503105, 3, 640x360 
0x12CB3460, 36963310921531632, 231503132, 231503135, 3, 640x360 
0x12CB3460, 36963310921851336, 231503162, 231503165, 3, 640x360 
0x12CB3460, 36963310922170768, 231503192, 231503195, 3, 640x360 
0x12CB3460, 36963310922497264, 231503223, 231503227, 4, 640x360 
0x12CB3460, 36963310922810448, 231503261, 231503264, 3, 640x360 
0x12CB3460, 36963310923134344, 231503293, 231503296, 3, 640x360 
0x12CB3460, 36963310923453112, 231503322, 231503324, 2, 640x360 
0x12CB3460, 36963310923930392, 231503374, 231503393, 19, 640x360 
0x12CB3460, 36963310924249944, 231503402, 231503404, 2, 640x360 
0x12CB3460, 36963310924571824, 231503432, 231503435, 3, 640x360 
0x12CB3460, 36963310924890592, 231503472, 231503475, 3, 640x360 
0x12CB3460, 36963310925210896, 231503501, 231503504, 3, 640x360 
0x12CB3460, 36963310925531736, 231503532, 231503535, 3, 640x360 
0x12CB3460, 36963310925850536, 231503561, 231503564, 3, 640x360 
0x12CB3460, 36963310926172200, 231503592, 231503594, 2, 640x360 
0x12CB3460, 36963310926491544, 231503632, 231503635, 3, 640x360 
0x12CB3460, 36963310926811200, 231503662, 231503665, 3, 640x360 
0x12CB3460, 36963310927131752, 231503692, 231503696, 4, 640x360 
0x12CB3460, 36963310927610816, 231503736, 231503739, 3, 640x360 
0x12CB3460, 36963310927930968, 231503772, 231503775, 3, 640x360 
0x12CB3460, 36963310928251400, 231503801, 231503804, 3, 640x360 
0x12CB3460, 36963310928571832, 231503832, 231503835, 3, 640x360 
0x12CB3460, 36963310928891696, 231503876, 231503888, 12, 640x360 
0x12CB3460, 36963310929211648, 231503901, 231503904, 3, 640x360 
0x12CB3460, 36963310929530800, 231503932, 231503935, 3, 640x360 
0x12CB3460, 36963310929850624, 231503962, 231503979, 17, 640x360 
0x12CB3460, 36963310930172224, 231503993, 231503996, 3, 640x360 
0x12CB3460, 36963310930493240, 231504031, 231504034, 3, 640x360 
0x12CB3460, 36963310930812976, 231504062, 231504064, 2, 640x360 
0x12CB3460, 36963310931130320, 231504091, 231504093, 2, 640x360 
0x12CB3460, 36963310931611680, 231504141, 231504144, 3, 640x360 
0x12CB3460, 36963310931932688, 231504172, 231504175, 3, 640x360 
0x12CB3460, 36963310932249832, 231504202, 231504204, 2, 640x360 
0x12CB3460, 36963310932572576, 231504232, 231504235, 3, 640x360 
0x12CB3460, 36963310932890336, 231504262, 231504265, 3, 640x360 
0x12CB3460, 36963310933210192, 231504301, 231504304, 3, 640x360 
0x12CB3460, 36963310933531816, 231504333, 231504336, 3, 640x360 
0x12CB3460, 36963310933851792, 231504375, 231504378, 3, 640x360 
0x12CB3460, 36963310934171048, 231504392, 231504394, 2, 640x360 
0x12CB3460, 36963310934491552, 231504432, 231504434, 2, 640x360 
0x12CB3460, 36963310934811056, 231504462, 231504465, 3, 640x360 
0x12CB3460, 36963310935133376, 231504492, 231504495, 3, 640x360 
0x12CB3460, 36963310935612992, 231504541, 231504544, 3, 640x360 
0x12CB3460, 36963310935934352, 231504573, 231504577, 4, 640x360 
0x12CB3460, 36963310936254368, 231504602, 231504605, 3, 640x360 
0x12CB3460, 36963310936575680, 231504646, 231504650, 4, 640x360 
0x12CB3460, 36963310936890744, 231504672, 231504675, 3, 640x360 
0x12CB3460, 36963310937212384, 231504701, 231504704, 3, 640x360 
0x12CB3460, 36963310937531240, 231504732, 231504735, 3, 640x360 
0x12CB3460, 36963310937850384, 231504762, 231504765, 3, 640x360 
0x12CB3460, 36963310938171696, 231504792, 231504795, 3, 640x360 
0x12CB3460, 36963310938491664, 231504822, 231504825, 3, 640x360 
0x12CB3460, 36963310938811856, 231504890, 231504893, 3, 640x360 
0x12CB3460, 36963310939289680, 231504902, 231504905, 3, 640x360 
0x12CB3460, 36963310939611128, 231504942, 231504945, 3, 640x360 
0x12CB3460, 36963310939931248, 231504971, 231504974, 3, 640x360 
0x12CB3460, 36963310940249968, 231505002, 231505004, 2, 640x360 
0x12CB3460, 36963310940570928, 231505032, 231505035, 3, 640x360 
0x12CB3460, 36963310940890096, 231505062, 231505065, 3, 640x360 
0x12CB3460, 36963310941210728, 231505101, 231505104, 3, 640x360 
0x12CB3460, 36963310941530176, 231505132, 231505135, 3, 640x360 
0x12CB3460, 36963310941851224, 231505161, 231505164, 3, 640x360 
0x12CB3460, 36963310942170632, 231505192, 231505194, 2, 640x360 
0x12CB3460, 36963310942491048, 231505222, 231505225, 3, 640x360 
0x12CB3460, 36963310942810816, 231505261, 231505264, 3, 640x360 
0x12CB3460, 36963310943289768, 231505302, 231505305, 3, 640x360 
0x12CB3460, 36963310943611232, 231505342, 231505345, 3, 640x360 
0x12CB3460, 36963310943934144, 231505377, 231505381, 4, 640x360 
0x12CB3460, 36963310944250304, 231505402, 231505405, 3, 640x360 
0x12CB3460, 36963310944569896, 231505431, 231505434, 3, 640x360 
0x12CB3460, 36963310944890840, 231505462, 231505465, 3, 640x360 
0x12CB3460, 36963310945211184, 231505501, 231505504, 3, 640x360 
0x12CB3460, 36963310945530656, 231505532, 231505535, 3, 640x360 
0x12CB3460, 36963310945850144, 231505561, 231505564, 3, 640x360 
0x12CB3460, 36963310946170912, 231505592, 231505595, 3, 640x360 
0x12CB3460, 36963310946490512, 231505622, 231505625, 3, 640x360 
0x12CB3460, 36963310946969608, 231505672, 231505674, 2, 640x360 
0x12CB3460, 36963310947289864, 231505711, 231505714, 3, 640x360 
0x12CB3460, 36963310947612528, 231505742, 231505744, 2, 640x360 
0x12CB3460, 36963310947930136, 231505771, 231505773, 2, 640x360 
0x12CB3460, 36963310948250000, 231505802, 231505804, 2, 640x360 
0x12CB3460, 36963310948570152, 231505832, 231505835, 3, 640x360 
0x12CB3460, 36963310948892224, 231505871, 231505877, 6, 640x360 
0x12CB3460, 36963310949210536, 231505901, 231505904, 3, 640x360 
0x12CB3460, 36963310949530136, 231505932, 231505934, 2, 640x360 
0x12CB3460, 36963310949851200, 231505962, 231505964, 2, 640x360 
0x12CB3460, 36963310950172184, 231505992, 231505995, 3, 640x360 
0x12CB3460, 36963310950491024, 231506032, 231506034, 2, 640x360 
0x12CB3460, 36963310950971264, 231506071, 231506074, 3, 640x360 
0x12CB3460, 36963310951291360, 231506102, 231506104, 2, 640x360 
0x12CB3460, 36963310951610288, 231506142, 231506145, 3, 640x360 
0x12CB3460, 36963310951930216, 231506171, 231506173, 2, 640x360 
0x12CB3460, 36963310952250192, 231506202, 231506204, 2, 640x360 
0x12CB3460, 36963310952570480, 231506231, 231506234, 3, 640x360 
0x12CB3460, 36963310952890120, 231506262, 231506264, 2, 640x360 
0x12CB3460, 36963310953210264, 231506302, 231506304, 2, 640x360 
0x12CB3460, 36963310953531000, 231506332, 231506334, 2, 640x360 
0x12CB3460, 36963310953852032, 231506370, 231506373, 3, 640x360 
0x12CB3460, 36963310954170672, 231506392, 231506395, 3, 640x360 
0x12CB3460, 36963310954490592, 231506432, 231506435, 3, 640x360 
0x12CB3460, 36963310954969800, 231506472, 231506474, 2, 640x360 
0x12CB3460, 36963310955290104, 231506511, 231506514, 3, 640x360 
0x12CB3460, 36963310955610080, 231506542, 231506545, 3, 640x360 
0x12CB3460, 36963310955929904, 231506571, 231506574, 3, 640x360 
0x12CB3460, 36963310956250080, 231506602, 231506604, 2, 640x360 
0x12CB3460, 36963310956571656, 231506631, 231506635, 4, 640x360 
0x12CB3460, 36963310956893144, 231506662, 231506666, 4, 640x360 
0x12CB3460, 36963310957210520, 231506702, 231506705, 3, 640x360 
0x12CB3460, 36963310957532048, 231506732, 231506735, 3, 640x360 
0x12CB3460, 36963310957851064, 231506761, 231506764, 3, 640x360 
0x12CB3460, 36963310958177104, 231506791, 231506794, 3, 640x360 
0x12CB3460, 36963310958650152, 231506842, 231506845, 3, 640x360 
0x12CB3460, 36963310958970256, 231506878, 231506881, 3, 640x360 
0x12CB3460, 36963310959291288, 231506902, 231506905, 3, 640x360 
0x12CB3460, 36963310959609920, 231506942, 231506944, 2, 640x360 
0x12CB3460, 36963310959930352, 231506971, 231506974, 3, 640x360 
0x12CB3460, 36963310960250296, 231507002, 231507005, 3, 640x360 
0x12CB3460, 36963310960570840, 231507031, 231507034, 3, 640x360 
0x12CB3460, 36963310960890456, 231507062, 231507064, 2, 640x360 
0x12CB3460, 36963310961210744, 231507102, 231507105, 3, 640x360 
0x12CB3460, 36963310961530528, 231507132, 231507134, 2, 640x360 
0x12CB3460, 36963310961851976, 231507162, 231507165, 3, 640x360 
0x12CB3460, 36963310962171688, 231507191, 231507195, 4, 640x360 
0x12CB3460, 36963310962649920, 231507242, 231507245, 3, 640x360 
0x12CB3460, 36963310962971792, 231507271, 231507274, 3, 640x360 
0x12CB3460, 36963310963290000, 231507302, 231507305, 3, 640x360 
0x12CB3460, 36963310963610496, 231507342, 231507345, 3, 640x360 
0x12CB3460, 36963310963933656, 231507384, 231507387, 3, 640x360 
0x12CB3460, 36963310964250352, 231507402, 231507405, 3, 640x360 
0x12CB3460, 36963310964570176, 231507431, 231507434, 3, 640x360 
0x12CB3460, 36963310964890200, 231507465, 231507468, 3, 640x360 
0x12CB3460, 36963310965211640, 231507502, 231507505, 3, 640x360 
0x12CB3460, 36963310965530288, 231507531, 231507534, 3, 640x360 
0x12CB3460, 36963310965850872, 231507563, 231507566, 3, 640x360 
0x12CB3460, 36963310966170408, 231507592, 231507594, 2, 640x360 
0x12CB3460, 36963310966651536, 231507642, 231507644, 2, 640x360 
0x12CB3460, 36963310966969792, 231507672, 231507675, 3, 640x360 
0x12CB3460, 36963310967290472, 231507712, 231507715, 3, 640x360 
0x12CB3460, 36963310967615040, 231507741, 231507744, 3, 640x360 
0x12CB3460, 36963310967930016, 231507771, 231507774, 3, 640x360 
0x12CB3460, 36963310968250584, 231507801, 231507804, 3, 640x360 
0x12CB3460, 36963310968571640, 231507831, 231507834, 3, 640x360 
0x12CB3460, 36963310968891656, 231507874, 231507878, 4, 640x360 
0x12CB3460, 36963310969210472, 231507901, 231507904, 3, 640x360 
0x12CB3460, 36963310969531096, 231507932, 231507934, 2, 640x360 
0x12CB3460, 36963310969852152, 231507962, 231507966, 4, 640x360 
0x12CB3460, 36963310970329744, 231508011, 231508015, 4, 640x360 
0x12CB3460, 36963310970651136, 231508042, 231508045, 3, 640x360 
0x12CB3460, 36963310970971376, 231508072, 231508074, 2, 640x360 
0x12CB3460, 36963310971291000, 231508101, 231508104, 3, 640x360 
0x12CB3460, 36963310971612784, 231508142, 231508144, 2, 640x360 
0x12CB3460, 36963310971930520, 231508171, 231508175, 4, 640x360 
0x12CB3460, 36963310972250736, 231508201, 231508204, 3, 640x360 
0x12CB3460, 36963310972570392, 231508231, 231508234, 3, 640x360 
0x12CB3460, 36963310972890120, 231508263, 231508266, 3, 640x360 
0x12CB3460, 36963310973210696, 231508302, 231508305, 3, 640x360 
0x12CB3460, 36963310973531400, 231508333, 231508336, 3, 640x360 
0x12CB3460, 36963310973851832, 231508383, 231508386, 3, 640x360 
0x12CB3460, 36963310974329744, 231508411, 231508414, 3, 640x360 
0x12CB3460, 36963310974651744, 231508442, 231508444, 2, 640x360 
0x12CB3460, 36963310974972096, 231508472, 231508475, 3, 640x360 
0x12CB3460, 36963310975290160, 231508502, 231508505, 3, 640x360 
0x12CB3460, 36963310975612328, 231508541, 231508543, 2, 640x360 
0x12CB3460, 36963310975930320, 231508572, 231508574, 2, 640x360 
0x12CB3460, 36963310976250984, 231508601, 231508603, 2, 640x360 
0x12CB3460, 36963310976569784, 231508632, 231508634, 2, 640x360 
0x12CB3460, 36963310976890016, 231508662, 231508664, 2, 640x360 
0x12CB3460, 36963310977210264, 231508702, 231508704, 2, 640x360 
0x12CB3460, 36963310977531120, 231508732, 231508735, 3, 640x360 
0x12CB3460, 36963310978009528, 231508781, 231508784, 3, 640x360 
0x12CB3460, 36963310978331456, 231508812, 231508814, 2, 640x360 
0x12CB3460, 36963310978650976, 231508841, 231508844, 3, 640x360 
0x12CB3460, 36963310978970040, 231508870, 231508873, 3, 640x360 
0x12CB3460, 36963310979291240, 231508912, 231508915, 3, 640x360 
0x12CB3460, 36963310979611072, 231508942, 231508945, 3, 640x360 
0x12CB3460, 36963310979930224, 231508972, 231508975, 3, 640x360 
0x12CB3460, 36963310980250096, 231509002, 231509005, 3, 640x360 
0x12CB3460, 36963310980569856, 231509033, 231509036, 3, 640x360 
0x12CB3460, 36963310980890456, 231509062, 231509064, 2, 640x360 
0x12CB3460, 36963310981211336, 231509101, 231509104, 3, 640x360 
0x12CB3460, 36963310981530800, 231509132, 231509135, 3, 640x360 
0x12CB3460, 36963310982010240, 231509181, 231509184, 3, 640x360 
0x12CB3460, 36963310982330552, 231509212, 231509215, 3, 640x360 
0x12CB3460, 36963310982649912, 231509241, 231509244, 3, 640x360 
0x12CB3460, 36963310982971624, 231509272, 231509274, 2, 640x360 
0x12CB3460, 36963310983290096, 231509312, 231509314, 2, 640x360 
0x12CB3460, 36963310983610976, 231509342, 231509345, 3, 640x360 
0x12CB3460, 36963310983933952, 231509372, 231509375, 3, 640x360 
0x12CB3460, 36963310984252752, 231509401, 231509404, 3, 640x360 
0x12CB3460, 36963310984570328, 231509432, 231509435, 3, 640x360 
0x12CB3460, 36963310984892296, 231509472, 231509476, 4, 640x360 
0x12CB3460, 36963310985210840, 231509502, 231509505, 3, 640x360 
0x12CB3460, 36963310985531192, 231509532, 231509535, 3, 640x360 
0x12CB3460, 36963310986009640, 231509581, 231509583, 2, 640x360 
0x12CB3460, 36963310986329488, 231509612, 231509614, 2, 640x360 
0x12CB3460, 36963310986651448, 231509643, 231509647, 4, 640x360 
0x12CB3460, 36963310986970424, 231509672, 231509675, 3, 640x360 
0x12CB3460, 36963310987291176, 231509702, 231509705, 3, 640x360 
0x12CB3460, 36963310987611000, 231509741, 231509743, 2, 640x360 
0x12CB3460, 36963310987931016, 231509771, 231509774, 3, 640x360 
0x12CB3460, 36963310988250096, 231509802, 231509805, 3, 640x360 
0x12CB3460, 36963310988578192, 231509831, 231509835, 4, 640x360 
0x12CB3460, 36963310988894048, 231509877, 231509884, 7, 640x360 
0x12CB3460, 36963310989213800, 231509901, 231509904, 3, 640x360 
0x12CB3460, 36963310989691552, 231509942, 231509945, 3, 640x360 
0x12CB3460, 36963310990010488, 231509982, 231509984, 2, 640x360 
0x12CB3460, 36963310990330696, 231510012, 231510015, 3, 640x360 
0x12CB3460, 36963310990649504, 231510042, 231510045, 3, 640x360 
0x12CB3460, 36963310990970776, 231510071, 231510074, 3, 640x360 
0x12CB3460, 36963310991290560, 231510103, 231510106, 3, 640x360 
0x12CB3460, 36963310991610760, 231510142, 231510145, 3, 640x360 
0x12CB3460, 36963310991931272, 231510173, 231510177, 4, 640x360 
0x12CB3460, 36963310992250536, 231510202, 231510204, 2, 640x360 
0x12CB3460, 36963310992569888, 231510233, 231510236, 3, 640x360 
0x12CB3460, 36963310992889728, 231510262, 231510264, 2, 640x360 
0x12CB3460, 36963310993210208, 231510301, 231510304, 3, 640x360 
0x12CB3460, 36963310993689256, 231510342, 231510344, 2, 640x360 
0x12CB3460, 36963310994009720, 231510374, 231510377, 3, 640x360 
0x12CB3460, 36963310994329872, 231510411, 231510414, 3, 640x360 
0x12CB3460, 36963310994652352, 231510442, 231510445, 3, 640x360 
0x12CB3460, 36963310994970672, 231510472, 231510475, 3, 640x360 
0x12CB3460, 36963310995291656, 231510512, 231510515, 3, 640x360 
0x12CB3460, 36963310995610936, 231510541, 231510543, 2, 640x360 
0x12CB3460, 36963310995931080, 231510572, 231510574, 2, 640x360 
0x12CB3460, 36963310996252232, 231510602, 231510605, 3, 640x360 
0x12CB3460, 36963310996572408, 231510633, 231510636, 3, 640x360 
0x12CB3460, 36963310996890848, 231510672, 231510674, 2, 640x360 
0x12CB3460, 36963310997211336, 231510702, 231510704, 2, 640x360 
0x12CB3460, 36963310997691024, 231510742, 231510744, 2, 640x360 
0x12CB3460, 36963310998011600, 231510781, 231510784, 3, 640x360 
0x12CB3460, 36963310998331384, 231510811, 231510814, 3, 640x360 
0x12CB3460, 36963310998650976, 231510841, 231510844, 3, 640x360 
0x12CB3460, 36963310998971632, 231510870, 231510872, 2, 640x360 
0x12CB3460, 36963310999290120, 231510902, 231510904, 2, 640x360 
0x12CB3460, 36963310999611184, 231510942, 231510944, 2, 640x360 
0x12CB3460, 36963310999930776, 231510972, 231510974, 2, 640x360 
0x12CB3460, 36963311000249976, 231511003, 231511005, 2, 640x360 
0x12CB3460, 36963311000571856, 231511032, 231511034, 2, 640x360 
0x12CB3460, 36963311000891464, 231511072, 231511075, 3, 640x360 
0x12CB3460, 36963311001371624, 231511111, 231511114, 3, 640x360 
0x12CB3460, 36963311001690168, 231511142, 231511145, 3, 640x360 
0x12CB3460, 36963311002010440, 231511181, 231511184, 3, 640x360 
0x12CB3460, 36963311002331328, 231511212, 231511215, 3, 640x360 
0x12CB3460, 36963311002651824, 231511241, 231511244, 3, 640x360 
0x12CB3460, 36963311002971816, 231511272, 231511274, 2, 640x360 
0x12CB3460, 36963311003291736, 231511303, 231511305, 2, 640x360 
0x12CB3460, 36963311003613960, 231511341, 231511344, 3, 640x360 
0x12CB3460, 36963311003932944, 231511386, 231511389, 3, 640x360 
0x12CB3460, 36963311004249776, 231511401, 231511404, 3, 640x360 
0x12CB3460, 36963311004571576, 231511431, 231511434, 3, 640x360 
0x12CB3460, 36963311004892080, 231511462, 231511479, 17, 640x360 
0x12CB3460, 36963311005373432, 231511511, 231511514, 3, 640x360 
0x12CB3460, 36963311005692128, 231511545, 231511547, 2, 640x360 
0x12CB3460, 36963311006011232, 231511582, 231511584, 2, 640x360 
0x12CB3460, 36963311006331688, 231511611, 231511614, 3, 640x360 
0x12CB3460, 36963311006650848, 231511643, 231511645, 2, 640x360 
0x12CB3460, 36963311006971440, 231511672, 231511675, 3, 640x360 
0x12CB3460, 36963311007291984, 231511712, 231511715, 3, 640x360 
0x12CB3460, 36963311007611664, 231511741, 231511744, 3, 640x360 
0x12CB3460, 36963311007931640, 231511772, 231511774, 2, 640x360 
0x12CB3460, 36963311008250856, 231511802, 231511804, 2, 640x360 
0x12CB3460, 36963311008573016, 231511833, 231511835, 2, 640x360 
0x12CB3460, 36963311008893616, 231511882, 231511884, 2, 640x360 
0x12CB3460, 36963311009370792, 231511912, 231511915, 3, 640x360 
0x12CB3460, 36963311009691496, 231511952, 231511954, 2, 640x360 
0x12CB3460, 36963311010011616, 231511981, 231511984, 3, 640x360 
0x12CB3460, 36963311010329904, 231512012, 231512016, 4, 640x360 
0x12CB3460, 36963311010653744, 231512043, 231512047, 4, 640x360 
0x12CB3460, 36963311010971904, 231512071, 231512074, 3, 640x360 
0x12CB3460, 36963311011290944, 231512102, 231512120, 18, 640x360 
0x12CB3460, 36963311011610392, 231512142, 231512144, 2, 640x360 
0x12CB3460, 36963311011931176, 231512171, 231512173, 2, 640x360 
0x12CB3460, 36963311012250784, 231512201, 231512204, 3, 640x360 
0x12CB3460, 36963311012571920, 231512231, 231512233, 2, 640x360 
0x12CB3460, 36963311013050104, 231512281, 231512284, 3, 640x360 
0x12CB3460, 36963311013370096, 231512312, 231512315, 3, 640x360 
0x12CB3460, 36963311013689568, 231512342, 231512344, 2, 640x360 
0x12CB3460, 36963311014010968, 231512382, 231512385, 3, 640x360 
0x12CB3460, 36963311014329568, 231512412, 231512414, 2, 640x360 
0x12CB3460, 36963311014649632, 231512441, 231512444, 3, 640x360 
0x12CB3460, 36963311014970496, 231512472, 231512474, 2, 640x360 
0x12CB3460, 36963311015290296, 231512512, 231512515, 3, 640x360 
0x12CB3460, 36963311015610888, 231512541, 231512544, 3, 640x360 
0x12CB3460, 36963311015930864, 231512572, 231512575, 3, 640x360 
0x12CB3460, 36963311016250352, 231512601, 231512604, 3, 640x360 
0x12CB3460, 36963311016570752, 231512631, 231512634, 3, 640x360 
0x12CB3460, 36963311017051848, 231512683, 231512686, 3, 640x360 
0x12CB3460, 36963311017370848, 231512712, 231512715, 3, 640x360 
0x12CB3460, 36963311017690592, 231512751, 231512754, 3, 640x360 
0x12CB3460, 36963311018011512, 231512781, 231512784, 3, 640x360 
0x12CB3460, 36963311018332144, 231512812, 231512815, 3, 640x360 
0x12CB3460, 36963311018651984, 231512841, 231512844, 3, 640x360 
0x12CB3460, 36963311018970880, 231512875, 231512879, 4, 640x360 
0x12CB3460, 36963311019290504, 231512902, 231512904, 2, 640x360 
0x12CB3460, 36963311019610288, 231512942, 231512945, 3, 640x360 
0x12CB3460, 36963311019930416, 231512971, 231512974, 3, 640x360 
0x12CB3460, 36963311020249936, 231513002, 231513004, 2, 640x360 
0x12CB3460, 36963311020729576, 231513052, 231513055, 3, 640x360 
0x12CB3460, 36963311021050368, 231513081, 231513084, 3, 640x360 
0x12CB3460, 36963311021369840, 231513112, 231513114, 2, 640x360 
0x12CB3460, 36963311021690704, 231513142, 231513144, 2, 640x360 
0x12CB3460, 36963311022009792, 231513182, 231513185, 3, 640x360 
0x12CB3460, 36963311022331608, 231513212, 231513214, 2, 640x360 
0x12CB3460, 36963311022652144, 231513241, 231513244, 3, 640x360 
0x12CB3460, 36963311022970808, 231513272, 231513274, 2, 640x360 
0x12CB3460, 36963311023291360, 231513312, 231513315, 3, 640x360 
0x12CB3460, 36963311023611600, 231513342, 231513372, 30, 640x360 
0x12CB3460, 36963311023930632, 231513375, 231513378, 3, 640x360 
0x12CB3460, 36963311024250360, 231513402, 231513404, 2, 640x360 
0x12CB3460, 36963311024729240, 231513452, 231513454, 2, 640x360 
0x12CB3460, 36963311025049680, 231513482, 231513485, 3, 640x360 
0x12CB3460, 36963311025371368, 231513512, 231513514, 2, 640x360 
0x12CB3460, 36963311025690680, 231513551, 231513554, 3, 640x360 
0x12CB3460, 36963311026011360, 231513581, 231513584, 3, 640x360 
0x12CB3460, 36963311026331672, 231513611, 231513613, 2, 640x360 
0x12CB3460, 36963311026653280, 231513642, 231513644, 2, 640x360 
0x12CB3460, 36963311026970304, 231513672, 231513674, 2, 640x360 
0x12CB3460, 36963311027291272, 231513702, 231513704, 2, 640x360 
0x12CB3460, 36963311027677104, 231513752, 231513757, 5, 640x360 
0x12CB3460, 36963311027931592, 231513771, 231513773, 2, 640x360 
0x12CB3460, 36963311028250496, 231513802, 231513804, 2, 640x360 
0x12CB3460, 36963311028731152, 231513882, 231513887, 5, 640x360 
0x12CB3460, 36963311029371792, 231513911, 231513914, 3, 640x360 
0x12CB3460, 36963311029691136, 231513952, 231513954, 2, 640x360 
0x12CB3460, 36963311030010528, 231513982, 231513985, 3, 640x360 
0x12CB3460, 36963311030331288, 231514013, 231514016, 3, 640x360 
0x12CB3460, 36963311030653712, 231514042, 231514046, 4, 640x360 
0x12CB3460, 36963311030970592, 231514071, 231514074, 3, 640x360 
0x12CB3460, 36963311031290312, 231514102, 231514104, 2, 640x360 
0x12CB3460, 36963311031612136, 231514142, 231514145, 3, 640x360 
0x12CB3460, 36963311031931416, 231514172, 231514174, 2, 640x360 
0x12CB3460, 36963311032410704, 231514222, 231514229, 7, 640x360 
0x12CB3460, 36963311032730656, 231514251, 231514253, 2, 640x360 
0x12CB3460, 36963311033051584, 231514282, 231514284, 2, 640x360 
0x12CB3460, 36963311033372824, 231514312, 231514314, 2, 640x360 
0x12CB3460, 36963311033691840, 231514342, 231514345, 3, 640x360 
0x12CB3460, 36963311034149592, 231514391, 231514394, 3, 640x360 
0x12CB3460, 36963311034330512, 231514411, 231514413, 2, 640x360 
0x12CB3460, 36963311034651016, 231514442, 231514445, 3, 640x360 
0x12CB3460, 36963311034972240, 231514472, 231514475, 3, 640x360 
0x12CB3460, 36963311035290968, 231514502, 231514505, 3, 640x360 
0x12CB3460, 36963311035614408, 231514542, 231514545, 3, 640x360 
0x12CB3460, 36963311035929944, 231514571, 231514574, 3, 640x360 
0x12CB3460, 36963311036409776, 231514622, 231514624, 2, 640x360 
0x12CB3460, 36963311036730552, 231514652, 231514655, 3, 640x360 
0x12CB3460, 36963311037051568, 231514681, 231514684, 3, 640x360 
0x12CB3460, 36963311037369656, 231514712, 231514714, 2, 640x360 
0x12CB3460, 36963311037690912, 231514752, 231514754, 2, 640x360 
0x12CB3460, 36963311038011424, 231514781, 231514784, 3, 640x360 
0x12CB3460, 36963311038329840, 231514812, 231514817, 5, 640x360 
0x12CB3460, 36963311038651656, 231514842, 231514845, 3, 640x360 
0x12CB3460, 36963311038971184, 231514887, 231514895, 8, 640x360 
0x12CB3460, 36963311039290152, 231514901, 231514905, 4, 640x360 
0x12CB3460, 36963311039611216, 231514942, 231514945, 3, 640x360 
0x12CB3460, 36963311039932528, 231514971, 231514974, 3, 640x360 
0x12CB3460, 36963311040409520, 231515023, 231515025, 2, 640x360 
0x12CB3460, 36963311040729440, 231515051, 231515055, 4, 640x360 
0x12CB3460, 36963311041050872, 231515082, 231515100, 18, 640x360 
0x12CB3460, 36963311041370216, 231515111, 231515114, 3, 640x360 
0x12CB3460, 36963311041690600, 231515152, 231515155, 3, 640x360 
0x12CB3460, 36963311042010248, 231515182, 231515185, 3, 640x360 
0x12CB3460, 36963311042331768, 231515212, 231515215, 3, 640x360 
0x12CB3460, 36963311042652112, 231515241, 231515244, 3, 640x360 
0x12CB3460, 36963311042969688, 231515272, 231515275, 3, 640x360 
0x12CB3460, 36963311043289904, 231515311, 231515314, 3, 640x360 
0x12CB3460, 36963311043610440, 231515341, 231515344, 3, 640x360 
0x12CB3460, 36963311044088696, 231515383, 231515385, 2, 640x360 
0x12CB3460, 36963311044410800, 231515421, 231515423, 2, 640x360 
0x12CB3460, 36963311044730800, 231515452, 231515454, 2, 640x360 
0x12CB3460, 36963311045050984, 231515482, 231515484, 2, 640x360 
0x12CB3460, 36963311045371648, 231515513, 231515515, 2, 640x360 
0x12CB3460, 36963311045693096, 231515551, 231515553, 2, 640x360 
0x12CB3460, 36963311046009752, 231515582, 231515585, 3, 640x360 
0x12CB3460, 36963311046329480, 231515612, 231515615, 3, 640x360 
0x12CB3460, 36963311046650392, 231515641, 231515644, 3, 640x360 
0x12CB3460, 36963311046969480, 231515673, 231515675, 2, 640x360 
0x12CB3460, 36963311047290896, 231515702, 231515704, 2, 640x360 
0x12CB3460, 36963311047611440, 231515741, 231515744, 3, 640x360 
0x12CB3460, 36963311048091192, 231515792, 231515794, 2, 640x360 
0x12CB3460, 36963311048412248, 231515822, 231515824, 2, 640x360 
0x12CB3460, 36963311048732144, 231515878, 231515880, 2, 640x360 
0x12CB3460, 36963311049369424, 231515911, 231515914, 3, 640x360 
0x12CB3460, 36963311049691008, 231515942, 231515945, 3, 640x360 
0x12CB3460, 36963311050010456, 231515982, 231515984, 2, 640x360 
0x12CB3460, 36963311050332736, 231516012, 231516014, 2, 640x360 
0x12CB3460, 36963311050650624, 231516041, 231516044, 3, 640x360 
0x12CB3460, 36963311050970048, 231516072, 231516074, 2, 640x360 
0x12CB3460, 36963311051290552, 231516112, 231516114, 2, 640x360 
0x12CB3460, 36963311051611632, 231516141, 231516144, 3, 640x360 
0x12CB3460, 36963311052089752, 231516182, 231516185, 3, 640x360 
0x12CB3460, 36963311052411016, 231516222, 231516225, 3, 640x360 
0x12CB3460, 36963311052730408, 231516251, 231516253, 2, 640x360 
0x12CB3460, 36963311053050448, 231516282, 231516284, 2, 640x360 
0x12CB3460, 36963311053369616, 231516312, 231516315, 3, 640x360 
0x12CB3460, 36963311053690120, 231516382, 231516384, 2, 640x360 
0x12CB3460, 36963311054330160, 231516412, 231516415, 3, 640x360 
0x12CB3460, 36963311054650640, 231516441, 231516444, 3, 640x360 
0x12CB3460, 36963311054970592, 231516472, 231516475, 3, 640x360 
0x12CB3460, 36963311055290432, 231516502, 231516505, 3, 640x360 
0x12CB3460, 36963311055769648, 231516551, 231516554, 3, 640x360 
0x12CB3460, 36963311056089256, 231516583, 231516588, 5, 640x360 
0x12CB3460, 36963311056410400, 231516622, 231516624, 2, 640x360 
0x12CB3460, 36963311056731160, 231516651, 231516654, 3, 640x360 
0x12CB3460, 36963311057050984, 231516683, 231516685, 2, 640x360 
0x12CB3460, 36963311057372960, 231516711, 231516714, 3, 640x360 
0x12CB3460, 36963311057689520, 231516742, 231516746, 4, 640x360 
0x12CB3460, 36963311058009216, 231516782, 231516784, 2, 640x360 
0x12CB3460, 36963311058331200, 231516811, 231516814, 3, 640x360 
0x12CB3460, 36963311058652864, 231516842, 231516846, 4, 640x360 
0x12CB3460, 36963311058971552, 231516881, 231516885, 4, 640x360 
0x12CB3460, 36963311059290040, 231516902, 231516906, 4, 640x360 
0x12CB3460, 36963311059768952, 231516952, 231516955, 3, 640x360 
0x12CB3460, 36963311060090864, 231516983, 231516987, 4, 640x360 
0x12CB3460, 36963311060412456, 231517022, 231517024, 2, 640x360 
0x12CB3460, 36963311060731688, 231517052, 231517058, 6, 640x360 
0x12CB3460, 36963311061050856, 231517081, 231517084, 3, 640x360 
0x12CB3460, 36963311061370152, 231517112, 231517114, 2, 640x360 
0x12CB3460, 36963311061690472, 231517142, 231517146, 4, 640x360 
0x12CB3460, 36963311062009272, 231517181, 231517184, 3, 640x360 
0x12CB3460, 36963311062330008, 231517212, 231517217, 5, 640x360 
0x12CB3460, 36963311062650536, 231517241, 231517244, 3, 640x360 
0x12CB3460, 36963311062969424, 231517272, 231517274, 2, 640x360 
0x12CB3460, 36963311063455288, 231517323, 231517325, 2, 640x360 
0x12CB3460, 36963311063772984, 231517383, 231517386, 3, 640x360 
0x12CB3460, 36963311064409096, 231517421, 231517424, 3, 640x360 
0x12CB3460, 36963311064729776, 231517452, 231517455, 3, 640x360 
0x12CB3460, 36963311065051608, 231517482, 231517485, 3, 640x360 
0x12CB3460, 36963311065372272, 231517511, 231517514, 3, 640x360 
0x12CB3460, 36963311065690376, 231517542, 231517545, 3, 640x360 
0x12CB3460, 36963311066011544, 231517582, 231517599, 17, 640x360 
0x12CB3460, 36963311066329792, 231517611, 231517614, 3, 640x360 
0x12CB3460, 36963311066652032, 231517642, 231517645, 3, 640x360 
0x12CB3460, 36963311066971416, 231517674, 231517677, 3, 640x360 
0x12CB3460, 36963311067450240, 231517721, 231517724, 3, 640x360 
0x12CB3460, 36963311067770224, 231517751, 231517754, 3, 640x360 
0x12CB3460, 36963311068091176, 231517792, 231517794, 2, 640x360 
0x12CB3460, 36963311068410120, 231517823, 231517826, 3, 640x360 
0x12CB3460, 36963311068733040, 231517879, 231517883, 4, 640x360 
0x12CB3460, 36963311069371152, 231517912, 231517915, 3, 640x360 
0x12CB3460, 36963311069690736, 231517942, 231517945, 3, 640x360 
0x12CB3460, 36963311070011928, 231517982, 231517985, 3, 640x360 
0x12CB3460, 36963311070332712, 231518011, 231518014, 3, 640x360 
0x12CB3460, 36963311070650368, 231518042, 231518058, 16, 640x360 
0x12CB3460, 36963311070970672, 231518071, 231518074, 3, 640x360 
0x12CB3460, 36963311071451248, 231518122, 231518124, 2, 640x360 
0x12CB3460, 36963311071769112, 231518152, 231518154, 2, 640x360 
0x12CB3460, 36963311072090944, 231518182, 231518186, 4, 640x360 
0x12CB3460, 36963311072410656, 231518222, 231518224, 2, 640x360 
0x12CB3460, 36963311072729384, 231518251, 231518253, 2, 640x360 
0x12CB3460, 36963311073051048, 231518282, 231518285, 3, 640x360 
0x12CB3460, 36963311073370400, 231518312, 231518315, 3, 640x360 
0x12CB3460, 36963311073690920, 231518370, 231518374, 4, 640x360 
0x12CB3460, 36963311074011176, 231518381, 231518384, 3, 640x360 
0x12CB3460, 36963311074333728, 231518411, 231518414, 3, 640x360 
0x12CB3460, 36963311074650904, 231518441, 231518443, 2, 640x360 
0x12CB3460, 36963311075129192, 231518492, 231518495, 3, 640x360 
0x12CB3460, 36963311075449856, 231518522, 231518525, 3, 640x360 
0x12CB3460, 36963311075770464, 231518552, 231518556, 4, 640x360 
0x12CB3460, 36963311076097616, 231518592, 231518594, 2, 640x360 
0x12CB3460, 36963311076409664, 231518621, 231518624, 3, 640x360 
0x12CB3460, 36963311076729512, 231518652, 231518654, 2, 640x360 
0x12CB3460, 36963311077050912, 231518681, 231518686, 5, 640x360 
0x12CB3460, 36963311077371936, 231518711, 231518714, 3, 640x360 
0x12CB3460, 36963311077690448, 231518742, 231518745, 3, 640x360 
0x12CB3460, 36963311078009936, 231518781, 231518784, 3, 640x360 
0x12CB3460, 36963311078330648, 231518811, 231518813, 2, 640x360 
0x12CB3460, 36963311078649456, 231518842, 231518845, 3, 640x360 
0x12CB3460, 36963311079130176, 231518891, 231518895, 4, 640x360 
0x12CB3460, 36963311079450568, 231518921, 231518924, 3, 640x360 
0x12CB3460, 36963311079770376, 231518952, 231518955, 3, 640x360 
0x12CB3460, 36963311080091008, 231518983, 231518986, 3, 640x360 
0x12CB3460, 36963311080410240, 231519022, 231519025, 3, 640x360 
0x12CB3460, 36963311080732984, 231519051, 231519054, 3, 640x360 
0x12CB3460, 36963311081049528, 231519082, 231519085, 3, 640x360 
0x12CB3460, 36963311081369424, 231519112, 231519114, 2, 640x360 
0x12CB3460, 36963311081691400, 231519151, 231519154, 3, 640x360 
0x12CB3460, 36963311082010784, 231519183, 231519185, 2, 640x360 
0x12CB3460, 36963311082332264, 231519213, 231519230, 17, 640x360 
0x12CB3460, 36963311082653040, 231519243, 231519246, 3, 640x360 
0x12CB3460, 36963311083130816, 231519291, 231519294, 3, 640x360 
0x12CB3460, 36963311083450272, 231519322, 231519325, 3, 640x360 
0x12CB3460, 36963311083773304, 231519383, 231519386, 3, 640x360 
0x12CB3460, 36963311084410776, 231519421, 231519424, 3, 640x360 
0x12CB3460, 36963311084731304, 231519451, 231519454, 3, 640x360 
0x12CB3460, 36963311085050016, 231519482, 231519485, 3, 640x360 
0x12CB3460, 36963311085370880, 231519512, 231519515, 3, 640x360 
0x12CB3460, 36963311085691696, 231519543, 231519546, 3, 640x360 
0x12CB3460, 36963311086010032, 231519582, 231519585, 3, 640x360 
0x12CB3460, 36963311086330040, 231519611, 231519613, 2, 640x360 
0x12CB3460, 36963311086809120, 231519662, 231519664, 2, 640x360 
0x12CB3460, 36963311087130576, 231519691, 231519693, 2, 640x360 
0x12CB3460, 36963311087450472, 231519721, 231519724, 3, 640x360 
0x12CB3460, 36963311087772784, 231519752, 231519755, 3, 640x360 
0x12CB3460, 36963311088091288, 231519782, 231519787, 5, 640x360 
0x12CB3460, 36963311088410200, 231519822, 231519824, 2, 640x360 
0x12CB3460, 36963311088730992, 231519851, 231519854, 3, 640x360 
0x12CB3460, 36963311089050024, 231519883, 231519886, 3, 640x360 
0x12CB3460, 36963311089371768, 231519911, 231519914, 3, 640x360 
0x12CB3460, 36963311089690792, 231519942, 231519954, 12, 640x360 
0x12CB3460, 36963311090010736, 231519982, 231519984, 2, 640x360 
0x12CB3460, 36963311090330648, 231520011, 231520014, 3, 640x360 
0x12CB3460, 36963311090810400, 231520063, 231520066, 3, 640x360 
0x12CB3460, 36963311091130304, 231520092, 231520094, 2, 640x360 
0x12CB3460, 36963311091451040, 231520122, 231520125, 3, 640x360 
0x12CB3460, 36963311091769304, 231520151, 231520154, 3, 640x360 
0x12CB3460, 36963311092090072, 231520182, 231520186, 4, 640x360 
0x12CB3460, 36963311092411288, 231520221, 231520224, 3, 640x360 
0x12CB3460, 36963311092730648, 231520251, 231520254, 3, 640x360 
0x12CB3460, 36963311093050632, 231520281, 231520285, 4, 640x360 
0x12CB3460, 36963311093370816, 231520312, 231520315, 3, 640x360 
0x12CB3460, 36963311093690056, 231520342, 231520345, 3, 640x360 
0x12CB3460, 36963311094010952, 231520383, 231520386, 3, 640x360 
0x12CB3460, 36963311094490536, 231520422, 231520426, 4, 640x360 
0x12CB3460, 36963311094811152, 231520462, 231520480, 18, 640x360 
0x12CB3460, 36963311095129848, 231520491, 231520494, 3, 640x360 
0x12CB3460, 36963311095453608, 231520522, 231520525, 3, 640x360 
0x12CB3460, 36963311095772736, 231520553, 231520556, 3, 640x360 
0x12CB3460, 36963311096090664, 231520582, 231520586, 4, 640x360 
0x12CB3460, 36963311096410000, 231520621, 231520624, 3, 640x360 
0x12CB3460, 36963311096730096, 231520652, 231520655, 3, 640x360 
0x12CB3460, 36963311097049296, 231520683, 231520685, 2, 640x360 
0x12CB3460, 36963311097371808, 231520713, 231520715, 2, 640x360 
0x12CB3460, 36963311097689616, 231520741, 231520744, 3, 640x360 
0x12CB3460, 36963311098011680, 231520781, 231520784, 3, 640x360 
0x12CB3460, 36963311098492096, 231520832, 231520835, 3, 640x360 
0x12CB3460, 36963311098812232, 231520877, 231520879, 2, 640x360 
0x12CB3460, 36963311099129392, 231520892, 231520894, 2, 640x360 
0x12CB3460, 36963311099450712, 231520921, 231520934, 13, 640x360 
0x12CB3460, 36963311099769288, 231520952, 231520954, 2, 640x360 
0x12CB3460, 36963311100090216, 231520992, 231520995, 3, 640x360 
0x12CB3460, 36963311100410400, 231521022, 231521024, 2, 640x360 
0x12CB3460, 36963311100730136, 231521051, 231521053, 2, 640x360 
0x12CB3460, 36963311101049864, 231521082, 231521085, 3, 640x360 
0x12CB3460, 36963311101370280, 231521111, 231521115, 4, 640x360 
0x12CB3460, 36963311101691000, 231521143, 231521146, 3, 640x360 
0x12CB3460, 36963311102011656, 231521183, 231521187, 4, 640x360 
0x12CB3460, 36963311102490688, 231521222, 231521226, 4, 640x360 
0x12CB3460, 36963311102810656, 231521262, 231521265, 3, 640x360 
0x12CB3460, 36963311103129272, 231521291, 231521294, 3, 640x360 
0x12CB3460, 36963311103449448, 231521322, 231521324, 2, 640x360 
0x12CB3460, 36963311103772216, 231521372, 231521374, 2, 640x360 
0x12CB3460, 36963311104090288, 231521382, 231521386, 4, 640x360 
0x12CB3460, 36963311104409328, 231521421, 231521424, 3, 640x360 
0x12CB3460, 36963311104729672, 231521452, 231521454, 2, 640x360 
0x12CB3460, 36963311105049096, 231521481, 231521484, 3, 640x360 
0x12CB3460, 36963311105371208, 231521512, 231521515, 3, 640x360 
0x12CB3460, 36963311105690864, 231521552, 231521554, 2, 640x360 
0x12CB3460, 36963311106171408, 231521592, 231521595, 3, 640x360 
0x12CB3460, 36963311106492584, 231521631, 231521634, 3, 640x360 
0x12CB3460, 36963311106811080, 231521662, 231521666, 4, 640x360 
0x12CB3460, 36963311107132296, 231521692, 231521694, 2, 640x360 
0x12CB3460, 36963311107449544, 231521722, 231521725, 3, 640x360 
0x12CB3460, 36963311107769320, 231521751, 231521754, 3, 640x360 
0x12CB3460, 36963311108091184, 231521783, 231521786, 3, 640x360 
0x12CB3460, 36963311108410168, 231521821, 231521824, 3, 640x360 
0x12CB3460, 36963311108730488, 231521852, 231521855, 3, 640x360 
0x12CB3460, 36963311109050536, 231521884, 231521887, 3, 640x360 
0x12CB3460, 36963311109369592, 231521912, 231521915, 3, 640x360 
0x12CB3460, 36963311109691360, 231521942, 231521946, 4, 640x360 
0x12CB3460, 36963311110169096, 231521993, 231521995, 2, 640x360 
0x12CB3460, 36963311110489592, 231522022, 231522026, 4, 640x360 
0x12CB3460, 36963311110812064, 231522062, 231522079, 17, 640x360 
0x12CB3460, 36963311111130136, 231522091, 231522093, 2, 640x360 
0x12CB3460, 36963311111449240, 231522121, 231522124, 3, 640x360 
0x12CB3460, 36963311111770264, 231522152, 231522155, 3, 640x360 
0x12CB3460, 36963311112089216, 231522182, 231522186, 4, 640x360 
0x12CB3460, 36963311112411304, 231522221, 231522224, 3, 640x360 
0x12CB3460, 36963311112729280, 231522252, 231522254, 2, 640x360 
0x12CB3460, 36963311113050984, 231522281, 231522285, 4, 640x360 
0x12CB3460, 36963311113370208, 231522312, 231522315, 3, 640x360 
0x12CB3460, 36963311113690088, 231522342, 231522346, 4, 640x360 
0x12CB3460, 36963311114170120, 231522391, 231522408, 17, 640x360 
0x12CB3460, 36963311114490616, 231522432, 231522435, 3, 640x360 
0x12CB3460, 36963311114810256, 231522462, 231522465, 3, 640x360 
0x12CB3460, 36963311115130984, 231522492, 231522495, 3, 640x360 
0x12CB3460, 36963311115452696, 231522523, 231522526, 3, 640x360 
0x12CB3460, 36963311115771312, 231522552, 231522554, 2, 640x360 
0x12CB3460, 36963311116090928, 231522592, 231522594, 2, 640x360 
0x12CB3460, 36963311116410496, 231522621, 231522624, 3, 640x360 
0x12CB3460, 36963311116730760, 231522652, 231522656, 4, 640x360 
0x12CB3460, 36963311117050288, 231522683, 231522687, 4, 640x360 
0x12CB3460, 36963311117370176, 231522712, 231522715, 3, 640x360 
0x12CB3460, 36963311117848608, 231522762, 231522766, 4, 640x360 
0x12CB3460, 36963311118168848, 231522792, 231522798, 6, 640x360 
0x12CB3460, 36963311118489304, 231522822, 231522826, 4, 640x360 
0x12CB3460, 36963311118810368, 231522868, 231522871, 3, 640x360 
0x12CB3460, 36963311119135832, 231522891, 231522898, 7, 640x360 
0x12CB3460, 36963311119450120, 231522922, 231522934, 12, 640x360 
0x12CB3460, 36963311119770560, 231522952, 231522956, 4, 640x360 
0x12CB3460, 36963311120090296, 231522983, 231522987, 4, 640x360 
0x12CB3460, 36963311120409752, 231523021, 231523023, 2, 640x360 
0x12CB3460, 36963311120731432, 231523051, 231523054, 3, 640x360 
0x12CB3460, 36963311121049192, 231523082, 231523085, 3, 640x360 
0x12CB3460, 36963311121370824, 231523113, 231523115, 2, 640x360 
0x12CB3460, 36963311121850744, 231523163, 231523165, 2, 640x360 
0x12CB3460, 36963311122169888, 231523192, 231523195, 3, 640x360 
0x12CB3460, 36963311122491904, 231523223, 231523227, 4, 640x360 
0x12CB3460, 36963311122809424, 231523262, 231523264, 2, 640x360 
0x12CB3460, 36963311123131016, 231523291, 231523293, 2, 640x360 
0x12CB3460, 36963311123451096, 231523322, 231523325, 3, 640x360 
0x12CB3460, 36963311123769904, 231523352, 231523355, 3, 640x360 
0x12CB3460, 36963311124092600, 231523385, 231523388, 3, 640x360 
0x12CB3460, 36963311124409928, 231523421, 231523424, 3, 640x360 
0x12CB3460, 36963311124730720, 231523451, 231523454, 3, 640x360 
0x12CB3460, 36963311125051392, 231523481, 231523484, 3, 640x360 
0x12CB3460, 36963311125372264, 231523512, 231523515, 3, 640x360 
0x12CB3460, 36963311125851248, 231523561, 231523564, 3, 640x360 
0x12CB3460, 36963311126170272, 231523591, 231523594, 3, 640x360 
0x12CB3460, 36963311126490840, 231523622, 231523625, 3, 640x360 
0x12CB3460, 36963311126809736, 231523662, 231523664, 2, 640x360 
0x12CB3460, 36963311127132096, 231523692, 231523695, 3, 640x360 
0x12CB3460, 36963311127449528, 231523722, 231523725, 3, 640x360 
0x12CB3460, 36963311127769672, 231523752, 231523754, 2, 640x360 
0x12CB3460, 36963311128090376, 231523783, 231523786, 3, 640x360 
0x12CB3460, 36963311128409976, 231523822, 231523825, 3, 640x360 
0x12CB3460, 36963311128729280, 231523874, 231523878, 4, 640x360 
0x12CB3460, 36963311129050936, 231523882, 231523886, 4, 640x360 
0x12CB3460, 36963311129530712, 231523932, 231523935, 3, 640x360 
0x12CB3460, 36963311129851064, 231523962, 231523965, 3, 640x360 
0x12CB3460, 36963311130169776, 231523992, 231523994, 2, 640x360 
0x12CB3460, 36963311130490904, 231524022, 231524026, 4, 640x360 
0x12CB3460, 36963311130812432, 231524062, 231524064, 2, 640x360 
0x12CB3460, 36963311131130488, 231524091, 231524093, 2, 640x360 
0x12CB3460, 36963311131450592, 231524121, 231524124, 3, 640x360 
0x12CB3460, 36963311131770064, 231524151, 231524154, 3, 640x360 
0x12CB3460, 36963311132088944, 231524182, 231524186, 4, 640x360 
0x12CB3460, 36963311132410000, 231524222, 231524225, 3, 640x360 
0x12CB3460, 36963311132730184, 231524251, 231524254, 3, 640x360 
0x12CB3460, 36963311133050624, 231524282, 231524285, 3, 640x360 
0x12CB3460, 36963311133531544, 231524331, 231524334, 3, 640x360 
0x12CB3460, 36963311133850128, 231524373, 231524376, 3, 640x360 
0x12CB3460, 36963311134169976, 231524391, 231524394, 3, 640x360 
0x12CB3460, 36963311134490632, 231524431, 231524435, 4, 640x360 
0x12CB3460, 36963311134810848, 231524462, 231524464, 2, 640x360 
0x12CB3460, 36963311135130576, 231524491, 231524493, 2, 640x360 
0x12CB3460, 36963311135452048, 231524522, 231524525, 3, 640x360 
0x12CB3460, 36963311135769680, 231524552, 231524554, 2, 640x360 
0x12CB3460, 36963311136090504, 231524585, 231524588, 3, 640x360 
0x12CB3460, 36963311136410312, 231524622, 231524624, 2, 640x360 
0x12CB3460, 36963311136733104, 231524652, 231524656, 4, 640x360 
0x12CB3460, 36963311137213536, 231524701, 231524704, 3, 640x360 
0x12CB3460, 36963311137528824, 231524732, 231524736, 4, 640x360 
0x12CB3460, 36963311137848960, 231524761, 231524764, 3, 640x360 
0x12CB3460, 36963311138170792, 231524792, 231524794, 2, 640x360 
0x12CB3460, 36963311138489952, 231524833, 231524836, 3, 640x360 
0x12CB3460, 36963311138809816, 231524880, 231524883, 3, 640x360 
0x12CB3460, 36963311139131088, 231524891, 231524896, 5, 640x360 
0x12CB3460, 36963311139448920, 231524922, 231524924, 2, 640x360 
0x12CB3460, 36963311139770424, 231524951, 231524954, 3, 640x360 
0x12CB3460, 36963311140090480, 231524982, 231524986, 4, 640x360 
0x12CB3460, 36963311140409400, 231525021, 231525024, 3, 640x360 
0x12CB3460, 36963311140730920, 231525052, 231525055, 3, 640x360 
0x12CB3460, 36963311141208512, 231525101, 231525104, 3, 640x360 
0x12CB3460, 36963311141530696, 231525132, 231525135, 3, 640x360 
0x12CB3460, 36963311141849496, 231525162, 231525165, 3, 640x360 
0x12CB3460, 36963311142172560, 231525192, 231525195, 3, 640x360 
0x12CB3460, 36963311142491288, 231525223, 231525227, 4, 640x360 
0x12CB3460, 36963311142809904, 231525262, 231525264, 2, 640x360 
0x12CB3460, 36963311143130816, 231525291, 231525293, 2, 640x360 
0x12CB3460, 36963311143451344, 231525322, 231525330, 8, 640x360 
0x12CB3460, 36963311143770984, 231525373, 231525376, 3, 640x360 
0x12CB3460, 36963311144089880, 231525384, 231525387, 3, 640x360 
0x12CB3460, 36963311144410480, 231525421, 231525434, 13, 640x360 
0x12CB3460, 36963311144729960, 231525451, 231525455, 4, 640x360 
0x12CB3460, 36963311145210000, 231525503, 231525506, 3, 640x360 
0x12CB3460, 36963311145534608, 231525533, 231525536, 3, 640x360 
0x12CB3460, 36963311145854304, 231525562, 231525566, 4, 640x360 
0x12CB3460, 36963311146170384, 231525593, 231525595, 2, 640x360 
0x12CB3460, 36963311146490832, 231525631, 231525634, 3, 640x360 
0x12CB3460, 36963311146810184, 231525662, 231525665, 3, 640x360 
0x12CB3460, 36963311147130000, 231525691, 231525694, 3, 640x360 
0x12CB3460, 36963311147450696, 231525722, 231525726, 4, 640x360 
0x12CB3460, 36963311147768824, 231525752, 231525754, 2, 640x360 
0x12CB3460, 36963311148089648, 231525783, 231525786, 3, 640x360 
0x12CB3460, 36963311148410136, 231525821, 231525824, 3, 640x360 
0x12CB3460, 36963311148891024, 231525873, 231525876, 3, 640x360 
0x12CB3460, 36963311149208472, 231525901, 231525903, 2, 640x360 
0x12CB3460, 36963311149530488, 231525932, 231525935, 3, 640x360 
0x12CB3460, 36963311149849424, 231525961, 231525964, 3, 640x360 
0x12CB3460, 36963311150171240, 231525993, 231525996, 3, 640x360 
0x12CB3460, 36963311150492104, 231526032, 231526036, 4, 640x360 
0x12CB3460, 36963311150809584, 231526061, 231526064, 3, 640x360 
0x12CB3460, 36963311151130384, 231526092, 231526094, 2, 640x360 
0x12CB3460, 36963311151450368, 231526121, 231526134, 13, 640x360 
0x12CB3460, 36963311151770816, 231526152, 231526155, 3, 640x360 
0x12CB3460, 36963311152091160, 231526182, 231526186, 4, 640x360 
0x12CB3460, 36963311152410768, 231526222, 231526225, 3, 640x360 
0x12CB3460, 36963311152890368, 231526262, 231526265, 3, 640x360 
0x12CB3460, 36963311153210808, 231526302, 231526304, 2, 640x360 
0x12CB3460, 36963311153531672, 231526331, 231526334, 3, 640x360 
0x12CB3460, 36963311153852056, 231526380, 231526383, 3, 640x360 
0x12CB3460, 36963311154170152, 231526391, 231526395, 4, 640x360 
0x12CB3460, 36963311154490376, 231526422, 231526425, 3, 640x360 
0x12CB3460, 36963311154810816, 231526461, 231526464, 3, 640x360 
0x12CB3460, 36963311155128912, 231526492, 231526494, 2, 640x360 
0x12CB3460, 36963311155451016, 231526522, 231526524, 2, 640x360 
0x12CB3460, 36963311155770584, 231526552, 231526555, 3, 640x360 
0x12CB3460, 36963311156090584, 231526583, 231526587, 4, 640x360 
0x12CB3460, 36963311156411200, 231526623, 231526626, 3, 640x360 
0x12CB3460, 36963311156891504, 231526671, 231526674, 3, 640x360 
0x12CB3460, 36963311157212496, 231526701, 231526704, 3, 640x360 
0x12CB3460, 36963311157529632, 231526733, 231526736, 3, 640x360 
0x12CB3460, 36963311157850280, 231526761, 231526764, 3, 640x360 
0x12CB3460, 36963311158169440, 231526793, 231526795, 2, 640x360 
0x12CB3460, 36963311158489752, 231526822, 231526825, 3, 640x360 
0x12CB3460, 36963311158810688, 231526877, 231526880, 3, 640x360 
0x12CB3460, 36963311159129384, 231526892, 231526895, 3, 640x360 
0x12CB3460, 36963311159450064, 231526921, 231526924, 3, 640x360 
0x12CB3460, 36963311159769520, 231526952, 231526955, 3, 640x360 
0x12CB3460, 36963311160089904, 231526992, 231526996, 4, 640x360 
0x12CB3460, 36963311160572912, 231527033, 231527036, 3, 640x360 
0x12CB3460, 36963311160888440, 231527062, 231527066, 4, 640x360 
0x12CB3460, 36963311161209360, 231527102, 231527105, 3, 640x360 
0x12CB3460, 36963311161530640, 231527131, 231527134, 3, 640x360 
0x12CB3460, 36963311161851200, 231527162, 231527165, 3, 640x360 
0x12CB3460, 36963311162172040, 231527192, 231527196, 4, 640x360 
0x12CB3460, 36963311162490952, 231527223, 231527227, 4, 640x360 
0x12CB3460, 36963311162808808, 231527262, 231527265, 3, 640x360 
0x12CB3460, 36963311163129936, 231527292, 231527294, 2, 640x360 
0x12CB3460, 36963311163450800, 231527322, 231527325, 3, 640x360 
0x12CB3460, 36963311163770896, 231527378, 231527383, 5, 640x360 
0x12CB3460, 36963311164090816, 231527385, 231527388, 3, 640x360 
0x12CB3460, 36963311164570168, 231527432, 231527435, 3, 640x360 
0x12CB3460, 36963311164891888, 231527472, 231527476, 4, 640x360 
0x12CB3460, 36963311165212512, 231527502, 231527505, 3, 640x360 
0x12CB3460, 36963311165531224, 231527532, 231527535, 3, 640x360 
0x12CB3460, 36963311165849136, 231527562, 231527564, 2, 640x360 
0x12CB3460, 36963311166170720, 231527591, 231527595, 4, 640x360 
0x12CB3460, 36963311166490032, 231527622, 231527626, 4, 640x360 
0x12CB3460, 36963311166811832, 231527662, 231527665, 3, 640x360 
0x12CB3460, 36963311167132240, 231527692, 231527695, 3, 640x360 
0x12CB3460, 36963311167449576, 231527722, 231527726, 4, 640x360 
0x12CB3460, 36963311167769200, 231527753, 231527755, 2, 640x360 
0x12CB3460, 36963311168090144, 231527783, 231527786, 3, 640x360 
0x12CB3460, 36963311168571968, 231527833, 231527836, 3, 640x360 
0x12CB3460, 36963311168891376, 231527884, 231527886, 2, 640x360 
0x12CB3460, 36963311169210520, 231527902, 231527906, 4, 640x360 
0x12CB3460, 36963311169528720, 231527931, 231527934, 3, 640x360 
0x12CB3460, 36963311169850896, 231527962, 231527964, 2, 640x360 
0x12CB3460, 36963311170171408, 231527993, 231527996, 3, 640x360 
0x12CB3460, 36963311170491656, 231528032, 231528035, 3, 640x360 
0x12CB3460, 36963311170810000, 231528055, 231528062, 7, 640x360 
0x12CB3460, 36963311171129920, 231528091, 231528094, 3, 640x360 
0x12CB3460, 36963311171449784, 231528122, 231528124, 2, 640x360 
0x12CB3460, 36963311171770712, 231528151, 231528154, 3, 640x360 
0x12CB3460, 36963311172250104, 231528202, 231528204, 2, 640x360 
0x12CB3460, 36963311172568504, 231528233, 231528236, 3, 640x360 
0x12CB3460, 36963311172890264, 231528262, 231528266, 4, 640x360 
0x12CB3460, 36963311173210664, 231528301, 231528304, 3, 640x360 
0x12CB3460, 36963311173531304, 231528332, 231528335, 3, 640x360 
0x12CB3460, 36963311173852696, 231528384, 231528387, 3, 640x360 
0x12CB3460, 36963311174168824, 231528393, 231528396, 3, 640x360 
0x12CB3460, 36963311174488736, 231528422, 231528426, 4, 640x360 
0x12CB3460, 36963311174809440, 231528461, 231528464, 3, 640x360 
0x12CB3460, 36963311175131464, 231528492, 231528495, 3, 640x360 
0x12CB3460, 36963311175451352, 231528522, 231528534, 12, 640x360 
0x12CB3460, 36963311175774280, 231528562, 231528565, 3, 640x360 
0x12CB3460, 36963311176251016, 231528602, 231528605, 3, 640x360 
0x12CB3460, 36963311176569752, 231528631, 231528635, 4, 640x360 
0x12CB3460, 36963311176893120, 231528663, 231528666, 3, 640x360 
0x12CB3460, 36963311177209664, 231528702, 231528705, 3, 640x360 
0x12CB3460, 36963311177529384, 231528732, 231528735, 3, 640x360 
0x12CB3460, 36963311177850144, 231528761, 231528763, 2, 640x360 
0x12CB3460, 36963311178170592, 231528792, 231528794, 2, 640x360 
0x12CB3460, 36963311178491368, 231528832, 231528835, 3, 640x360 
0x12CB3460, 36963311178811616, 231528881, 231528885, 4, 640x360 
0x12CB3460, 36963311179130616, 231528891, 231528897, 6, 640x360 
0x12CB3460, 36963311179449920, 231528922, 231528924, 2, 640x360 
0x12CB3460, 36963311179930464, 231528972, 231528974, 2, 640x360 
0x12CB3460, 36963311180251128, 231529002, 231529005, 3, 640x360 
0x12CB3460, 36963311180569920, 231529032, 231529036, 4, 640x360 
0x12CB3460, 36963311180889984, 231529063, 231529077, 14, 640x360 
0x12CB3460, 36963311181210320, 231529102, 231529104, 2, 640x360 
0x12CB3460, 36963311181530680, 231529132, 231529135, 3, 640x360 
0x12CB3460, 36963311181852640, 231529163, 231529166, 3, 640x360 
0x12CB3460, 36963311182170376, 231529193, 231529197, 4, 640x360 
0x12CB3460, 36963311182488552, 231529222, 231529226, 4, 640x360 
0x12CB3460, 36963311182811832, 231529262, 231529264, 2, 640x360 
0x12CB3460, 36963311183132144, 231529291, 231529294, 3, 640x360 
0x12CB3460, 36963311183451544, 231529321, 231529325, 4, 640x360 
0x12CB3460, 36963311183935680, 231529390, 231529395, 5, 640x360 
0x12CB3460, 36963311184248840, 231529401, 231529405, 4, 640x360 
0x12CB3460, 36963311184569992, 231529432, 231529435, 3, 640x360 
0x12CB3460, 36963311184888856, 231529472, 231529474, 2, 640x360 
0x12CB3460, 36963311185210264, 231529502, 231529505, 3, 640x360 
0x12CB3460, 36963311185530272, 231529531, 231529535, 4, 640x360 
0x12CB3460, 36963311185852568, 231529563, 231529566, 3, 640x360 
0x12CB3460, 36963311186170560, 231529592, 231529595, 3, 640x360 
0x12CB3460, 36963311186491600, 231529632, 231529636, 4, 640x360 
0x12CB3460, 36963311186810472, 231529661, 231529664, 3, 640x360 
0x12CB3460, 36963311187129632, 231529691, 231529694, 3, 640x360 
0x12CB3460, 36963311187450552, 231529721, 231529723, 2, 640x360 
0x12CB3460, 36963311187930072, 231529772, 231529775, 3, 640x360 
0x12CB3460, 36963311188250512, 231529801, 231529804, 3, 640x360 
0x12CB3460, 36963311188569080, 231529833, 231529836, 3, 640x360 
0x12CB3460, 36963311188892296, 231529876, 231529879, 3, 640x360 
0x12CB3460, 36963311189209424, 231529901, 231529903, 2, 640x360 
0x12CB3460, 36963311189530032, 231529931, 231529935, 4, 640x360 
0x12CB3460, 36963311189850832, 231529961, 231529964, 3, 640x360 
0x12CB3460, 36963311190171064, 231529992, 231529995, 3, 640x360 
0x12CB3460, 36963311190490192, 231530031, 231530037, 6, 640x360 
0x12CB3460, 36963311190810400, 231530062, 231530065, 3, 640x360 
0x12CB3460, 36963311191129280, 231530091, 231530094, 3, 640x360 
0x12CB3460, 36963311191609512, 231530142, 231530145, 3, 640x360 
0x12CB3460, 36963311191929600, 231530171, 231530174, 3, 640x360 
0x12CB3460, 36963311192249536, 231530202, 231530204, 2, 640x360 
0x12CB3460, 36963311192571512, 231530231, 231530236, 5, 640x360 
0x12CB3460, 36963311192890064, 231530262, 231530265, 3, 640x360 
0x12CB3460, 36963311193209168, 231530301, 231530304, 3, 640x360 
0x12CB3460, 36963311193530568, 231530331, 231530334, 3, 640x360 
0x12CB3460, 36963311193850336, 231530376, 231530380, 4, 640x360 
0x12CB3460, 36963311194168568, 231530392, 231530395, 3, 640x360 
0x12CB3460, 36963311194489256, 231530422, 231530426, 4, 640x360 
0x12CB3460, 36963311194810224, 231530462, 231530464, 2, 640x360 
0x12CB3460, 36963311195129168, 231530491, 231530494, 3, 640x360 
0x12CB3460, 36963311195611264, 231530542, 231530558, 16, 640x360 
0x12CB3460, 36963311195928848, 231530571, 231530574, 3, 640x360 
0x12CB3460, 36963311196251528, 231530602, 231530604, 2, 640x360 
0x12CB3460, 36963311196570104, 231530632, 231530636, 4, 640x360 
0x12CB3460, 36963311196890552, 231530672, 231530676, 4, 640x360 
0x12CB3460, 36963311197214688, 231530701, 231530705, 4, 640x360 
0x12CB3460, 36963311197529768, 231530731, 231530734, 3, 640x360 
0x12CB3460, 36963311197848328, 231530761, 231530764, 3, 640x360 
0x12CB3460, 36963311198170000, 231530792, 231530794, 2, 640x360 
0x12CB3460, 36963311198489560, 231530832, 231530835, 3, 640x360 
0x12CB3460, 36963311198812048, 231530884, 231530887, 3, 640x360 
0x12CB3460, 36963311199130600, 231530892, 231530895, 3, 640x360 
0x12CB3460, 36963311199611080, 231530941, 231530944, 3, 640x360 
0x12CB3460, 36963311199930504, 231530971, 231530974, 3, 640x360 
0x12CB3460, 36963311200251352, 231531003, 231531005, 2, 640x360 
0x12CB3460, 36963311200570384, 231531033, 231531052, 19, 640x360 
0x12CB3460, 36963311200890080, 231531065, 231531068, 3, 640x360 
0x12CB3460, 36963311201209112, 231531101, 231531103, 2, 640x360 
0x12CB3460, 36963311201529248, 231531131, 231531135, 4, 640x360 
0x12CB3460, 36963311201849168, 231531161, 231531164, 3, 640x360 
0x12CB3460, 36963311202171232, 231531192, 231531195, 3, 640x360 
0x12CB3460, 36963311202489216, 231531222, 231531226, 4, 640x360 
0x12CB3460, 36963311202809648, 231531262, 231531265, 3, 640x360 
0x12CB3460, 36963311203289368, 231531302, 231531305, 3, 640x360 
0x12CB3460, 36963311203612440, 231531342, 231531346, 4, 640x360 
0x12CB3460, 36963311203931168, 231531375, 231531378, 3, 640x360 
0x12CB3460, 36963311204249864, 231531401, 231531404, 3, 640x360 
0x12CB3460, 36963311204570200, 231531432, 231531435, 3, 640x360 
0x12CB3460, 36963311204890592, 231531462, 231531466, 4, 640x360 
0x12CB3460, 36963311205209704, 231531502, 231531506, 4, 640x360 
0x12CB3460, 36963311205532608, 231531532, 231531536, 4, 640x360 
0x12CB3460, 36963311205855504, 231531563, 231531567, 4, 640x360 
0x12CB3460, 36963311206173560, 231531592, 231531595, 3, 640x360 
0x12CB3460, 36963311206489352, 231531622, 231531626, 4, 640x360 
0x12CB3460, 36963311206811384, 231531662, 231531665, 3, 640x360 
0x12CB3460, 36963311207291320, 231531712, 231531715, 3, 640x360 
0x12CB3460, 36963311207611912, 231531742, 231531745, 3, 640x360 
0x12CB3460, 36963311207928600, 231531772, 231531774, 2, 640x360 
0x12CB3460, 36963311208250800, 231531802, 231531805, 3, 640x360 
0x12CB3460, 36963311208575184, 231531833, 231531837, 4, 640x360 
0x12CB3460, 36963311208892024, 231531877, 231531880, 3, 640x360 
0x12CB3460, 36963311209210032, 231531901, 231531903, 2, 640x360 
0x12CB3460, 36963311209529568, 231531931, 231531935, 4, 640x360 
0x12CB3460, 36963311209848872, 231531961, 231531963, 2, 640x360 
0x12CB3460, 36963311210169704, 231531992, 231531995, 3, 640x360 
0x12CB3460, 36963311210491200, 231532023, 231532026, 3, 640x360 
0x12CB3460, 36963311210969512, 231532072, 231532075, 3, 640x360 
0x12CB3460, 36963311211289936, 231532112, 231532115, 3, 640x360 
0x12CB3460, 36963311211608808, 231532142, 231532144, 2, 640x360 
0x12CB3460, 36963311211928408, 231532173, 231532175, 2, 640x360 
0x12CB3460, 36963311212248920, 231532202, 231532205, 3, 640x360 
0x12CB3460, 36963311212570592, 231532231, 231532235, 4, 640x360 
0x12CB3460, 36963311212889600, 231532271, 231532274, 3, 640x360 
0x12CB3460, 36963311213208632, 231532301, 231532304, 3, 640x360 
0x12CB3460, 36963311213529704, 231532331, 231532334, 3, 640x360 
0x12CB3460, 36963311213849968, 231532386, 231532390, 4, 640x360 
0x12CB3460, 36963311214170648, 231532393, 231532397, 4, 640x360 
0x12CB3460, 36963311214488608, 231532422, 231532426, 4, 640x360 
0x12CB3460, 36963311214968976, 231532472, 231532475, 3, 640x360 
0x12CB3460, 36963311215291152, 231532512, 231532515, 3, 640x360 
0x12CB3460, 36963311215613520, 231532542, 231532545, 3, 640x360 
0x12CB3460, 36963311215930288, 231532571, 231532574, 3, 640x360 
0x12CB3460, 36963311216250776, 231532602, 231532604, 2, 640x360 
0x12CB3460, 36963311216571840, 231532631, 231532635, 4, 640x360 
0x12CB3460, 36963311216893568, 231532672, 231532676, 4, 640x360 
0x12CB3460, 36963311217209952, 231532703, 231532706, 3, 640x360 
0x12CB3460, 36963311217529184, 231532731, 231532735, 4, 640x360 
0x12CB3460, 36963311217849104, 231532761, 231532764, 3, 640x360 
0x12CB3460, 36963311218169096, 231532791, 231532794, 3, 640x360 
0x12CB3460, 36963311218489520, 231532822, 231532825, 3, 640x360 
0x12CB3460, 36963311218968968, 231532880, 231532883, 3, 640x360 
0x12CB3460, 36963311219288048, 231532902, 231532906, 4, 640x360 
0x12CB3460, 36963311219611272, 231532942, 231532945, 3, 640x360 
0x12CB3460, 36963311219928328, 231532971, 231532974, 3, 640x360 
0x12CB3460, 36963311220249144, 231533002, 231533004, 2, 640x360 
0x12CB3460, 36963311220570048, 231533032, 231533050, 18, 640x360 
0x12CB3460, 36963311220888584, 231533062, 231533067, 5, 640x360 
0x12CB3460, 36963311221209824, 231533101, 231533110, 9, 640x360 
0x12CB3460, 36963311221528992, 231533131, 231533134, 3, 640x360 
0x12CB3460, 36963311221851168, 231533162, 231533165, 3, 640x360 
0x12CB3460, 36963311222172696, 231533193, 231533196, 3, 640x360 
0x12CB3460, 36963311222648424, 231533241, 231533244, 3, 640x360 
0x12CB3460, 36963311222970288, 231533272, 231533274, 2, 640x360 
0x12CB3460, 36963311223290296, 231533311, 231533314, 3, 640x360 
0x12CB3460, 36963311223611128, 231533342, 231533344, 2, 640x360 
0x12CB3460, 36963311223931224, 231533379, 231533382, 3, 640x360 
0x12CB3460, 36963311224249464, 231533401, 231533404, 3, 640x360 
0x12CB3460, 36963311224568664, 231533431, 231533434, 3, 640x360 
0x12CB3460, 36963311224889944, 231533462, 231533466, 4, 640x360 
0x12CB3460, 36963311225209984, 231533502, 231533505, 3, 640x360 
0x12CB3460, 36963311225531680, 231533532, 231533535, 3, 640x360 
0x12CB3460, 36963311225854168, 231533562, 231533566, 4, 640x360 
0x12CB3460, 36963311226170384, 231533592, 231533594, 2, 640x360 
0x12CB3460, 36963311226651096, 231533642, 231533645, 3, 640x360 
0x12CB3460, 36963311226968816, 231533672, 231533675, 3, 640x360 
0x12CB3460, 36963311227289616, 231533703, 231533706, 3, 640x360 
0x12CB3460, 36963311227609112, 231533742, 231533745, 3, 640x360 
0x12CB3460, 36963311227928384, 231533771, 231533774, 3, 640x360 
0x12CB3460, 36963311228249520, 231533801, 231533804, 3, 640x360 
0x12CB3460, 36963311228570648, 231533832, 231533835, 3, 640x360 
0x12CB3460, 36963311228889424, 231533892, 231533896, 4, 640x360 
0x12CB3460, 36963311229209640, 231533901, 231533904, 3, 640x360 
0x12CB3460, 36963311229528328, 231533931, 231533934, 3, 640x360 
0x12CB3460, 36963311229850392, 231533961, 231533964, 3, 640x360 
0x12CB3460, 36963311230169392, 231533992, 231533995, 3, 640x360 
0x12CB3460, 36963311230650472, 231534042, 231534046, 4, 640x360 
0x12CB3460, 36963311230969432, 231534071, 231534074, 3, 640x360 
0x12CB3460, 36963311231289784, 231534112, 231534115, 3, 640x360 
0x12CB3460, 36963311231609528, 231534142, 231534144, 2, 640x360 
0x12CB3460, 36963311231929408, 231534172, 231534174, 2, 640x360 
0x12CB3460, 36963311232248528, 231534201, 231534204, 3, 640x360 
0x12CB3460, 36963311232569656, 231534233, 231534237, 4, 640x360 
0x12CB3460, 36963311232889056, 231534262, 231534266, 4, 640x360 
0x12CB3460, 36963311233209456, 231534301, 231534304, 3, 640x360 
0x12CB3460, 36963311233530016, 231534330, 231534333, 3, 640x360 
0x12CB3460, 36963311233852032, 231534380, 231534383, 3, 640x360 
0x12CB3460, 36963311234329176, 231534411, 231534414, 3, 640x360 
0x12CB3460, 36963311234648848, 231534442, 231534445, 3, 640x360 
0x12CB3460, 36963311234970024, 231534472, 231534474, 2, 640x360 
0x12CB3460, 36963311235290560, 231534503, 231534506, 3, 640x360 
0x12CB3460, 36963311235609824, 231534535, 231534539, 4, 640x360 
0x12CB3460, 36963311235930408, 231534572, 231534574, 2, 640x360 
0x12CB3460, 36963311236248504, 231534601, 231534605, 4, 640x360 
0x12CB3460, 36963311236568528, 231534632, 231534634, 2, 640x360 
0x12CB3460, 36963311236889184, 231534662, 231534666, 4, 640x360 
0x12CB3460, 36963311237210232, 231534701, 231534704, 3, 640x360 
0x12CB3460, 36963311237530984, 231534732, 231534735, 3, 640x360 
0x12CB3460, 36963311237849928, 231534761, 231534779, 18, 640x360 
0x12CB3460, 36963311238330912, 231534811, 231534814, 3, 640x360 
0x12CB3460, 36963311238651632, 231534843, 231534846, 3, 640x360 
0x12CB3460, 36963311238971216, 231534879, 231534883, 4, 640x360 
0x12CB3460, 36963311239288144, 231534902, 231534905, 3, 640x360 
0x12CB3460, 36963311239608968, 231534942, 231534945, 3, 640x360 
0x12CB3460, 36963311239929560, 231534971, 231534974, 3, 640x360 
0x12CB3460, 36963311240249832, 231535002, 231535005, 3, 640x360 
0x12CB3460, 36963311240568848, 231535032, 231535035, 3, 640x360 
0x12CB3460, 36963311240890376, 231535071, 231535074, 3, 640x360 
0x12CB3460, 36963311241209168, 231535101, 231535104, 3, 640x360 
0x12CB3460, 36963311241529768, 231535132, 231535135, 3, 640x360 
0x12CB3460, 36963311241850952, 231535161, 231535164, 3, 640x360 
0x12CB3460, 36963311242331064, 231535212, 231535215, 3, 640x360 
0x12CB3460, 36963311242648544, 231535241, 231535244, 3, 640x360 
0x12CB3460, 36963311242968544, 231535272, 231535274, 2, 640x360 
0x12CB3460, 36963311243291184, 231535312, 231535315, 3, 640x360 
0x12CB3460, 36963311243609840, 231535342, 231535346, 4, 640x360 
0x12CB3460, 36963311243931752, 231535384, 231535387, 3, 640x360 
0x12CB3460, 36963311244249296, 231535401, 231535405, 4, 640x360 
0x12CB3460, 36963311244568560, 231535432, 231535435, 3, 640x360 
0x12CB3460, 36963311244890040, 231535472, 231535475, 3, 640x360 
0x12CB3460, 36963311245209432, 231535501, 231535504, 3, 640x360 
0x12CB3460, 36963311245530544, 231535531, 231535534, 3, 640x360 
0x12CB3460, 36963311246012744, 231535582, 231535588, 6, 640x360 
0x12CB3460, 36963311246328896, 231535612, 231535615, 3, 640x360 
0x12CB3460, 36963311246653696, 231535643, 231535646, 3, 640x360 
0x12CB3460, 36963311246969312, 231535673, 231535676, 3, 640x360 
0x12CB3460, 36963311247290768, 231535712, 231535715, 3, 640x360 
0x12CB3460, 36963311247609304, 231535735, 231535740, 5, 640x360 
0x12CB3460, 36963311247929120, 231535772, 231535775, 3, 640x360 
0x12CB3460, 36963311248248496, 231535801, 231535804, 3, 640x360 
0x12CB3460, 36963311248569056, 231535831, 231535835, 4, 640x360 
0x12CB3460, 36963311248891592, 231535887, 231535897, 10, 640x360 
0x12CB3460, 36963311249210128, 231535898, 231535903, 5, 640x360 
0x12CB3460, 36963311249529712, 231535931, 231535934, 3, 640x360 
0x12CB3460, 36963311250008800, 231535982, 231535985, 3, 640x360 
0x12CB3460, 36963311250329992, 231536012, 231536015, 3, 640x360 
0x12CB3460, 36963311250652216, 231536042, 231536059, 17, 640x360 
0x12CB3460, 36963311250969760, 231536072, 231536075, 3, 640x360 
0x12CB3460, 36963311251289672, 231536111, 231536114, 3, 640x360 
0x12CB3460, 36963311251609456, 231536142, 231536144, 2, 640x360 
0x12CB3460, 36963311251929272, 231536172, 231536174, 2, 640x360 
0x12CB3460, 36963311252249352, 231536201, 231536209, 8, 640x360 
0x12CB3460, 36963311252570320, 231536232, 231536239, 7, 640x360 
0x12CB3460, 36963311252889032, 231536262, 231536266, 4, 640x360 
0x12CB3460, 36963311253208568, 231536302, 231536305, 3, 640x360 
0x12CB3460, 36963311253689824, 231536343, 231536347, 4, 640x360 
0x12CB3460, 36963311254009568, 231536381, 231536385, 4, 640x360 
0x12CB3460, 36963311254329808, 231536411, 231536414, 3, 640x360 
0x12CB3460, 36963311254650208, 231536441, 231536444, 3, 640x360 
0x12CB3460, 36963311254968656, 231536472, 231536475, 3, 640x360 
0x12CB3460, 36963311255290424, 231536512, 231536516, 4, 640x360 
0x12CB3460, 36963311255611736, 231536542, 231536545, 3, 640x360 
0x12CB3460, 36963311255930768, 231536571, 231536574, 3, 640x360 
0x12CB3460, 36963311256250304, 231536602, 231536605, 3, 640x360 
0x12CB3460, 36963311256570816, 231536631, 231536635, 4, 640x360 
0x12CB3460, 36963311256893920, 231536672, 231536676, 4, 640x360 
0x12CB3460, 36963311257210784, 231536703, 231536710, 7, 640x360 
0x12CB3460, 36963311257689512, 231536743, 231536759, 16, 640x360 
0x12CB3460, 36963311258008176, 231536781, 231536784, 3, 640x360 
0x12CB3460, 36963311258328648, 231536811, 231536814, 3, 640x360 
0x12CB3460, 36963311258651112, 231536842, 231536845, 3, 640x360 
0x12CB3460, 36963311258969872, 231536887, 231536890, 3, 640x360 
0x12CB3460, 36963311259288136, 231536912, 231536914, 2, 640x360 
0x12CB3460, 36963311259608664, 231536941, 231536944, 3, 640x360 
0x12CB3460, 36963311259928976, 231536972, 231536975, 3, 640x360 
0x12CB3460, 36963311260248080, 231537001, 231537004, 3, 640x360 
0x12CB3460, 36963311260567952, 231537032, 231537035, 3, 640x360 
0x12CB3460, 36963311260889416, 231537062, 231537066, 4, 640x360 
0x12CB3460, 36963311261209640, 231537101, 231537110, 9, 640x360 
0x12CB3460, 36963311261690040, 231537142, 231537146, 4, 640x360 
0x12CB3460, 36963311262011624, 231537182, 231537185, 3, 640x360 
0x12CB3460, 36963311262330344, 231537211, 231537214, 3, 640x360 
0x12CB3460, 36963311262650072, 231537243, 231537246, 3, 640x360 
0x12CB3460, 36963311262968664, 231537271, 231537274, 3, 640x360 
0x12CB3460, 36963311263289936, 231537311, 231537314, 3, 640x360 
0x12CB3460, 36963311263610128, 231537342, 231537345, 3, 640x360 
0x12CB3460, 36963311263930720, 231537380, 231537384, 4, 640x360 
0x12CB3460, 36963311264248824, 231537401, 231537404, 3, 640x360 
0x12CB3460, 36963311264569400, 231537431, 231537434, 3, 640x360 
0x12CB3460, 36963311264890096, 231537462, 231537466, 4, 640x360 
0x12CB3460, 36963311265371344, 231537512, 231537515, 3, 640x360 
0x12CB3460, 36963311265692664, 231537552, 231537555, 3, 640x360 
0x12CB3460, 36963311266011808, 231537584, 231537587, 3, 640x360 
0x12CB3460, 36963311266331008, 231537612, 231537615, 3, 640x360 
0x12CB3460, 36963311266653088, 231537643, 231537646, 3, 640x360 
0x12CB3460, 36963311266970888, 231537672, 231537675, 3, 640x360 
0x12CB3460, 36963311267290560, 231537712, 231537715, 3, 640x360 
0x12CB3460, 36963311267612808, 231537737, 231537740, 3, 640x360 
0x12CB3460, 36963311267927416, 231537771, 231537775, 4, 640x360 
0x12CB3460, 36963311268248824, 231537801, 231537808, 7, 640x360 
0x12CB3460, 36963311268568712, 231537831, 231537835, 4, 640x360 
0x12CB3460, 36963311268891600, 231537876, 231537879, 3, 640x360 
0x12CB3460, 36963311269367408, 231537912, 231537915, 3, 640x360 
0x12CB3460, 36963311269689168, 231537952, 231537954, 2, 640x360 
0x12CB3460, 36963311270009928, 231537982, 231537986, 4, 640x360 
0x12CB3460, 36963311270328592, 231538013, 231538019, 6, 640x360 
0x12CB3460, 36963311270649088, 231538041, 231538045, 4, 640x360 
0x12CB3460, 36963311270968272, 231538071, 231538074, 3, 640x360 
0x12CB3460, 36963311271288968, 231538102, 231538105, 3, 640x360 
0x12CB3460, 36963311271610168, 231538141, 231538144, 3, 640x360 
0x12CB3460, 36963311271929728, 231538171, 231538174, 3, 640x360 
0x12CB3460, 36963311272247528, 231538201, 231538204, 3, 640x360 
0x12CB3460, 36963311272569880, 231538231, 231538235, 4, 640x360 
0x12CB3460, 36963311272891048, 231538271, 231538274, 3, 640x360 
0x12CB3460, 36963311273367408, 231538310, 231538314, 4, 640x360 
0x12CB3460, 36963311273689352, 231538342, 231538347, 5, 640x360 
0x12CB3460, 36963311274008736, 231538385, 231538388, 3, 640x360 
0x12CB3460, 36963311274328416, 231538411, 231538414, 3, 640x360 
0x12CB3460, 36963311274649056, 231538442, 231538444, 2, 640x360 
0x12CB3460, 36963311274969440, 231538471, 231538475, 4, 640x360 
0x12CB3460, 36963311275290352, 231538511, 231538514, 3, 640x360 
0x12CB3460, 36963311275608400, 231538542, 231538544, 2, 640x360 
0x12CB3460, 36963311275930520, 231538572, 231538575, 3, 640x360 
0x12CB3460, 36963311276249520, 231538601, 231538604, 3, 640x360 
0x12CB3460, 36963311276569064, 231538633, 231538635, 2, 640x360 
0x12CB3460, 36963311277050176, 231538683, 231538686, 3, 640x360 
0x12CB3460, 36963311277368160, 231538714, 231538717, 3, 640x360 
0x12CB3460, 36963311277689696, 231538742, 231538746, 4, 640x360 
0x12CB3460, 36963311278009264, 231538781, 231538784, 3, 640x360 
0x12CB3460, 36963311278329304, 231538812, 231538815, 3, 640x360 
0x12CB3460, 36963311278649064, 231538841, 231538844, 3, 640x360 
0x12CB3460, 36963311278968496, 231538875, 231538878, 3, 640x360 
0x12CB3460, 36963311279287720, 231538902, 231538906, 4, 640x360 
0x12CB3460, 36963311279609664, 231538941, 231538944, 3, 640x360 
0x12CB3460, 36963311279928768, 231538971, 231538973, 2, 640x360 
0x12CB3460, 36963311280249384, 231539002, 231539004, 2, 640x360 
0x12CB3460, 36963311280569192, 231539031, 231539035, 4, 640x360 
0x12CB3460, 36963311281048816, 231539082, 231539085, 3, 640x360 
0x12CB3460, 36963311281368088, 231539111, 231539114, 3, 640x360 
0x12CB3460, 36963311281690440, 231539152, 231539155, 3, 640x360 
0x12CB3460, 36963311282008632, 231539181, 231539184, 3, 640x360 
0x12CB3460, 36963311282328912, 231539212, 231539215, 3, 640x360 
0x12CB3460, 36963311282649912, 231539242, 231539244, 2, 640x360 
0x12CB3460, 36963311282969512, 231539271, 231539274, 3, 640x360 
0x12CB3460, 36963311283289328, 231539312, 231539314, 2, 640x360 
0x12CB3460, 36963311283609688, 231539341, 231539344, 3, 640x360 
0x12CB3460, 36963311283930384, 231539373, 231539376, 3, 640x360 
0x12CB3460, 36963311284248200, 231539401, 231539404, 3, 640x360 
0x12CB3460, 36963311284568272, 231539432, 231539442, 10, 640x360 
0x12CB3460, 36963311285048880, 231539481, 231539484, 3, 640x360 
0x12CB3460, 36963311285367608, 231539513, 231539517, 4, 640x360 
0x12CB3460, 36963311285689824, 231539553, 231539556, 3, 640x360 
0x12CB3460, 36963311286010368, 231539581, 231539584, 3, 640x360 
0x12CB3460, 36963311286328528, 231539611, 231539614, 3, 640x360 
0x12CB3460, 36963311286651328, 231539642, 231539645, 3, 640x360 
0x12CB3460, 36963311286968480, 231539672, 231539675, 3, 640x360 
0x12CB3460, 36963311287289216, 231539711, 231539714, 3, 640x360 
0x12CB3460, 36963311287610296, 231539741, 231539744, 3, 640x360 
0x12CB3460, 36963311287928704, 231539771, 231539774, 3, 640x360 
0x12CB3460, 36963311288249416, 231539801, 231539804, 3, 640x360 
0x12CB3460, 36963311288729000, 231539882, 231539889, 7, 640x360 
0x12CB3460, 36963311289367352, 231539912, 231539915, 3, 640x360 
0x12CB3460, 36963311289687744, 231539952, 231539954, 2, 640x360 
0x12CB3460, 36963311290009720, 231539981, 231539984, 3, 640x360 
0x12CB3460, 36963311290328672, 231540011, 231540014, 3, 640x360 
0x12CB3460, 36963311290649584, 231540042, 231540060, 18, 640x360 
0x12CB3460, 36963311290968168, 231540072, 231540075, 3, 640x360 
0x12CB3460, 36963311291288144, 231540111, 231540114, 3, 640x360 
0x12CB3460, 36963311291609360, 231540142, 231540145, 3, 640x360 
0x12CB3460, 36963311291929320, 231540172, 231540175, 3, 640x360 
0x12CB3460, 36963311292249368, 231540202, 231540205, 3, 640x360 
0x12CB3460, 36963311292728584, 231540252, 231540254, 2, 640x360 
0x12CB3460, 36963311293048632, 231540281, 231540284, 3, 640x360 
0x12CB3460, 36963311293368896, 231540312, 231540315, 3, 640x360 
0x12CB3460, 36963311293689440, 231540379, 231540383, 4, 640x360 
0x12CB3460, 36963311294123120, 231540392, 231540395, 3, 640x360 
0x12CB3460, 36963311294328456, 231540412, 231540414, 2, 640x360 
0x12CB3460, 36963311294649232, 231540441, 231540459, 18, 640x360 
0x12CB3460, 36963311294968072, 231540472, 231540475, 3, 640x360 
0x12CB3460, 36963311295289888, 231540511, 231540514, 3, 640x360 
0x12CB3460, 36963311295609112, 231540541, 231540545, 4, 640x360 
0x12CB3460, 36963311295931512, 231540572, 231540577, 5, 640x360 
0x12CB3460, 36963311296407336, 231540621, 231540624, 3, 640x360 
0x12CB3460, 36963311296727040, 231540652, 231540657, 5, 640x360 
0x12CB3460, 36963311297048872, 231540682, 231540687, 5, 640x360 
0x12CB3460, 36963311297367560, 231540712, 231540717, 5, 640x360 
0x12CB3460, 36963311297688584, 231540751, 231540754, 3, 640x360 
0x12CB3460, 36963311298011664, 231540781, 231540784, 3, 640x360 
0x12CB3460, 36963311298328808, 231540812, 231540815, 3, 640x360 
0x12CB3460, 36963311298647592, 231540841, 231540846, 5, 640x360 
0x12CB3460, 36963311299081544, 231540882, 231540886, 4, 640x360 
0x12CB3460, 36963311299287504, 231540903, 231540906, 3, 640x360 
0x12CB3460, 36963311299608184, 231540942, 231540945, 3, 640x360 
0x12CB3460, 36963311299928896, 231540971, 231540974, 3, 640x360 
0x12CB3460, 36963311300407288, 231541022, 231541024, 2, 640x360 
0x12CB3460, 36963311300729744, 231541051, 231541054, 3, 640x360 
0x12CB3460, 36963311301048128, 231541082, 231541086, 4, 640x360 
0x12CB3460, 36963311301367992, 231541111, 231541116, 5, 640x360 
0x12CB3460, 36963311301687424, 231541151, 231541153, 2, 640x360 
0x12CB3460, 36963311302013008, 231541182, 231541185, 3, 640x360 
0x12CB3460, 36963311302329928, 231541212, 231541230, 18, 640x360 
0x12CB3460, 36963311302660704, 231541243, 231541246, 3, 640x360 
0x12CB3460, 36963311302971560, 231541272, 231541281, 9, 640x360 
0x12CB3460, 36963311303288168, 231541312, 231541316, 4, 640x360 
0x12CB3460, 36963311303610656, 231541342, 231541345, 3, 640x360 
0x12CB3460, 36963311304088888, 231541392, 231541396, 4, 640x360 
0x12CB3460, 36963311304410232, 231541421, 231541424, 3, 640x360 
0x12CB3460, 36963311304727896, 231541452, 231541454, 2, 640x360 
0x12CB3460, 36963311305048752, 231541482, 231541485, 3, 640x360 
0x12CB3460, 36963311305369344, 231541511, 231541515, 4, 640x360 
0x12CB3460, 36963311305690600, 231541552, 231541555, 3, 640x360 
0x12CB3460, 36963311306010120, 231541581, 231541585, 4, 640x360 
0x12CB3460, 36963311306329080, 231541611, 231541614, 3, 640x360 
0x12CB3460, 36963311306650432, 231541641, 231541644, 3, 640x360 
0x12CB3460, 36963311306970824, 231541671, 231541675, 4, 640x360 
0x12CB3460, 36963311307293632, 231541712, 231541716, 4, 640x360 
0x12CB3460, 36963311307625920, 231541743, 231541758, 15, 640x360 
0x12CB3460, 36963311308087568, 231541791, 231541794, 3, 640x360 
0x12CB3460, 36963311308410168, 231541822, 231541825, 3, 640x360 
0x12CB3460, 36963311308731408, 231541873, 231541877, 4, 640x360 
0x12CB3460, 36963311309060528, 231541885, 231541891, 6, 640x360 
0x12CB3460, 36963311309367960, 231541911, 231541914, 3, 640x360 
0x12CB3460, 36963311309689232, 231541952, 231541955, 3, 640x360 
0x12CB3460, 36963311310008728, 231541982, 231541986, 4, 640x360 
0x12CB3460, 36963311310329616, 231542012, 231542015, 3, 640x360 
0x12CB3460, 36963311310649976, 231542042, 231542045, 3, 640x360 
0x12CB3460, 36963311310967832, 231542072, 231542075, 3, 640x360 
0x12CB3460, 36963311311290648, 231542111, 231542114, 3, 640x360 
0x12CB3460, 36963311311608784, 231542141, 231542159, 18, 640x360 
0x12CB3460, 36963311312088952, 231542183, 231542186, 3, 640x360 
0x12CB3460, 36963311312409320, 231542221, 231542225, 4, 640x360 
0x12CB3460, 36963311312730344, 231542251, 231542254, 3, 640x360 
0x12CB3460, 36963311313048568, 231542281, 231542284, 3, 640x360 
0x12CB3460, 36963311313368504, 231542311, 231542314, 3, 640x360 
0x12CB3460, 36963311313688368, 231542342, 231542369, 27, 640x360 
0x12CB3460, 36963311314019176, 231542381, 231542384, 3, 640x360 
0x12CB3460, 36963311314328584, 231542411, 231542414, 3, 640x360 
0x12CB3460, 36963311314651680, 231542442, 231542460, 18, 640x360 
0x12CB3460, 36963311314969904, 231542471, 231542474, 3, 640x360 
0x12CB3460, 36963311315291472, 231542511, 231542529, 18, 640x360 
0x12CB3460, 36963311315608824, 231542542, 231542546, 4, 640x360 
0x12CB3460, 36963311316150264, 231542591, 231542594, 3, 640x360 
0x12CB3460, 36963311316411416, 231542622, 231542624, 2, 640x360 
0x12CB3460, 36963311316727904, 231542651, 231542654, 3, 640x360 
0x12CB3460, 36963311317049368, 231542682, 231542685, 3, 640x360 
0x12CB3460, 36963311317368304, 231542712, 231542716, 4, 640x360 
0x12CB3460, 36963311317690344, 231542752, 231542755, 3, 640x360 
0x12CB3460, 36963311318008464, 231542781, 231542784, 3, 640x360 
0x12CB3460, 36963311318327936, 231542812, 231542814, 2, 640x360 
0x12CB3460, 36963311318650304, 231542841, 231542844, 3, 640x360 
0x12CB3460, 36963311319092960, 231542891, 231542897, 6, 640x360 
0x12CB3460, 36963311319288424, 231542902, 231542906, 4, 640x360 
0x12CB3460, 36963311319767104, 231542952, 231542954, 2, 640x360 
0x12CB3460, 36963311320088880, 231542991, 231542994, 3, 640x360 
0x12CB3460, 36963311320408912, 231543021, 231543023, 2, 640x360 
0x12CB3460, 36963311320729848, 231543052, 231543055, 3, 640x360 
0x12CB3460, 36963311321048920, 231543081, 231543083, 2, 640x360 
0x12CB3460, 36963311321367432, 231543112, 231543114, 2, 640x360 
0x12CB3460, 36963311321688032, 231543151, 231543154, 3, 640x360 
0x12CB3460, 36963311322008368, 231543181, 231543184, 3, 640x360 
0x12CB3460, 36963311322328688, 231543211, 231543214, 3, 640x360 
0x12CB3460, 36963311322649064, 231543253, 231543256, 3, 640x360 
0x12CB3460, 36963311322968656, 231543272, 231543275, 3, 640x360 
0x12CB3460, 36963311323289448, 231543311, 231543314, 3, 640x360 
0x12CB3460, 36963311324035784, 231543381, 231543386, 5, 640x360 
0x12CB3460, 36963311324088888, 231543392, 231543395, 3, 640x360 
0x12CB3460, 36963311324407896, 231543421, 231543423, 2, 640x360 
0x12CB3460, 36963311324728728, 231543451, 231543454, 3, 640x360 
0x12CB3460, 36963311325049456, 231543481, 231543484, 3, 640x360 
0x12CB3460, 36963311325688000, 231543551, 231543554, 3, 640x360 
0x12CB3460, 36963311326009728, 231543581, 231543584, 3, 640x360 
0x12CB3460, 36963311326328776, 231543611, 231543614, 3, 640x360 
0x12CB3460, 36963311326649960, 231543642, 231543645, 3, 640x360 
0x12CB3460, 36963311326969336, 231543672, 231543674, 2, 640x360 
0x12CB3460, 36963311327450472, 231543722, 231543724, 2, 640x360 
0x12CB3460, 36963311327767080, 231543752, 231543754, 2, 640x360 
0x12CB3460, 36963311328087160, 231543782, 231543785, 3, 640x360 
0x12CB3460, 36963311328408880, 231543821, 231543824, 3, 640x360 
0x12CB3460, 36963311328728256, 231543851, 231543854, 3, 640x360 
0x12CB3460, 36963311329126456, 231543893, 231543895, 2, 640x360 
0x12CB3460, 36963311329367320, 231543912, 231543915, 3, 640x360 
0x12CB3460, 36963311329687480, 231543951, 231543953, 2, 640x360 
0x12CB3460, 36963311330008392, 231543981, 231543984, 3, 640x360 
0x12CB3460, 36963311330329080, 231544012, 231544015, 3, 640x360 
0x12CB3460, 36963311330648576, 231544043, 231544046, 3, 640x360 
0x12CB3460, 36963311330967768, 231544072, 231544075, 3, 640x360 
0x12CB3460, 36963311331447368, 231544121, 231544135, 14, 640x360 
0x12CB3460, 36963311331769904, 231544152, 231544155, 3, 640x360 
0x12CB3460, 36963311332087336, 231544192, 231544195, 3, 640x360 
0x12CB3460, 36963311332412032, 231544222, 231544224, 2, 640x360 
0x12CB3460, 36963311332728040, 231544251, 231544255, 4, 640x360 
0x12CB3460, 36963311333049216, 231544282, 231544284, 2, 640x360 
0x12CB3460, 36963311333370848, 231544312, 231544316, 4, 640x360 
0x12CB3460, 36963311333688112, 231544341, 231544345, 4, 640x360 
0x12CB3460, 36963311334097408, 231544391, 231544394, 3, 640x360 
0x12CB3460, 36963311334328160, 231544412, 231544415, 3, 640x360 
0x12CB3460, 36963311334649232, 231544442, 231544444, 2, 640x360 
0x12CB3460, 36963311334968376, 231544471, 231544474, 3, 640x360 
0x12CB3460, 36963311335537576, 231544534, 231544537, 3, 640x360 
0x12CB3460, 36963311335767624, 231544553, 231544556, 3, 640x360 
0x12CB3460, 36963311336088272, 231544592, 231544595, 3, 640x360 
0x12CB3460, 36963311336408448, 231544621, 231544628, 7, 640x360 
0x12CB3460, 36963311336729664, 231544654, 231544656, 2, 640x360 
0x12CB3460, 36963311337092144, 231544692, 231544697, 5, 640x360 
0x12CB3460, 36963311337372568, 231544714, 231544717, 3, 640x360 
0x12CB3460, 36963311337690152, 231544751, 231544754, 3, 640x360 
0x12CB3460, 36963311338008032, 231544781, 231544783, 2, 640x360 
0x12CB3460, 36963311338329368, 231544811, 231544814, 3, 640x360 
0x12CB3460, 36963311338649400, 231544841, 231544843, 2, 640x360 
0x12CB3460, 36963311339128496, 231544891, 231544894, 3, 640x360 
0x12CB3460, 36963311339451184, 231544921, 231544924, 3, 640x360 
0x12CB3460, 36963311339768336, 231544951, 231544954, 3, 640x360 
0x12CB3460, 36963311340089544, 231544982, 231544987, 5, 640x360 
0x12CB3460, 36963311340409424, 231545022, 231545024, 2, 640x360 
0x12CB3460, 36963311340729256, 231545052, 231545055, 3, 640x360 
0x12CB3460, 36963311341048752, 231545082, 231545088, 6, 640x360 
0x12CB3460, 36963311341367336, 231545111, 231545114, 3, 640x360 
0x12CB3460, 36963311341689544, 231545151, 231545154, 3, 640x360 
0x12CB3460, 36963311342008808, 231545181, 231545184, 3, 640x360 
0x12CB3460, 36963311342329624, 231545212, 231545214, 2, 640x360 
0x12CB3460, 36963311342648504, 231545241, 231545247, 6, 640x360 
0x12CB3460, 36963311343129392, 231545292, 231545294, 2, 640x360 
0x12CB3460, 36963311343449272, 231545321, 231545324, 3, 640x360 
0x12CB3460, 36963311343767328, 231545375, 231545377, 2, 640x360 
0x12CB3460, 36963311344087512, 231545391, 231545394, 3, 640x360 
0x12CB3460, 36963311344414424, 231545421, 231545424, 3, 640x360 
0x12CB3460, 36963311344728568, 231545451, 231545454, 3, 640x360 
0x12CB3460, 36963311345050456, 231545481, 231545485, 4, 640x360 
0x12CB3460, 36963311345367256, 231545521, 231545524, 3, 640x360 
0x12CB3460, 36963311345688600, 231545551, 231545554, 3, 640x360 
0x12CB3460, 36963311346027792, 231545582, 231545591, 9, 640x360 
0x12CB3460, 36963311346328736, 231545612, 231545615, 3, 640x360 
0x12CB3460, 36963311346648328, 231545641, 231545645, 4, 640x360 
0x12CB3460, 36963311347127784, 231545692, 231545694, 2, 640x360 
0x12CB3460, 36963311347448720, 231545723, 231545726, 3, 640x360 
0x12CB3460, 36963311347767128, 231545752, 231545754, 2, 640x360 
0x12CB3460, 36963311348089576, 231545791, 231545794, 3, 640x360 
0x12CB3460, 36963311348408200, 231545820, 231545823, 3, 640x360 
0x12CB3460, 36963311348727792, 231545885, 231545890, 5, 640x360 
0x12CB3460, 36963311349166432, 231545895, 231545898, 3, 640x360 
0x12CB3460, 36963311349453976, 231545922, 231545928, 6, 640x360 
0x12CB3460, 36963311349689944, 231545951, 231545957, 6, 640x360 
0x12CB3460, 36963311350456656, 231546031, 231546037, 6, 640x360 
0x12CB3460, 36963311350830712, 231546062, 231546066, 4, 640x360 
0x12CB3460, 36963311351146192, 231546092, 231546094, 2, 640x360 
0x12CB3460, 36963311351449560, 231546122, 231546125, 3, 640x360 
0x12CB3460, 36963311351769800, 231546153, 231546157, 4, 640x360 
0x12CB3460, 36963311352088552, 231546191, 231546196, 5, 640x360 
0x12CB3460, 36963311352408176, 231546222, 231546225, 3, 640x360 
0x12CB3460, 36963311352728048, 231546253, 231546257, 4, 640x360 
0x12CB3460, 36963311353047656, 231546281, 231546284, 3, 640x360 
0x12CB3460, 36963311353369328, 231546311, 231546315, 4, 640x360 
0x12CB3460, 36963311353688504, 231546343, 231546348, 5, 640x360 
0x12CB3460, 36963311354075248, 231546383, 231546386, 3, 640x360 
0x12CB3460, 36963311354329488, 231546411, 231546415, 4, 640x360 
0x12CB3460, 36963311354807352, 231546462, 231546465, 3, 640x360 
0x12CB3460, 36963311355131952, 231546491, 231546495, 4, 640x360 
0x12CB3460, 36963311355449528, 231546522, 231546540, 18, 640x360 
0x12CB3460, 36963311355768280, 231546552, 231546555, 3, 640x360 
0x12CB3460, 36963311356088080, 231546593, 231546598, 5, 640x360 
0x12CB3460, 36963311356408200, 231546621, 231546624, 3, 640x360 
0x12CB3460, 36963311356728496, 231546652, 231546655, 3, 640x360 
0x12CB3460, 36963311357049424, 231546681, 231546685, 4, 640x360 
0x12CB3460, 36963311357368720, 231546712, 231546715, 3, 640x360 
0x12CB3460, 36963311357690920, 231546751, 231546754, 3, 640x360 
0x12CB3460, 36963311358055872, 231546782, 231546785, 3, 640x360 
0x12CB3460, 36963311358329000, 231546811, 231546814, 3, 640x360 
0x12CB3460, 36963311358809208, 231546879, 231546883, 4, 640x360 
0x12CB3460, 36963311359130408, 231546891, 231546895, 4, 640x360 
0x12CB3460, 36963311359448792, 231546921, 231546925, 4, 640x360 
0x12CB3460, 36963311359768424, 231546952, 231546955, 3, 640x360 
0x12CB3460, 36963311360088792, 231546992, 231547003, 11, 640x360 
0x12CB3460, 36963311360418816, 231547021, 231547023, 2, 640x360 
0x12CB3460, 36963311360728496, 231547052, 231547055, 3, 640x360 
0x12CB3460, 36963311361127136, 231547093, 231547101, 8, 640x360 
0x12CB3460, 36963311361369160, 231547121, 231547123, 2, 640x360 
0x12CB3460, 36963311361689344, 231547151, 231547154, 3, 640x360 
0x12CB3460, 36963311362008520, 231547181, 231547183, 2, 640x360 
0x12CB3460, 36963311362487488, 231547231, 231547236, 5, 640x360 
0x12CB3460, 36963311362835552, 231547263, 231547266, 3, 640x360 
0x12CB3460, 36963311363128336, 231547291, 231547294, 3, 640x360 
0x12CB3460, 36963311363719192, 231547352, 231547390, 38, 640x360 
0x12CB3460, 36963311364175904, 231547401, 231547405, 4, 640x360 
0x12CB3460, 36963311364411280, 231547422, 231547424, 2, 640x360 
0x12CB3460, 36963311364727600, 231547452, 231547455, 3, 640x360 
0x12CB3460, 36963311365086680, 231547482, 231547488, 6, 640x360 
0x12CB3460, 36963311365403312, 231547522, 231547541, 19, 640x360 
0x12CB3460, 36963311365701072, 231547551, 231547554, 3, 640x360 
0x12CB3460, 36963311366050624, 231547592, 231547594, 2, 640x360 
0x12CB3460, 36963311366487224, 231547633, 231547638, 5, 640x360 
0x12CB3460, 36963311366807560, 231547661, 231547664, 3, 640x360 
0x12CB3460, 36963311367127528, 231547691, 231547694, 3, 640x360 
0x12CB3460, 36963311367450832, 231547724, 231547748, 24, 640x360 
0x12CB3460, 36963311367773640, 231547776, 231547789, 13, 640x360 
0x12CB3460, 36963311368090808, 231547790, 231547814, 24, 640x360 
0x12CB3460, 36963311368436512, 231547821, 231547825, 4, 640x360 
0x12CB3460, 36963311368731192, 231547884, 231547889, 5, 640x360 
0x12CB3460, 36963311369175400, 231547893, 231547899, 6, 640x360 
0x12CB3460, 36963311369369176, 231547921, 231547923, 2, 640x360 
0x12CB3460, 36963311369688216, 231547942, 231547945, 3, 640x360 
0x12CB3460, 36963311370169288, 231547991, 231547994, 3, 640x360 
0x12CB3460, 36963311370487848, 231548031, 231548035, 4, 640x360 
0x12CB3460, 36963311370809584, 231548062, 231548064, 2, 640x360 
0x12CB3460, 36963311371127160, 231548091, 231548094, 3, 640x360 
0x12CB3460, 36963311371448952, 231548122, 231548124, 2, 640x360 
0x12CB3460, 36963311371768304, 231548152, 231548156, 4, 640x360 
0x12CB3460, 36963311372089880, 231548191, 231548195, 4, 640x360 
0x12CB3460, 36963311372409808, 231548222, 231548225, 3, 640x360 
0x12CB3460, 36963311372779120, 231548253, 231548257, 4, 640x360 
0x12CB3460, 36963311373047584, 231548281, 231548286, 5, 640x360 
0x12CB3460, 36963311373368000, 231548312, 231548318, 6, 640x360 
0x12CB3460, 36963311373688504, 231548342, 231548346, 4, 640x360 
0x12CB3460, 36963311374184552, 231548405, 231548409, 4, 640x360 
0x12CB3460, 36963311374490760, 231548432, 231548436, 4, 640x360 
0x12CB3460, 36963311374807016, 231548461, 231548463, 2, 640x360 
0x12CB3460, 36963311375128184, 231548491, 231548494, 3, 640x360 
0x12CB3460, 36963311375446952, 231548521, 231548524, 3, 640x360 
0x12CB3460, 36963311375769784, 231548551, 231548554, 3, 640x360 
0x12CB3460, 36963311376090184, 231548591, 231548595, 4, 640x360 
0x12CB3460, 36963311376408912, 231548621, 231548640, 19, 640x360 
0x12CB3460, 36963311376728544, 231548652, 231548656, 4, 640x360 
0x12CB3460, 36963311377172720, 231548693, 231548702, 9, 640x360 
0x12CB3460, 36963311377379216, 231548736, 231548746, 10, 640x360 
0x12CB3460, 36963311377747552, 231548751, 231548759, 8, 640x360 
0x12CB3460, 36963311378169080, 231548791, 231548797, 6, 640x360 
0x12CB3460, 36963311378487296, 231548831, 231548834, 3, 640x360 
0x12CB3460, 36963311379011184, 231548890, 231548895, 5, 640x360 
0x12CB3460, 36963311379447808, 231548922, 231548925, 3, 640x360 
0x12CB3460, 36963311379768224, 231548952, 231548955, 3, 640x360 
0x12CB3460, 36963311380087400, 231548983, 231548986, 3, 640x360 
0x12CB3460, 36963311380408800, 231549022, 231549025, 3, 640x360 
0x12CB3460, 36963311380729608, 231549052, 231549054, 2, 640x360 
0x12CB3460, 36963311381048360, 231549081, 231549084, 3, 640x360 
0x12CB3460, 36963311381368936, 231549111, 231549114, 3, 640x360 
0x12CB3460, 36963311381848224, 231549161, 231549179, 18, 640x360 
0x12CB3460, 36963311382168968, 231549192, 231549195, 3, 640x360 
0x12CB3460, 36963311382487896, 231549223, 231549226, 3, 640x360 
0x12CB3460, 36963311382807472, 231549262, 231549266, 4, 640x360 
0x12CB3460, 36963311383156184, 231549291, 231549295, 4, 640x360 
0x12CB3460, 36963311383448872, 231549322, 231549326, 4, 640x360 
0x12CB3460, 36963311383768112, 231549374, 231549378, 4, 640x360 
0x12CB3460, 36963311384087584, 231549391, 231549394, 3, 640x360 
0x12CB3460, 36963311384412920, 231549422, 231549424, 2, 640x360 
0x12CB3460, 36963311384727888, 231549453, 231549459, 6, 640x360 
0x12CB3460, 36963311385047216, 231549482, 231549484, 2, 640x360 
0x12CB3460, 36963311385368632, 231549512, 231549515, 3, 640x360 
0x12CB3460, 36963311385847784, 231549561, 231549564, 3, 640x360 
0x12CB3460, 36963311386170480, 231549592, 231549596, 4, 640x360 
0x12CB3460, 36963311386487576, 231549631, 231549635, 4, 640x360 
0x12CB3460, 36963311386807736, 231549662, 231549664, 2, 640x360 
0x12CB3460, 36963311387127256, 231549692, 231549695, 3, 640x360 
0x12CB3460, 36963311387447440, 231549722, 231549724, 2, 640x360 
0x12CB3460, 36963311387767496, 231549751, 231549755, 4, 640x360 
0x12CB3460, 36963311388087248, 231549782, 231549786, 4, 640x360 
0x12CB3460, 36963311388408136, 231549821, 231549824, 3, 640x360 
0x12CB3460, 36963311388728928, 231549875, 231549881, 6, 640x360 
0x12CB3460, 36963311389098520, 231549891, 231549894, 3, 640x360 
0x12CB3460, 36963311389369544, 231549912, 231549915, 3, 640x360 
0x12CB3460, 36963311389847240, 231549962, 231549980, 18, 640x360 
0x12CB3460, 36963311390167256, 231549991, 231549994, 3, 640x360 
0x12CB3460, 36963311390487560, 231550031, 231550034, 3, 640x360 
0x12CB3460, 36963311390807336, 231550061, 231550064, 3, 640x360 
0x12CB3460, 36963311391129888, 231550091, 231550096, 5, 640x360 
0x12CB3460, 36963311391448760, 231550121, 231550123, 2, 640x360 
0x12CB3460, 36963311391769040, 231550151, 231550154, 3, 640x360 
0x12CB3460, 36963311392087672, 231550191, 231550193, 2, 640x360 
0x12CB3460, 36963311392408200, 231550222, 231550225, 3, 640x360 
0x12CB3460, 36963311392727336, 231550251, 231550255, 4, 640x360 
0x12CB3460, 36963311393049080, 231550282, 231550284, 2, 640x360 
0x12CB3460, 36963311393527944, 231550331, 231550333, 2, 640x360 
0x12CB3460, 36963311394075952, 231550391, 231550394, 3, 640x360 
0x12CB3460, 36963311394488376, 231550422, 231550425, 3, 640x360 
0x12CB3460, 36963311394807904, 231550462, 231550464, 2, 640x360 
0x12CB3460, 36963311395127424, 231550491, 231550494, 3, 640x360 
0x12CB3460, 36963311395448200, 231550521, 231550524, 3, 640x360 
0x12CB3460, 36963311395770024, 231550551, 231550554, 3, 640x360 
0x12CB3460, 36963311396088392, 231550591, 231550596, 5, 640x360 
0x12CB3460, 36963311396445152, 231550622, 231550628, 6, 640x360 
0x12CB3460, 36963311397048824, 231550681, 231550684, 3, 640x360 
0x12CB3460, 36963311397527104, 231550732, 231550739, 7, 640x360 
0x12CB3460, 36963311397847608, 231550762, 231550765, 3, 640x360 
0x12CB3460, 36963311398168808, 231550792, 231550796, 4, 640x360 
0x12CB3460, 36963311398489016, 231550832, 231550835, 3, 640x360 
0x12CB3460, 36963311398830928, 231550882, 231550885, 3, 640x360 
0x12CB3460, 36963311399128896, 231550892, 231550894, 2, 640x360 
0x12CB3460, 36963311399448464, 231550922, 231550926, 4, 640x360 
0x12CB3460, 36963311399767360, 231550952, 231550955, 3, 640x360 
0x12CB3460, 36963311400087288, 231550982, 231550985, 3, 640x360 
0x12CB3460, 36963311400408200, 231551021, 231551024, 3, 640x360 
0x12CB3460, 36963311400730888, 231551052, 231551055, 3, 640x360 
0x12CB3460, 36963311401049096, 231551084, 231551088, 4, 640x360 
0x12CB3460, 36963311401528720, 231551131, 231551135, 4, 640x360 
0x12CB3460, 36963311401849184, 231551161, 231551164, 3, 640x360 
0x12CB3460, 36963311402170432, 231551192, 231551196, 4, 640x360 
0x12CB3460, 36963311402486952, 231551231, 231551235, 4, 640x360 
0x12CB3460, 36963311402811896, 231551262, 231551267, 5, 640x360 
0x12CB3460, 36963311403128744, 231551291, 231551294, 3, 640x360 
0x12CB3460, 36963311403447632, 231551322, 231551324, 2, 640x360 
0x12CB3460, 36963311403768392, 231551377, 231551382, 5, 640x360 
0x12CB3460, 36963311404093296, 231551391, 231551394, 3, 640x360 
0x12CB3460, 36963311404414768, 231551422, 231551424, 2, 640x360 
0x12CB3460, 36963311404728384, 231551451, 231551454, 3, 640x360 
0x12CB3460, 36963311405208536, 231551501, 231551504, 3, 640x360 
0x12CB3460, 36963311405526768, 231551530, 231551533, 3, 640x360 
0x12CB3460, 36963311405848128, 231551562, 231551567, 5, 640x360 
0x12CB3460, 36963311406167280, 231551592, 231551596, 4, 640x360 
0x12CB3460, 36963311406488680, 231551631, 231551634, 3, 640x360 
0x12CB3460, 36963311406807296, 231551663, 231551666, 3, 640x360 
0x12CB3460, 36963311407128008, 231551693, 231551697, 4, 640x360 
0x12CB3460, 36963311407447208, 231551722, 231551725, 3, 640x360 
0x12CB3460, 36963311407769128, 231551755, 231551763, 8, 640x360 
0x12CB3460, 36963311408088496, 231551793, 231551797, 4, 640x360 
0x12CB3460, 36963311408427232, 231551822, 231551825, 3, 640x360 
0x12CB3460, 36963311408729136, 231551851, 231551889, 38, 640x360 
0x12CB3460, 36963311409207016, 231551902, 231551904, 2, 640x360 
0x12CB3460, 36963311409528568, 231551932, 231551937, 5, 640x360 
0x12CB3460, 36963311409847944, 231551963, 231551966, 3, 640x360 
0x12CB3460, 36963311410167696, 231551991, 231551994, 3, 640x360 
0x12CB3460, 36963311410488208, 231552031, 231552036, 5, 640x360 
0x12CB3460, 36963311410807352, 231552062, 231552065, 3, 640x360 
0x12CB3460, 36963311411149600, 231552103, 231552114, 11, 640x360 
0x12CB3460, 36963311411452392, 231552123, 231552127, 4, 640x360 
0x12CB3460, 36963311411766864, 231552163, 231552167, 4, 640x360 
0x12CB3460, 36963311412089544, 231552192, 231552196, 4, 640x360 
0x12CB3460, 36963311412412648, 231552228, 231552235, 7, 640x360 
0x12CB3460, 36963311412926016, 231552271, 231552277, 6, 640x360 
0x12CB3460, 36963311413206720, 231552302, 231552305, 3, 640x360 
0x12CB3460, 36963311413526512, 231552331, 231552336, 5, 640x360 
0x12CB3460, 36963311414072672, 231552392, 231552396, 4, 640x360 
0x12CB3460, 36963311414488216, 231552437, 231552441, 4, 640x360 
0x12CB3460, 36963311414813552, 231552461, 231552464, 3, 640x360 
0x12CB3460, 36963311415127424, 231552491, 231552494, 3, 640x360 
0x12CB3460, 36963311415448296, 231552522, 231552525, 3, 640x360 
0x12CB3460, 36963311415768064, 231552551, 231552554, 3, 640x360 
0x12CB3460, 36963311416088416, 231552591, 231552593, 2, 640x360 
0x12CB3460, 36963311416408800, 231552622, 231552625, 3, 640x360 
0x12CB3460, 36963311416888424, 231552671, 231552673, 2, 640x360 
0x12CB3460, 36963311417208888, 231552701, 231552704, 3, 640x360 
0x12CB3460, 36963311417527752, 231552731, 231552734, 3, 640x360 
0x12CB3460, 36963311417847392, 231552762, 231552766, 4, 640x360 
0x12CB3460, 36963311418168440, 231552791, 231552794, 3, 640x360 
0x12CB3460, 36963311418487440, 231552831, 231552834, 3, 640x360 
0x12CB3460, 36963311419080680, 231552891, 231552894, 3, 640x360 
0x12CB3460, 36963311419448608, 231552922, 231552925, 3, 640x360 
0x12CB3460, 36963311419793008, 231552963, 231552967, 4, 640x360 
0x12CB3460, 36963311420136568, 231553002, 231553006, 4, 640x360 
0x12CB3460, 36963311420432712, 231553022, 231553031, 9, 640x360 
0x12CB3460, 36963311420890840, 231553074, 231553077, 3, 640x360 
0x12CB3460, 36963311421212448, 231553102, 231553104, 2, 640x360 
0x12CB3460, 36963311421529224, 231553131, 231553133, 2, 640x360 
0x12CB3460, 36963311421848296, 231553162, 231553164, 2, 640x360 
0x12CB3460, 36963311422168448, 231553191, 231553194, 3, 640x360 
0x12CB3460, 36963311422488808, 231553231, 231553234, 3, 640x360 
0x12CB3460, 36963311422807304, 231553262, 231553264, 2, 640x360 
0x12CB3460, 36963311423127256, 231553291, 231553293, 2, 640x360 
0x12CB3460, 36963311423446928, 231553321, 231553324, 3, 640x360 
0x12CB3460, 36963311424043960, 231553383, 231553389, 6, 640x360 
0x12CB3460, 36963311424160000, 231553415, 231553426, 11, 640x360 
0x12CB3460, 36963311424575560, 231553442, 231553445, 3, 640x360 
0x12CB3460, 36963311424887272, 231553463, 231553466, 3, 640x360 
0x12CB3460, 36963311425207728, 231553501, 231553504, 3, 640x360 
0x12CB3460, 36963311425528456, 231553530, 231553533, 3, 640x360 
0x12CB3460, 36963311425847864, 231553561, 231553564, 3, 640x360 
0x12CB3460, 36963311426168600, 231553591, 231553596, 5, 640x360 
0x12CB3460, 36963311426488760, 231553631, 231553633, 2, 640x360 
0x12CB3460, 36963311426807272, 231553661, 231553664, 3, 640x360 
0x12CB3460, 36963311427127680, 231553691, 231553694, 3, 640x360 
0x12CB3460, 36963311427450408, 231553722, 231553725, 3, 640x360 
0x12CB3460, 36963311427768040, 231553752, 231553756, 4, 640x360 
0x12CB3460, 36963311428087592, 231553791, 231553794, 3, 640x360 
0x12CB3460, 36963311428569096, 231553832, 231553834, 2, 640x360 
0x12CB3460, 36963311429075648, 231553891, 231553895, 4, 640x360 
0x12CB3460, 36963311429210656, 231553901, 231553904, 3, 640x360 
0x12CB3460, 36963311429527528, 231553932, 231553937, 5, 640x360 
0x12CB3460, 36963311429940448, 231553989, 231554017, 28, 640x360 
0x12CB3460, 36963311430220136, 231554023, 231554055, 32, 640x360 
0x12CB3460, 36963311430808752, 231554063, 231554069, 6, 640x360 
0x12CB3460, 36963311431144520, 231554091, 231554094, 3, 640x360 
0x12CB3460, 36963311431450664, 231554121, 231554124, 3, 640x360 
0x12CB3460, 36963311431767352, 231554151, 231554153, 2, 640x360 
0x12CB3460, 36963311432088232, 231554182, 231554185, 3, 640x360 
0x12CB3460, 36963311432567904, 231554231, 231554234, 3, 640x360 
0x12CB3460, 36963311432887816, 231554263, 231554265, 2, 640x360 
0x12CB3460, 36963311433207432, 231554302, 231554304, 2, 640x360 
0x12CB3460, 36963311433528464, 231554331, 231554333, 2, 640x360 
0x12CB3460, 36963311434112584, 231554392, 231554395, 3, 640x360 
0x12CB3460, 36963311434487488, 231554422, 231554425, 3, 640x360 
0x12CB3460, 36963311434808208, 231554462, 231554464, 2, 640x360 
0x12CB3460, 36963311435127880, 231554491, 231554493, 2, 640x360 
0x12CB3460, 36963311435447416, 231554521, 231554524, 3, 640x360 
0x12CB3460, 36963311436246384, 231554601, 231554604, 3, 640x360 
0x12CB3460, 36963311436568488, 231554632, 231554635, 3, 640x360 
0x12CB3460, 36963311436886384, 231554661, 231554665, 4, 640x360 
0x12CB3460, 36963311437208752, 231554701, 231554718, 17, 640x360 
0x12CB3460, 36963311437531432, 231554732, 231554735, 3, 640x360 
0x12CB3460, 36963311437848488, 231554761, 231554764, 3, 640x360 
0x12CB3460, 36963311438167768, 231554792, 231554794, 2, 640x360 
0x12CB3460, 36963311438488040, 231554832, 231554835, 3, 640x360 
0x12CB3460, 36963311439072696, 231554882, 231554887, 5, 640x360 
0x12CB3460, 36963311439129144, 231554892, 231554896, 4, 640x360 
0x12CB3460, 36963311439643776, 231554942, 231554946, 4, 640x360 
0x12CB3460, 36963311439769296, 231554952, 231554955, 3, 640x360 
0x12CB3460, 36963311440246752, 231555001, 231555004, 3, 640x360 
0x12CB3460, 36963311440567896, 231555031, 231555034, 3, 640x360 
0x12CB3460, 36963311440888824, 231555062, 231555065, 3, 640x360 
0x12CB3460, 36963311441208768, 231555101, 231555104, 3, 640x360 
0x12CB3460, 36963311441528336, 231555131, 231555134, 3, 640x360 
0x12CB3460, 36963311441848664, 231555162, 231555164, 2, 640x360 
0x12CB3460, 36963311442169192, 231555191, 231555194, 3, 640x360 
0x12CB3460, 36963311442488304, 231555231, 231555236, 5, 640x360 
0x12CB3460, 36963311442808536, 231555261, 231555263, 2, 640x360 
0x12CB3460, 36963311443128840, 231555291, 231555293, 2, 640x360 
0x12CB3460, 36963311443448584, 231555321, 231555323, 2, 640x360 
0x12CB3460, 36963311444012640, 231555382, 231555385, 3, 640x360 
0x12CB3460, 36963311444246896, 231555402, 231555404, 2, 640x360 
0x12CB3460, 36963311444568312, 231555431, 231555434, 3, 640x360 
0x12CB3460, 36963311444888792, 231555471, 231555473, 2, 640x360 
0x12CB3460, 36963311445208736, 231555502, 231555519, 17, 640x360 
0x12CB3460, 36963311445528856, 231555531, 231555534, 3, 640x360 
0x12CB3460, 36963311445850656, 231555561, 231555565, 4, 640x360 
0x12CB3460, 36963311446168424, 231555592, 231555595, 3, 640x360 
0x12CB3460, 36963311446487888, 231555632, 231555635, 3, 640x360 
0x12CB3460, 36963311446807408, 231555662, 231555664, 2, 640x360 
0x12CB3460, 36963311447127512, 231555691, 231555694, 3, 640x360 
0x12CB3460, 36963311447447312, 231555722, 231555724, 2, 640x360 
0x12CB3460, 36963311447927448, 231555771, 231555774, 3, 640x360 
0x12CB3460, 36963311448248280, 231555801, 231555803, 2, 640x360 
0x12CB3460, 36963311448566696, 231555832, 231555834, 2, 640x360 
0x12CB3460, 36963311449016624, 231555881, 231555884, 3, 640x360 
0x12CB3460, 36963311449209688, 231555902, 231555906, 4, 640x360 
0x12CB3460, 36963311449565128, 231555935, 231555979, 44, 640x360 
0x12CB3460, 36963311450072024, 231555992, 231555999, 7, 640x360 
0x12CB3460, 36963311450171096, 231556002, 231556006, 4, 640x360 
0x12CB3460, 36963311450490040, 231556032, 231556035, 3, 640x360 
0x12CB3460, 36963311450807632, 231556062, 231556065, 3, 640x360 
0x12CB3460, 36963311451127664, 231556092, 231556095, 3, 640x360 
0x12CB3460, 36963311451447464, 231556121, 231556123, 2, 640x360 
0x12CB3460, 36963311451927976, 231556171, 231556174, 3, 640x360 
0x12CB3460, 36963311452248648, 231556201, 231556204, 3, 640x360 
0x12CB3460, 36963311452569544, 231556234, 231556238, 4, 640x360 
0x12CB3460, 36963311452886360, 231556263, 231556266, 3, 640x360 
0x12CB3460, 36963311453207872, 231556301, 231556304, 3, 640x360 
0x12CB3460, 36963311453527936, 231556331, 231556334, 3, 640x360 
0x12CB3460, 36963311453979328, 231556382, 231556384, 2, 640x360 
0x12CB3460, 36963311454167248, 231556391, 231556394, 3, 640x360 
0x12CB3460, 36963311454487608, 231556431, 231556433, 2, 640x360 
0x12CB3460, 36963311454807904, 231556462, 231556464, 2, 640x360 
0x12CB3460, 36963311455127520, 231556491, 231556494, 3, 640x360 
0x12CB3460, 36963311455605992, 231556541, 231556544, 3, 640x360 
0x12CB3460, 36963311455926416, 231556571, 231556574, 3, 640x360 
0x12CB3460, 36963311456247920, 231556601, 231556604, 3, 640x360 
0x12CB3460, 36963311456567688, 231556632, 231556634, 2, 640x360 
0x12CB3460, 36963311456889760, 231556672, 231556674, 2, 640x360 
0x12CB3460, 36963311457207272, 231556701, 231556703, 2, 640x360 
0x12CB3460, 36963311457530184, 231556731, 231556734, 3, 640x360 
0x12CB3460, 36963311457848464, 231556762, 231556765, 3, 640x360 
0x12CB3460, 36963311458168344, 231556791, 231556794, 3, 640x360 
0x12CB3460, 36963311458488520, 231556822, 231556825, 3, 640x360 
0x12CB3460, 36963311458950312, 231556881, 231556884, 3, 640x360 
0x12CB3460, 36963311459129664, 231556892, 231556894, 2, 640x360 
0x12CB3460, 36963311459606856, 231556941, 231556943, 2, 640x360 
0x12CB3460, 36963311459929208, 231556970, 231556973, 3, 640x360 
0x12CB3460, 36963311460248264, 231557002, 231557004, 2, 640x360 
0x12CB3460, 36963311460566848, 231557031, 231557034, 3, 640x360 
0x12CB3460, 36963311460887896, 231557062, 231557065, 3, 640x360 
0x12CB3460, 36963311461208424, 231557101, 231557104, 3, 640x360 
0x12CB3460, 36963311461529840, 231557131, 231557134, 3, 640x360 
0x12CB3460, 36963311461848024, 231557162, 231557165, 3, 640x360 
0x12CB3460, 36963311462167368, 231557192, 231557194, 2, 640x360 
0x12CB3460, 36963311462486888, 231557231, 231557234, 3, 640x360 
0x12CB3460, 36963311462807224, 231557261, 231557264, 3, 640x360 
0x12CB3460, 36963311463128664, 231557291, 231557293, 2, 640x360 
0x12CB3460, 36963311463608680, 231557341, 231557344, 3, 640x360 
0x12CB3460, 36963311463991112, 231557374, 231557377, 3, 640x360 
0x12CB3460, 36963311464247920, 231557402, 231557405, 3, 640x360 
0x12CB3460, 36963311464567920, 231557431, 231557434, 3, 640x360 
0x12CB3460, 36963311464888424, 231557462, 231557465, 3, 640x360 
0x12CB3460, 36963311465208704, 231557502, 231557504, 2, 640x360 
0x12CB3460, 36963311465527560, 231557531, 231557534, 3, 640x360 
0x12CB3460, 36963311465849408, 231557561, 231557563, 2, 640x360 
0x12CB3460, 36963311466169176, 231557592, 231557594, 2, 640x360 
0x12CB3460, 36963311466490976, 231557631, 231557636, 5, 640x360 
0x12CB3460, 36963311466808072, 231557662, 231557664, 2, 640x360 
0x12CB3460, 36963311467288064, 231557711, 231557714, 3, 640x360 
0x12CB3460, 36963311467606184, 231557742, 231557744, 2, 640x360 
0x12CB3460, 36963311467927184, 231557771, 231557774, 3, 640x360 
0x12CB3460, 36963311468247288, 231557801, 231557804, 3, 640x360 
0x12CB3460, 36963311468567832, 231557832, 231557835, 3, 640x360 
0x12CB3460, 36963311469093664, 231557892, 231557897, 5, 640x360 
0x12CB3460, 36963311469214368, 231557902, 231557905, 3, 640x360 
0x12CB3460, 36963311469528496, 231557931, 231557933, 2, 640x360 
0x12CB3460, 36963311469847504, 231557961, 231557963, 2, 640x360 
0x12CB3460, 36963311470168160, 231557991, 231557994, 3, 640x360 
0x12CB3460, 36963311470487712, 231558031, 231558033, 2, 640x360 
0x12CB3460, 36963311470807720, 231558061, 231558063, 2, 640x360 
0x12CB3460, 36963311471286272, 231558111, 231558114, 3, 640x360 
0x12CB3460, 36963311471606408, 231558141, 231558144, 3, 640x360 
0x12CB3460, 36963311471928272, 231558172, 231558174, 2, 640x360 
0x12CB3460, 36963311472246200, 231558201, 231558203, 2, 640x360 
0x12CB3460, 36963311472568264, 231558241, 231558244, 3, 640x360 
0x12CB3460, 36963311472888912, 231558272, 231558275, 3, 640x360 
0x12CB3460, 36963311473208728, 231558302, 231558304, 2, 640x360 
0x12CB3460, 36963311473526688, 231558331, 231558333, 2, 640x360 
0x12CB3460, 36963311474025512, 231558382, 231558385, 3, 640x360 
0x12CB3460, 36963311474167968, 231558391, 231558394, 3, 640x360 
0x12CB3460, 36963311474488080, 231558422, 231558425, 3, 640x360 
0x12CB3460, 36963311474808944, 231558461, 231558464, 3, 640x360 
0x12CB3460, 36963311475289120, 231558512, 231558516, 4, 640x360 
0x12CB3460, 36963311475610872, 231558542, 231558546, 4, 640x360 
0x12CB3460, 36963311475927320, 231558572, 231558575, 3, 640x360 
0x12CB3460, 36963311476247112, 231558601, 231558604, 3, 640x360 
0x12CB3460, 36963311476567752, 231558630, 231558634, 4, 640x360 
0x12CB3460, 36963311476888224, 231558671, 231558673, 2, 640x360 
0x12CB3460, 36963311477208680, 231558701, 231558704, 3, 640x360 
0x12CB3460, 36963311477528832, 231558732, 231558750, 18, 640x360 
0x12CB3460, 36963311477847704, 231558762, 231558767, 5, 640x360 
0x12CB3460, 36963311478167632, 231558792, 231558794, 2, 640x360 
0x12CB3460, 36963311478488120, 231558831, 231558834, 3, 640x360 
0x12CB3460, 36963311479165416, 231558892, 231558896, 4, 640x360 
0x12CB3460, 36963311479285888, 231558911, 231558914, 3, 640x360 
0x12CB3460, 36963311479606592, 231558941, 231558944, 3, 640x360 
0x12CB3460, 36963311479927192, 231558971, 231558974, 3, 640x360 
0x12CB3460, 36963311480246696, 231559001, 231559004, 3, 640x360 
0x12CB3460, 36963311480568176, 231559031, 231559034, 3, 640x360 
0x12CB3460, 36963311480887768, 231559071, 231559074, 3, 640x360 
0x12CB3460, 36963311481206208, 231559102, 231559105, 3, 640x360 
0x12CB3460, 36963311481527304, 231559130, 231559133, 3, 640x360 
0x12CB3460, 36963311481846584, 231559162, 231559164, 2, 640x360 
0x12CB3460, 36963311482168064, 231559202, 231559204, 2, 640x360 
0x12CB3460, 36963311482966368, 231559272, 231559275, 3, 640x360 
0x12CB3460, 36963311483287296, 231559311, 231559313, 2, 640x360 
0x12CB3460, 36963311483607520, 231559341, 231559344, 3, 640x360 
0x12CB3460, 36963311484167248, 231559392, 231559398, 6, 640x360 
0x12CB3460, 36963311484247424, 231559401, 231559403, 2, 640x360 
0x12CB3460, 36963311484566320, 231559432, 231559437, 5, 640x360 
0x12CB3460, 36963311484887752, 231559471, 231559474, 3, 640x360 
0x12CB3460, 36963311485207576, 231559501, 231559503, 2, 640x360 
0x12CB3460, 36963311485527920, 231559531, 231559534, 3, 640x360 
0x12CB3460, 36963311485847280, 231559563, 231559565, 2, 640x360 
0x12CB3460, 36963311486168704, 231559602, 231559605, 3, 640x360 
0x12CB3460, 36963311486647752, 231559642, 231559645, 3, 640x360 
0x12CB3460, 36963311486967912, 231559672, 231559674, 2, 640x360 
0x12CB3460, 36963311487286384, 231559711, 231559714, 3, 640x360 
0x12CB3460, 36963311487607304, 231559741, 231559743, 2, 640x360 
0x12CB3460, 36963311487929056, 231559771, 231559774, 3, 640x360 
0x12CB3460, 36963311488248224, 231559802, 231559804, 2, 640x360 
0x12CB3460, 36963311488567480, 231559831, 231559834, 3, 640x360 
0x12CB3460, 36963311489040016, 231559882, 231559885, 3, 640x360 
0x12CB3460, 36963311489206640, 231559901, 231559903, 2, 640x360 
0x12CB3460, 36963311489527016, 231559932, 231559936, 4, 640x360 
0x12CB3460, 36963311489847224, 231559961, 231559963, 2, 640x360 
0x12CB3460, 36963311490168528, 231559992, 231559994, 2, 640x360 
0x12CB3460, 36963311490649464, 231560041, 231560045, 4, 640x360 
0x12CB3460, 36963311490967456, 231560072, 231560074, 2, 640x360 
0x12CB3460, 36963311491287816, 231560102, 231560105, 3, 640x360 
0x12CB3460, 36963311491607192, 231560141, 231560144, 3, 640x360 
0x12CB3460, 36963311491928208, 231560171, 231560173, 2, 640x360 
0x12CB3460, 36963311492247152, 231560201, 231560203, 2, 640x360 
0x12CB3460, 36963311492569024, 231560232, 231560235, 3, 640x360 
0x12CB3460, 36963311492886728, 231560272, 231560275, 3, 640x360 
0x12CB3460, 36963311493206560, 231560301, 231560303, 2, 640x360 
0x12CB3460, 36963311493526880, 231560331, 231560334, 3, 640x360 
0x12CB3460, 36963311493998104, 231560381, 231560383, 2, 640x360 
0x12CB3460, 36963311494648256, 231560441, 231560444, 3, 640x360 
0x12CB3460, 36963311494966456, 231560471, 231560474, 3, 640x360 
0x12CB3460, 36963311495288344, 231560511, 231560514, 3, 640x360 
0x12CB3460, 36963311495607064, 231560541, 231560544, 3, 640x360 
0x12CB3460, 36963311495927576, 231560572, 231560574, 2, 640x360 
0x12CB3460, 36963311496246744, 231560601, 231560605, 4, 640x360 
0x12CB3460, 36963311496567824, 231560632, 231560634, 2, 640x360 
0x12CB3460, 36963311496886712, 231560662, 231560665, 3, 640x360 
0x12CB3460, 36963311497207816, 231560702, 231560705, 3, 640x360 
0x12CB3460, 36963311497527416, 231560732, 231560734, 2, 640x360 
0x12CB3460, 36963311497848792, 231560761, 231560765, 4, 640x360 
0x12CB3460, 36963311498327752, 231560811, 231560813, 2, 640x360 
0x12CB3460, 36963311498648192, 231560841, 231560844, 3, 640x360 
0x12CB3460, 36963311499051352, 231560882, 231560885, 3, 640x360 
0x12CB3460, 36963311499287664, 231560902, 231560905, 3, 640x360 
0x12CB3460, 36963311499608320, 231560942, 231560946, 4, 640x360 
0x12CB3460, 36963311499926832, 231560971, 231560973, 2, 640x360 
0x12CB3460, 36963311500246872, 231561001, 231561003, 2, 640x360 
0x12CB3460, 36963311500567712, 231561031, 231561034, 3, 640x360 
0x12CB3460, 36963311500887320, 231561075, 231561079, 4, 640x360 
0x12CB3460, 36963311501210544, 231561101, 231561104, 3, 640x360 
0x12CB3460, 36963311501527752, 231561131, 231561134, 3, 640x360 
0x12CB3460, 36963311501847904, 231561161, 231561164, 3, 640x360 
0x12CB3460, 36963311502327744, 231561211, 231561214, 3, 640x360 
0x12CB3460, 36963311502649296, 231561241, 231561244, 3, 640x360 
0x12CB3460, 36963311502968552, 231561272, 231561276, 4, 640x360 
0x12CB3460, 36963311503286624, 231561301, 231561305, 4, 640x360 
0x12CB3460, 36963311503608072, 231561341, 231561344, 3, 640x360 
0x12CB3460, 36963311504022328, 231561382, 231561386, 4, 640x360 
0x12CB3460, 36963311504247312, 231561402, 231561405, 3, 640x360 
0x12CB3460, 36963311504566248, 231561431, 231561435, 4, 640x360 
0x12CB3460, 36963311504887688, 231561472, 231561474, 2, 640x360 
0x12CB3460, 36963311505206904, 231561502, 231561505, 3, 640x360 
0x12CB3460, 36963311505527192, 231561532, 231561537, 5, 640x360 
0x12CB3460, 36963311505846928, 231561562, 231561564, 2, 640x360 
0x12CB3460, 36963311506326520, 231561612, 231561615, 3, 640x360 
0x12CB3460, 36963311506646056, 231561640, 231561643, 3, 640x360 
0x12CB3460, 36963311506966440, 231561672, 231561674, 2, 640x360 
0x12CB3460, 36963311507287800, 231561711, 231561714, 3, 640x360 
0x12CB3460, 36963311507607448, 231561742, 231561746, 4, 640x360 
0x12CB3460, 36963311507927752, 231561772, 231561777, 5, 640x360 
0x12CB3460, 36963311508246216, 231561801, 231561804, 3, 640x360 
0x12CB3460, 36963311508567440, 231561832, 231561835, 3, 640x360 
0x12CB3460, 36963311509112776, 231561892, 231561895, 3, 640x360 
0x12CB3460, 36963311509208608, 231561901, 231561904, 3, 640x360 
0x12CB3460, 36963311509530656, 231561932, 231561937, 5, 640x360 
0x12CB3460, 36963311510007064, 231561981, 231561984, 3, 640x360 
0x12CB3460, 36963311510326520, 231562011, 231562014, 3, 640x360 
0x12CB3460, 36963311510650856, 231562042, 231562045, 3, 640x360 
0x12CB3460, 36963311510968440, 231562072, 231562075, 3, 640x360 
0x12CB3460, 36963311511287064, 231562102, 231562108, 6, 640x360 
0x12CB3460, 36963311511607424, 231562141, 231562143, 2, 640x360 
0x12CB3460, 36963311511927496, 231562171, 231562174, 3, 640x360 
0x12CB3460, 36963311512252056, 231562202, 231562206, 4, 640x360 
0x12CB3460, 36963311512569136, 231562232, 231562235, 3, 640x360 
0x12CB3460, 36963311512887040, 231562262, 231562265, 3, 640x360 
0x12CB3460, 36963311513212352, 231562301, 231562304, 3, 640x360 
0x12CB3460, 36963311513528752, 231562331, 231562336, 5, 640x360 
0x12CB3460, 36963311514006624, 231562388, 231562392, 4, 640x360 
0x12CB3460, 36963311514328016, 231562414, 231562422, 8, 640x360 
0x12CB3460, 36963311514646736, 231562442, 231562446, 4, 640x360 
0x12CB3460, 36963311514968976, 231562472, 231562475, 3, 640x360 
0x12CB3460, 36963311515286928, 231562512, 231562522, 10, 640x360 
0x12CB3460, 36963311515609024, 231562541, 231562544, 3, 640x360 
0x12CB3460, 36963311515928512, 231562573, 231562576, 3, 640x360 
0x12CB3460, 36963311516247496, 231562602, 231562606, 4, 640x360 
0x12CB3460, 36963311516566080, 231562631, 231562634, 3, 640x360 
0x12CB3460, 36963311516886856, 231562663, 231562666, 3, 640x360 
0x12CB3460, 36963311517207240, 231562702, 231562705, 3, 640x360 
0x12CB3460, 36963311517528736, 231562733, 231562739, 6, 640x360 
0x12CB3460, 36963311518006368, 231562782, 231562790, 8, 640x360 
0x12CB3460, 36963311518325728, 231562812, 231562817, 5, 640x360 
0x12CB3460, 36963311518648464, 231562841, 231562849, 8, 640x360 
0x12CB3460, 36963311518967376, 231562871, 231562879, 8, 640x360 
0x12CB3460, 36963311519290192, 231562912, 231562919, 7, 640x360 
0x12CB3460, 36963311519607192, 231562942, 231562945, 3, 640x360 
0x12CB3460, 36963311519931920, 231562971, 231562974, 3, 640x360 
0x12CB3460, 36963311520246168, 231563002, 231563006, 4, 640x360 
0x12CB3460, 36963311520567008, 231563032, 231563035, 3, 640x360 
0x12CB3460, 36963311520887152, 231563062, 231563066, 4, 640x360 
0x12CB3460, 36963311521208128, 231563102, 231563105, 3, 640x360 
0x12CB3460, 36963311521685560, 231563142, 231563145, 3, 640x360 
0x12CB3460, 36963311522008040, 231563181, 231563184, 3, 640x360 
0x12CB3460, 36963311522327104, 231563211, 231563214, 3, 640x360 
0x12CB3460, 36963311522646584, 231563241, 231563244, 3, 640x360 
0x12CB3460, 36963311522966432, 231563272, 231563275, 3, 640x360 
0x12CB3460, 36963311523287608, 231563301, 231563304, 3, 640x360 
0x12CB3460, 36963311523607192, 231563341, 231563344, 3, 640x360 
0x12CB3460, 36963311523927752, 231563371, 231563375, 4, 640x360 
0x12CB3460, 36963311524247192, 231563401, 231563404, 3, 640x360 
0x12CB3460, 36963311524567904, 231563432, 231563435, 3, 640x360 
0x12CB3460, 36963311524886784, 231563462, 231563465, 3, 640x360 
0x12CB3460, 36963311525206600, 231563501, 231563504, 3, 640x360 
0x12CB3460, 36963311525687408, 231563542, 231563545, 3, 640x360 
0x12CB3460, 36963311526006848, 231563581, 231563585, 4, 640x360 
0x12CB3460, 36963311526328616, 231563611, 231563615, 4, 640x360 
0x12CB3460, 36963311526649392, 231563642, 231563644, 2, 640x360 
0x12CB3460, 36963311526966640, 231563671, 231563674, 3, 640x360 
0x12CB3460, 36963311527286336, 231563711, 231563714, 3, 640x360 
0x12CB3460, 36963311527607280, 231563741, 231563743, 2, 640x360 
0x12CB3460, 36963311527926536, 231563771, 231563776, 5, 640x360 
0x12CB3460, 36963311528247552, 231563801, 231563803, 2, 640x360 
0x12CB3460, 36963311528566664, 231563832, 231563835, 3, 640x360 
0x12CB3460, 36963311528889080, 231563876, 231563879, 3, 640x360 
0x12CB3460, 36963311529366024, 231563911, 231563915, 4, 640x360 
0x12CB3460, 36963311529686976, 231563942, 231563948, 6, 640x360 
0x12CB3460, 36963311530007816, 231563981, 231563984, 3, 640x360 
0x12CB3460, 36963311530327864, 231564011, 231564014, 3, 640x360 
0x12CB3460, 36963311530646688, 231564041, 231564044, 3, 640x360 
0x12CB3460, 36963311530967128, 231564071, 231564075, 4, 640x360 
0x12CB3460, 36963311531288832, 231564111, 231564113, 2, 640x360 
0x12CB3460, 36963311531607008, 231564140, 231564143, 3, 640x360 
0x12CB3460, 36963311531928208, 231564171, 231564174, 3, 640x360 
0x12CB3460, 36963311532247520, 231564202, 231564204, 2, 640x360 
0x12CB3460, 36963311532567152, 231564232, 231564236, 4, 640x360 
0x12CB3460, 36963311532886832, 231564263, 231564265, 2, 640x360 
0x12CB3460, 36963311533367656, 231564311, 231564314, 3, 640x360 
0x12CB3460, 36963311533686296, 231564342, 231564347, 5, 640x360 
0x12CB3460, 36963311534006328, 231564381, 231564384, 3, 640x360 
0x12CB3460, 36963311534326440, 231564411, 231564413, 2, 640x360 
0x12CB3460, 36963311534647152, 231564442, 231564444, 2, 640x360 
0x12CB3460, 36963311534966640, 231564472, 231564474, 2, 640x360 
0x12CB3460, 36963311535287352, 231564502, 231564506, 4, 640x360 
0x12CB3460, 36963311535606768, 231564541, 231564543, 2, 640x360 
0x12CB3460, 36963311535927272, 231564571, 231564574, 3, 640x360 
0x12CB3460, 36963311536247464, 231564602, 231564607, 5, 640x360 
0x12CB3460, 36963311536567472, 231564631, 231564634, 3, 640x360 
0x12CB3460, 36963311536887712, 231564662, 231564666, 4, 640x360 
0x12CB3460, 36963311537367120, 231564711, 231564714, 3, 640x360 
0x12CB3460, 36963311537687608, 231564742, 231564745, 3, 640x360 
0x12CB3460, 36963311538006704, 231564781, 231564784, 3, 640x360 
0x12CB3460, 36963311538327392, 231564811, 231564814, 3, 640x360 
0x12CB3460, 36963311538648976, 231564842, 231564844, 2, 640x360 
0x12CB3460, 36963311538967840, 231564882, 231564885, 3, 640x360 
0x12CB3460, 36963311539286816, 231564902, 231564905, 3, 640x360 
0x12CB3460, 36963311539607024, 231564941, 231564946, 5, 640x360 
0x12CB3460, 36963311539926312, 231564971, 231564974, 3, 640x360 
0x12CB3460, 36963311540245904, 231565001, 231565003, 2, 640x360 
0x12CB3460, 36963311540567280, 231565032, 231565035, 3, 640x360 
0x12CB3460, 36963311541047960, 231565081, 231565084, 3, 640x360 
0x12CB3460, 36963311541367976, 231565112, 231565115, 3, 640x360 
0x12CB3460, 36963311541687488, 231565151, 231565154, 3, 640x360 
0x12CB3460, 36963311542006848, 231565181, 231565184, 3, 640x360 
0x12CB3460, 36963311542326128, 231565212, 231565214, 2, 640x360 
0x12CB3460, 36963311542647184, 231565241, 231565244, 3, 640x360 
0x12CB3460, 36963311542968024, 231565272, 231565275, 3, 640x360 
0x12CB3460, 36963311543286384, 231565302, 231565306, 4, 640x360 
0x12CB3460, 36963311543606848, 231565342, 231565344, 2, 640x360 
0x12CB3460, 36963311543927944, 231565374, 231565377, 3, 640x360 
0x12CB3460, 36963311544247728, 231565401, 231565404, 3, 640x360 
0x12CB3460, 36963311544566424, 231565431, 231565434, 3, 640x360 
0x12CB3460, 36963311545045520, 231565481, 231565483, 2, 640x360 
0x12CB3460, 36963311545366160, 231565510, 231565513, 3, 640x360 
0x12CB3460, 36963311545686272, 231565542, 231565545, 3, 640x360 
0x12CB3460, 36963311546006336, 231565582, 231565585, 3, 640x360 
0x12CB3460, 36963311546326784, 231565611, 231565615, 4, 640x360 
0x12CB3460, 36963311546647240, 231565641, 231565644, 3, 640x360 
0x12CB3460, 36963311546966280, 231565672, 231565674, 2, 640x360 
0x12CB3460, 36963311547285968, 231565711, 231565714, 3, 640x360 
0x12CB3460, 36963311547607904, 231565741, 231565744, 3, 640x360 
0x12CB3460, 36963311547927184, 231565772, 231565775, 3, 640x360 
0x12CB3460, 36963311548246864, 231565801, 231565804, 3, 640x360 
0x12CB3460, 36963311548567440, 231565832, 231565835, 3, 640x360 
0x12CB3460, 36963311549047744, 231565881, 231565884, 3, 640x360 
0x12CB3460, 36963311549366296, 231565911, 231565914, 3, 640x360 
0x12CB3460, 36963311549690480, 231565942, 231565948, 6, 640x360 
0x12CB3460, 36963311550006512, 231565982, 231565985, 3, 640x360 
0x12CB3460, 36963311550326560, 231566012, 231566014, 2, 640x360 
0x12CB3460, 36963311550646304, 231566041, 231566043, 2, 640x360 
0x12CB3460, 36963311550966712, 231566071, 231566074, 3, 640x360 
0x12CB3460, 36963311551286432, 231566101, 231566105, 4, 640x360 
0x12CB3460, 36963311551611568, 231566141, 231566144, 3, 640x360 
0x12CB3460, 36963311551926752, 231566171, 231566173, 2, 640x360 
0x12CB3460, 36963311552247200, 231566202, 231566204, 2, 640x360 
0x12CB3460, 36963311552729424, 231566251, 231566254, 3, 640x360 
0x12CB3460, 36963311553048480, 231566282, 231566302, 20, 640x360 
0x12CB3460, 36963311553366448, 231566312, 231566315, 3, 640x360 
0x12CB3460, 36963311553686184, 231566342, 231566346, 4, 640x360 
0x12CB3460, 36963311554007864, 231566375, 231566378, 3, 640x360 
0x12CB3460, 36963311554327432, 231566411, 231566413, 2, 640x360 
0x12CB3460, 36963311554646656, 231566441, 231566443, 2, 640x360 
0x12CB3460, 36963311554966992, 231566471, 231566474, 3, 640x360 
0x12CB3460, 36963311555286936, 231566501, 231566505, 4, 640x360 
0x12CB3460, 36963311555608424, 231566541, 231566543, 2, 640x360 
0x12CB3460, 36963311555928512, 231566571, 231566574, 3, 640x360 
0x12CB3460, 36963311556248560, 231566601, 231566604, 3, 640x360 
0x12CB3460, 36963311556727136, 231566651, 231566653, 2, 640x360 
0x12CB3460, 36963311557046576, 231566682, 231566684, 2, 640x360 
0x12CB3460, 36963311557367456, 231566711, 231566715, 4, 640x360 
0x12CB3460, 36963311557686136, 231566742, 231566745, 3, 640x360 
0x12CB3460, 36963311558011608, 231566781, 231566784, 3, 640x360 
0x12CB3460, 36963311558327424, 231566811, 231566814, 3, 640x360 
0x12CB3460, 36963311558650136, 231566840, 231566843, 3, 640x360 
0x12CB3460, 36963311558967432, 231566873, 231566875, 2, 640x360 
0x12CB3460, 36963311559287152, 231566912, 231566914, 2, 640x360 
0x12CB3460, 36963311559612496, 231566941, 231566943, 2, 640x360 
0x12CB3460, 36963311559927112, 231566971, 231566974, 3, 640x360 
0x12CB3460, 36963311560405784, 231567021, 231567023, 2, 640x360 
0x12CB3460, 36963311560726592, 231567051, 231567055, 4, 640x360 
0x12CB3460, 36963311561046976, 231567081, 231567084, 3, 640x360 
0x12CB3460, 36963311561367392, 231567112, 231567130, 18, 640x360 
0x12CB3460, 36963311561686104, 231567142, 231567145, 3, 640x360 
0x12CB3460, 36963311562007848, 231567181, 231567184, 3, 640x360 
0x12CB3460, 36963311562327608, 231567210, 231567213, 3, 640x360 
0x12CB3460, 36963311562646312, 231567242, 231567245, 3, 640x360 
0x12CB3460, 36963311562966312, 231567271, 231567274, 3, 640x360 
0x12CB3460, 36963311563286496, 231567302, 231567306, 4, 640x360 
0x12CB3460, 36963311563606912, 231567342, 231567344, 2, 640x360 
0x12CB3460, 36963311563927208, 231567370, 231567373, 3, 640x360 
0x12CB3460, 36963311564407536, 231567421, 231567424, 3, 640x360 
0x12CB3460, 36963311564726064, 231567451, 231567454, 3, 640x360 
0x12CB3460, 36963311565045760, 231567481, 231567484, 3, 640x360 
0x12CB3460, 36963311565365912, 231567512, 231567514, 2, 640x360 
0x12CB3460, 36963311565687152, 231567542, 231567545, 3, 640x360 
0x12CB3460, 36963311566007896, 231567581, 231567584, 3, 640x360 
0x12CB3460, 36963311566326464, 231567612, 231567617, 5, 640x360 
0x12CB3460, 36963311566650904, 231567641, 231567648, 7, 640x360 
0x12CB3460, 36963311566965776, 231567671, 231567674, 3, 640x360 
0x12CB3460, 36963311567287104, 231567712, 231567714, 2, 640x360 
0x12CB3460, 36963311567607976, 231567736, 231567739, 3, 640x360 
0x12CB3460, 36963311567926296, 231567770, 231567773, 3, 640x360 
0x12CB3460, 36963311568407784, 231567822, 231567825, 3, 640x360 
0x12CB3460, 36963311568726008, 231567869, 231567872, 3, 640x360 
0x12CB3460, 36963311569046640, 231567882, 231567884, 2, 640x360 
0x12CB3460, 36963311569367720, 231567912, 231567915, 3, 640x360 
0x12CB3460, 36963311569687456, 231567942, 231567946, 4, 640x360 
0x12CB3460, 36963311570006640, 231567981, 231567984, 3, 640x360 
0x12CB3460, 36963311570326528, 231568011, 231568014, 3, 640x360 
0x12CB3460, 36963311570646064, 231568042, 231568045, 3, 640x360 
0x12CB3460, 36963311570967128, 231568071, 231568074, 3, 640x360 
0x12CB3460, 36963311571287472, 231568101, 231568108, 7, 640x360 
0x12CB3460, 36963311571606256, 231568141, 231568143, 2, 640x360 
0x12CB3460, 36963311572085560, 231568191, 231568194, 3, 640x360 
0x12CB3460, 36963311572407120, 231568221, 231568224, 3, 640x360 
0x12CB3460, 36963311572726832, 231568252, 231568254, 2, 640x360 
0x12CB3460, 36963311573046528, 231568281, 231568283, 2, 640x360 
0x12CB3460, 36963311573366320, 231568312, 231568314, 2, 640x360 
0x12CB3460, 36963311573687248, 231568341, 231568345, 4, 640x360 
0x12CB3460, 36963311574006400, 231568382, 231568385, 3, 640x360 
0x12CB3460, 36963311574326008, 231568411, 231568414, 3, 640x360 
0x12CB3460, 36963311574646608, 231568442, 231568445, 3, 640x360 
0x12CB3460, 36963311574967824, 231568472, 231568475, 3, 640x360 
0x12CB3460, 36963311575288264, 231568502, 231568506, 4, 640x360 
0x12CB3460, 36963311575607128, 231568541, 231568543, 2, 640x360 
0x12CB3460, 36963311576087440, 231568582, 231568586, 4, 640x360 
0x12CB3460, 36963311576406504, 231568622, 231568626, 4, 640x360 
0x12CB3460, 36963311576726328, 231568650, 231568653, 3, 640x360 
0x12CB3460, 36963311577046144, 231568681, 231568684, 3, 640x360 
0x12CB3460, 36963311577367352, 231568711, 231568714, 3, 640x360 
0x12CB3460, 36963311577686320, 231568742, 231568746, 4, 640x360 
0x12CB3460, 36963311578006560, 231568782, 231568787, 5, 640x360 
0x12CB3460, 36963311578326056, 231568811, 231568814, 3, 640x360 
0x12CB3460, 36963311578649664, 231568842, 231568844, 2, 640x360 
0x12CB3460, 36963311578968096, 231568875, 231568878, 3, 640x360 
0x12CB3460, 36963311579286176, 231568902, 231568906, 4, 640x360 
0x12CB3460, 36963311579606712, 231568941, 231568944, 3, 640x360 
0x12CB3460, 36963311580085888, 231568982, 231568985, 3, 640x360 
0x12CB3460, 36963311580405744, 231569022, 231569024, 2, 640x360 
0x12CB3460, 36963311580726024, 231569051, 231569054, 3, 640x360 
0x12CB3460, 36963311581046432, 231569082, 231569084, 2, 640x360 
0x12CB3460, 36963311581366536, 231569112, 231569117, 5, 640x360 
0x12CB3460, 36963311581687176, 231569151, 231569155, 4, 640x360 
0x12CB3460, 36963311582006880, 231569181, 231569183, 2, 640x360 
0x12CB3460, 36963311582325944, 231569211, 231569213, 2, 640x360 
0x12CB3460, 36963311582647008, 231569241, 231569244, 3, 640x360 
0x12CB3460, 36963311582967280, 231569272, 231569275, 3, 640x360 
0x12CB3460, 36963311583286168, 231569301, 231569306, 5, 640x360 
0x12CB3460, 36963311583766504, 231569366, 231569368, 2, 640x360 
0x12CB3460, 36963311584087520, 231569391, 231569394, 3, 640x360 
0x12CB3460, 36963311584406040, 231569421, 231569424, 3, 640x360 
0x12CB3460, 36963311584725864, 231569452, 231569455, 3, 640x360 
0x12CB3460, 36963311585045712, 231569481, 231569484, 3, 640x360 
0x12CB3460, 36963311585365968, 231569512, 231569515, 3, 640x360 
0x12CB3460, 36963311585687224, 231569542, 231569545, 3, 640x360 
0x12CB3460, 36963311586007712, 231569580, 231569585, 5, 640x360 
0x12CB3460, 36963311586326264, 231569612, 231569615, 3, 640x360 
0x12CB3460, 36963311586650056, 231569640, 231569643, 3, 640x360 
0x12CB3460, 36963311586966320, 231569671, 231569674, 3, 640x360 
0x12CB3460, 36963311587286936, 231569711, 231569714, 3, 640x360 
0x12CB3460, 36963311587765616, 231569752, 231569761, 9, 640x360 
0x12CB3460, 36963311588087280, 231569782, 231569786, 4, 640x360 
0x12CB3460, 36963311588410840, 231569821, 231569824, 3, 640x360 
0x12CB3460, 36963311588727344, 231569851, 231569854, 3, 640x360 
0x12CB3460, 36963311589046136, 231569881, 231569884, 3, 640x360 
0x12CB3460, 36963311589367304, 231569911, 231569914, 3, 640x360 
0x12CB3460, 36963311589685968, 231569942, 231569945, 3, 640x360 
0x12CB3460, 36963311590005784, 231569980, 231569983, 3, 640x360 
0x12CB3460, 36963311590327192, 231570011, 231570013, 2, 640x360 
0x12CB3460, 36963311590647608, 231570042, 231570045, 3, 640x360 
0x12CB3460, 36963311590966480, 231570072, 231570075, 3, 640x360 
0x12CB3460, 36963311591286288, 231570102, 231570105, 3, 640x360 
0x12CB3460, 36963311591766792, 231570151, 231570154, 3, 640x360 
0x12CB3460, 36963311592085696, 231570182, 231570185, 3, 640x360 
0x12CB3460, 36963311592406072, 231570220, 231570223, 3, 640x360 
0x12CB3460, 36963311592726928, 231570252, 231570254, 2, 640x360 
0x12CB3460, 36963311593047296, 231570281, 231570286, 5, 640x360 
0x12CB3460, 36963311593365928, 231570312, 231570314, 2, 640x360 
0x12CB3460, 36963311593686008, 231570342, 231570345, 3, 640x360 
0x12CB3460, 36963311594006160, 231570381, 231570385, 4, 640x360 
0x12CB3460, 36963311594325952, 231570411, 231570414, 3, 640x360 
0x12CB3460, 36963311594647200, 231570442, 231570445, 3, 640x360 
0x12CB3460, 36963311594966984, 231570471, 231570474, 3, 640x360 
0x12CB3460, 36963311595445416, 231570521, 231570524, 3, 640x360 
0x12CB3460, 36963311595765584, 231570551, 231570554, 3, 640x360 
0x12CB3460, 36963311596088248, 231570582, 231570586, 4, 640x360 
0x12CB3460, 36963311596406032, 231570621, 231570624, 3, 640x360 
0x12CB3460, 36963311596726184, 231570651, 231570655, 4, 640x360 
0x12CB3460, 36963311597046488, 231570681, 231570683, 2, 640x360 
0x12CB3460, 36963311597366072, 231570712, 231570714, 2, 640x360 
0x12CB3460, 36963311597687096, 231570742, 231570746, 4, 640x360 
0x12CB3460, 36963311598006576, 231570781, 231570784, 3, 640x360 
0x12CB3460, 36963311598327872, 231570811, 231570814, 3, 640x360 
0x12CB3460, 36963311598648808, 231570841, 231570844, 3, 640x360 
0x12CB3460, 36963311598966624, 231570873, 231570876, 3, 640x360 
0x12CB3460, 36963311599447320, 231570921, 231570924, 3, 640x360 
0x12CB3460, 36963311599765544, 231570952, 231570955, 3, 640x360 
0x12CB3460, 36963311600086152, 231570981, 231570985, 4, 640x360 
0x12CB3460, 36963311600406040, 231571021, 231571024, 3, 640x360 
0x12CB3460, 36963311600727864, 231571052, 231571054, 2, 640x360 
0x12CB3460, 36963311601046712, 231571082, 231571085, 3, 640x360 
0x12CB3460, 36963311601366328, 231571112, 231571116, 4, 640x360 
0x12CB3460, 36963311601687320, 231571142, 231571145, 3, 640x360 
0x12CB3460, 36963311602007896, 231571181, 231571186, 5, 640x360 
0x12CB3460, 36963311602326504, 231571211, 231571214, 3, 640x360 
0x12CB3460, 36963311602646112, 231571242, 231571244, 2, 640x360 
0x12CB3460, 36963311603125816, 231571292, 231571294, 2, 640x360 
0x12CB3460, 36963311603446800, 231571321, 231571324, 3, 640x360 
0x12CB3460, 36963311603767912, 231571351, 231571354, 3, 640x360 
0x12CB3460, 36963311604086080, 231571384, 231571388, 4, 640x360 
0x12CB3460, 36963311604406720, 231571422, 231571424, 2, 640x360 
0x12CB3460, 36963311604727776, 231571452, 231571455, 3, 640x360 
0x12CB3460, 36963311605045720, 231571482, 231571484, 2, 640x360 
0x12CB3460, 36963311605366976, 231571512, 231571514, 2, 640x360 
0x12CB3460, 36963311605687728, 231571551, 231571554, 3, 640x360 
0x12CB3460, 36963311606007480, 231571581, 231571585, 4, 640x360 
0x12CB3460, 36963311606328160, 231571613, 231571616, 3, 640x360 
0x12CB3460, 36963311606647048, 231571641, 231571644, 3, 640x360 
0x12CB3460, 36963311607130856, 231571691, 231571694, 3, 640x360 
0x12CB3460, 36963311607445368, 231571721, 231571732, 11, 640x360 
0x12CB3460, 36963311607766392, 231571752, 231571755, 3, 640x360 
0x12CB3460, 36963311608087040, 231571792, 231571795, 3, 640x360 
0x12CB3460, 36963311608406176, 231571821, 231571824, 3, 640x360 
0x12CB3460, 36963311608728752, 231571867, 231571871, 4, 640x360 
0x12CB3460, 36963311609046728, 231571882, 231571884, 2, 640x360 
0x12CB3460, 36963311609366968, 231571911, 231571914, 3, 640x360 
0x12CB3460, 36963311609686496, 231571951, 231571956, 5, 640x360 
0x12CB3460, 36963311610006712, 231571982, 231571985, 3, 640x360 
0x12CB3460, 36963311610329024, 231572011, 231572014, 3, 640x360 
0x12CB3460, 36963311610648768, 231572041, 231572045, 4, 640x360 
0x12CB3460, 36963311611125368, 231572091, 231572094, 3, 640x360 
0x12CB3460, 36963311611446864, 231572121, 231572124, 3, 640x360 
0x12CB3460, 36963311611765696, 231572151, 231572154, 3, 640x360 
0x12CB3460, 36963311612087176, 231572191, 231572194, 3, 640x360 
0x12CB3460, 36963311612407280, 231572221, 231572223, 2, 640x360 
0x12CB3460, 36963311612725920, 231572251, 231572254, 3, 640x360 
0x12CB3460, 36963311613046160, 231572281, 231572284, 3, 640x360 
0x12CB3460, 36963311613367840, 231572312, 231572315, 3, 640x360 
0x12CB3460, 36963311613687448, 231572342, 231572346, 4, 640x360 
0x12CB3460, 36963311614007104, 231572381, 231572384, 3, 640x360 
0x12CB3460, 36963311614326616, 231572411, 231572413, 2, 640x360 
0x12CB3460, 36963311614806984, 231572461, 231572464, 3, 640x360 
0x12CB3460, 36963311615125456, 231572490, 231572493, 3, 640x360 
0x12CB3460, 36963311615447904, 231572521, 231572524, 3, 640x360 
0x12CB3460, 36963311615767944, 231572551, 231572555, 4, 640x360 
0x12CB3460, 36963311616085888, 231572582, 231572586, 4, 640x360 
0x12CB3460, 36963311616408288, 231572621, 231572623, 2, 640x360 
0x12CB3460, 36963311616727656, 231572651, 231572654, 3, 640x360 
0x12CB3460, 36963311617046744, 231572681, 231572683, 2, 640x360 
0x12CB3460, 36963311617368664, 231572712, 231572715, 3, 640x360 
0x12CB3460, 36963311617686280, 231572742, 231572745, 3, 640x360 
0x12CB3460, 36963311618006472, 231572781, 231572786, 5, 640x360 
0x12CB3460, 36963311618327248, 231572811, 231572814, 3, 640x360 
0x12CB3460, 36963311618807640, 231572878, 231572881, 3, 640x360 
0x12CB3460, 36963311619127008, 231572891, 231572895, 4, 640x360 
0x12CB3460, 36963311619447016, 231572922, 231572924, 2, 640x360 
0x12CB3460, 36963311619767824, 231572951, 231572955, 4, 640x360 
0x12CB3460, 36963311620087528, 231572982, 231572985, 3, 640x360 
0x12CB3460, 36963311620407248, 231573021, 231573024, 3, 640x360 
0x12CB3460, 36963311620728336, 231573051, 231573054, 3, 640x360 
0x12CB3460, 36963311621046384, 231573081, 231573084, 3, 640x360 
0x12CB3460, 36963311621367216, 231573111, 231573114, 3, 640x360 
0x12CB3460, 36963311621686496, 231573142, 231573146, 4, 640x360 
0x12CB3460, 36963311622008008, 231573182, 231573184, 2, 640x360 
0x12CB3460, 36963311622328960, 231573212, 231573215, 3, 640x360 
0x12CB3460, 36963311622805832, 231573261, 231573264, 3, 640x360 
0x12CB3460, 36963311623127744, 231573293, 231573296, 3, 640x360 
0x12CB3460, 36963311623447552, 231573321, 231573324, 3, 640x360 
0x12CB3460, 36963311623768656, 231573371, 231573374, 3, 640x360 
0x12CB3460, 36963311624086888, 231573381, 231573385, 4, 640x360 
0x12CB3460, 36963311624407448, 231573421, 231573423, 2, 640x360 
0x12CB3460, 36963311624726232, 231573453, 231573457, 4, 640x360 
0x12CB3460, 36963311625045432, 231573481, 231573483, 2, 640x360 
0x12CB3460, 36963311625367024, 231573511, 231573514, 3, 640x360 
0x12CB3460, 36963311625687264, 231573551, 231573554, 3, 640x360 
0x12CB3460, 36963311626008296, 231573583, 231573587, 4, 640x360 
0x12CB3460, 36963311626487000, 231573622, 231573626, 4, 640x360 
0x12CB3460, 36963311626807368, 231573660, 231573663, 3, 640x360 
0x12CB3460, 36963311627126688, 231573691, 231573694, 3, 640x360 
0x12CB3460, 36963311627446560, 231573721, 231573724, 3, 640x360 
0x12CB3460, 36963311627766272, 231573751, 231573761, 10, 640x360 
0x12CB3460, 36963311628087400, 231573791, 231573794, 3, 640x360 
0x12CB3460, 36963311628406616, 231573822, 231573825, 3, 640x360 
0x12CB3460, 36963311628728488, 231573868, 231573871, 3, 640x360 
0x12CB3460, 36963311629046712, 231573882, 231573884, 2, 640x360 
0x12CB3460, 36963311629366832, 231573911, 231573914, 3, 640x360 
0x12CB3460, 36963311629687424, 231573942, 231573946, 4, 640x360 
0x12CB3460, 36963311630012008, 231573981, 231573984, 3, 640x360 
0x12CB3460, 36963311630487168, 231574030, 231574036, 6, 640x360 
0x12CB3460, 36963311630805880, 231574062, 231574065, 3, 640x360 
0x12CB3460, 36963311631127008, 231574091, 231574094, 3, 640x360 
0x12CB3460, 36963311631446056, 231574121, 231574127, 6, 640x360 
0x12CB3460, 36963311631766664, 231574151, 231574154, 3, 640x360 
0x12CB3460, 36963311632086136, 231574182, 231574186, 4, 640x360 
0x12CB3460, 36963311632407296, 231574221, 231574224, 3, 640x360 
0x12CB3460, 36963311632727624, 231574251, 231574254, 3, 640x360 
0x12CB3460, 36963311633046880, 231574282, 231574284, 2, 640x360 
0x12CB3460, 36963311633366912, 231574311, 231574315, 4, 640x360 
0x12CB3460, 36963311633687560, 231574342, 231574346, 4, 640x360 
0x12CB3460, 36963311634008736, 231574384, 231574387, 3, 640x360 
0x12CB3460, 36963311634487096, 231574422, 231574426, 4, 640x360 
0x12CB3460, 36963311634807408, 231574461, 231574467, 6, 640x360 
0x12CB3460, 36963311635125328, 231574490, 231574493, 3, 640x360 
0x12CB3460, 36963311635447056, 231574521, 231574524, 3, 640x360 
0x12CB3460, 36963311635766352, 231574551, 231574553, 2, 640x360 
0x12CB3460, 36963311636087216, 231574582, 231574586, 4, 640x360 
0x12CB3460, 36963311636407216, 231574622, 231574625, 3, 640x360 
0x12CB3460, 36963311636727824, 231574652, 231574655, 3, 640x360 
0x12CB3460, 36963311637047680, 231574682, 231574685, 3, 640x360 
0x12CB3460, 36963311637370280, 231574712, 231574716, 4, 640x360 
0x12CB3460, 36963311637689576, 231574743, 231574748, 5, 640x360 
0x12CB3460, 36963311638168752, 231574791, 231574795, 4, 640x360 
0x12CB3460, 36963311638487480, 231574822, 231574825, 3, 640x360 
0x12CB3460, 36963311638806680, 231574875, 231574878, 3, 640x360 
0x12CB3460, 36963311639126744, 231574891, 231574894, 3, 640x360 
0x12CB3460, 36963311639445736, 231574920, 231574923, 3, 640x360 
0x12CB3460, 36963311639767600, 231574951, 231574955, 4, 640x360 
0x12CB3460, 36963311640085552, 231574982, 231574985, 3, 640x360 
0x12CB3460, 36963311640406608, 231575021, 231575024, 3, 640x360 
0x12CB3460, 36963311640729040, 231575051, 231575054, 3, 640x360 
0x12CB3460, 36963311641046168, 231575081, 231575084, 3, 640x360 
0x12CB3460, 36963311641366872, 231575112, 231575115, 3, 640x360 
0x12CB3460, 36963311641687648, 231575143, 231575147, 4, 640x360 
0x12CB3460, 36963311642166544, 231575192, 231575195, 3, 640x360 
0x12CB3460, 36963311642487104, 231575222, 231575226, 4, 640x360 
0x12CB3460, 36963311642806200, 231575261, 231575264, 3, 640x360 
0x12CB3460, 36963311643127104, 231575292, 231575295, 3, 640x360 
0x12CB3460, 36963311643447312, 231575321, 231575323, 2, 640x360 
0x12CB3460, 36963311643767576, 231575372, 231575376, 4, 640x360 
0x12CB3460, 36963311644086232, 231575382, 231575385, 3, 640x360 
0x12CB3460, 36963311644405608, 231575414, 231575418, 4, 640x360 
0x12CB3460, 36963311644727120, 231575451, 231575454, 3, 640x360 
0x12CB3460, 36963311645047656, 231575482, 231575485, 3, 640x360 
0x12CB3460, 36963311645366056, 231575512, 231575515, 3, 640x360 
0x12CB3460, 36963311645846072, 231575561, 231575564, 3, 640x360 
0x12CB3460, 36963311646167752, 231575592, 231575596, 4, 640x360 
0x12CB3460, 36963311646488736, 231575632, 231575635, 3, 640x360 
0x12CB3460, 36963311646807456, 231575662, 231575665, 3, 640x360 
0x12CB3460, 36963311647126808, 231575692, 231575695, 3, 640x360 
0x12CB3460, 36963311647447408, 231575721, 231575724, 3, 640x360 
0x12CB3460, 36963311647766672, 231575752, 231575755, 3, 640x360 
0x12CB3460, 36963311648086616, 231575791, 231575794, 3, 640x360 
0x12CB3460, 36963311648407088, 231575821, 231575824, 3, 640x360 
0x12CB3460, 36963311648728832, 231575874, 231575881, 7, 640x360 
0x12CB3460, 36963311649046216, 231575882, 231575885, 3, 640x360 
0x12CB3460, 36963311649367728, 231575912, 231575915, 3, 640x360 
0x12CB3460, 36963311649847072, 231575962, 231575976, 14, 640x360 
0x12CB3460, 36963311650167296, 231575991, 231575994, 3, 640x360 
0x12CB3460, 36963311650487736, 231576031, 231576034, 3, 640x360 
0x12CB3460, 36963311650806896, 231576061, 231576065, 4, 640x360 
0x12CB3460, 36963311651126608, 231576091, 231576094, 3, 640x360 
0x12CB3460, 36963311651447520, 231576121, 231576123, 2, 640x360 
0x12CB3460, 36963311651767440, 231576152, 231576155, 3, 640x360 
0x12CB3460, 36963311652085880, 231576192, 231576194, 2, 640x360 
0x12CB3460, 36963311652405936, 231576221, 231576224, 3, 640x360 
0x12CB3460, 36963311652726304, 231576251, 231576254, 3, 640x360 
0x12CB3460, 36963311653046872, 231576281, 231576284, 3, 640x360 
0x12CB3460, 36963311653365688, 231576312, 231576315, 3, 640x360 
0x12CB3460, 36963311653848248, 231576368, 231576372, 4, 640x360 
0x12CB3460, 36963311654166320, 231576390, 231576394, 4, 640x360 
0x12CB3460, 36963311654485280, 231576421, 231576425, 4, 640x360 
0x12CB3460, 36963311654805328, 231576461, 231576466, 5, 640x360 
0x12CB3460, 36963311655126808, 231576492, 231576495, 3, 640x360 
0x12CB3460, 36963311655448040, 231576521, 231576523, 2, 640x360 
0x12CB3460, 36963311655767176, 231576551, 231576555, 4, 640x360 
0x12CB3460, 36963311656085896, 231576582, 231576585, 3, 640x360 
0x12CB3460, 36963311656406440, 231576622, 231576624, 2, 640x360 
0x12CB3460, 36963311656728856, 231576651, 231576655, 4, 640x360 
0x12CB3460, 36963311657048672, 231576682, 231576685, 3, 640x360 
0x12CB3460, 36963311657528080, 231576731, 231576734, 3, 640x360 
0x12CB3460, 36963311657847432, 231576761, 231576764, 3, 640x360 
0x12CB3460, 36963311658168072, 231576793, 231576796, 3, 640x360 
0x12CB3460, 36963311658487256, 231576831, 231576837, 6, 640x360 
0x12CB3460, 36963311658807472, 231576890, 231576894, 4, 640x360 
0x12CB3460, 36963311659447088, 231576922, 231576925, 3, 640x360 
0x12CB3460, 36963311659765560, 231576951, 231576954, 3, 640x360 
0x12CB3460, 36963311660087960, 231576982, 231576985, 3, 640x360 
0x12CB3460, 36963311660406680, 231577021, 231577024, 3, 640x360 
0x12CB3460, 36963311660726864, 231577051, 231577054, 3, 640x360 
0x12CB3460, 36963311661046008, 231577082, 231577084, 2, 640x360 
0x12CB3460, 36963311661525480, 231577131, 231577134, 3, 640x360 
0x12CB3460, 36963311661846312, 231577162, 231577164, 2, 640x360 
0x12CB3460, 36963311662166288, 231577191, 231577194, 3, 640x360 
0x12CB3460, 36963311662487144, 231577222, 231577226, 4, 640x360 
0x12CB3460, 36963311662806616, 231577261, 231577264, 3, 640x360 
0x12CB3460, 36963311663127056, 231577291, 231577294, 3, 640x360 
0x12CB3460, 36963311663446584, 231577321, 231577324, 3, 640x360 
0x12CB3460, 36963311663765600, 231577351, 231577354, 3, 640x360 
0x12CB3460, 36963311664086768, 231577384, 231577387, 3, 640x360 
0x12CB3460, 36963311664406504, 231577421, 231577424, 3, 640x360 
0x12CB3460, 36963311664727216, 231577452, 231577455, 3, 640x360 
0x12CB3460, 36963311665047160, 231577481, 231577485, 4, 640x360 
0x12CB3460, 36963311665526912, 231577530, 231577533, 3, 640x360 
0x12CB3460, 36963311665845936, 231577561, 231577565, 4, 640x360 
0x12CB3460, 36963311666168920, 231577592, 231577595, 3, 640x360 
0x12CB3460, 36963311666493096, 231577633, 231577637, 4, 640x360 
0x12CB3460, 36963311666806680, 231577662, 231577665, 3, 640x360 
0x12CB3460, 36963311667127768, 231577692, 231577695, 3, 640x360 
0x12CB3460, 36963311667447576, 231577721, 231577724, 3, 640x360 
0x12CB3460, 36963311667767816, 231577752, 231577756, 4, 640x360 
0x12CB3460, 36963311668086968, 231577782, 231577786, 4, 640x360 
0x12CB3460, 36963311668406960, 231577822, 231577825, 3, 640x360 
0x12CB3460, 36963311668725560, 231577873, 231577876, 3, 640x360 
0x12CB3460, 36963311669206720, 231577901, 231577904, 3, 640x360 
0x12CB3460, 36963311669527496, 231577931, 231577934, 3, 640x360 
0x12CB3460, 36963311669847288, 231577961, 231577964, 3, 640x360 
0x12CB3460, 36963311670168288, 231577991, 231577995, 4, 640x360 
0x12CB3460, 36963311670488760, 231578032, 231578035, 3, 640x360 
0x12CB3460, 36963311670808376, 231578061, 231578064, 3, 640x360 
0x12CB3460, 36963311671125416, 231578090, 231578093, 3, 640x360 
0x12CB3460, 36963311671446624, 231578122, 231578124, 2, 640x360 
0x12CB3460, 36963311671766448, 231578151, 231578154, 3, 640x360 
0x12CB3460, 36963311672085360, 231578181, 231578185, 4, 640x360 
0x12CB3460, 36963311672407688, 231578221, 231578224, 3, 640x360 
0x12CB3460, 36963311672726176, 231578251, 231578253, 2, 640x360 
0x12CB3460, 36963311673207616, 231578301, 231578304, 3, 640x360 
0x12CB3460, 36963311673526064, 231578330, 231578334, 4, 640x360 
0x12CB3460, 36963311673849880, 231578384, 231578388, 4, 640x360 
0x12CB3460, 36963311674170512, 231578391, 231578395, 4, 640x360 
0x12CB3460, 36963311674486816, 231578422, 231578425, 3, 640x360 
0x12CB3460, 36963311674808072, 231578462, 231578464, 2, 640x360 
0x12CB3460, 36963311675126672, 231578491, 231578493, 2, 640x360 
0x12CB3460, 36963311675446952, 231578522, 231578524, 2, 640x360 
0x12CB3460, 36963311675767688, 231578551, 231578556, 5, 640x360 
0x12CB3460, 36963311676087320, 231578592, 231578595, 3, 640x360 
0x12CB3460, 36963311676407032, 231578622, 231578625, 3, 640x360 
0x12CB3460, 36963311676884880, 231578670, 231578673, 3, 640x360 
0x12CB3460, 36963311677204992, 231578701, 231578704, 3, 640x360 
0x12CB3460, 36963311677526608, 231578731, 231578735, 4, 640x360 
0x12CB3460, 36963311677845312, 231578762, 231578766, 4, 640x360 
0x12CB3460, 36963311678166688, 231578791, 231578798, 7, 640x360 
0x12CB3460, 36963311678487456, 231578822, 231578825, 3, 640x360 
0x12CB3460, 36963311678806792, 231578883, 231578888, 5, 640x360 
0x12CB3460, 36963311679127688, 231578902, 231578906, 4, 640x360 
0x12CB3460, 36963311679449736, 231578921, 231578928, 7, 640x360 
0x12CB3460, 36963311679766440, 231578951, 231578959, 8, 640x360 
0x12CB3460, 36963311680085424, 231578982, 231578986, 4, 640x360 
0x12CB3460, 36963311680410288, 231579021, 231579024, 3, 640x360 
0x12CB3460, 36963311680885168, 231579063, 231579066, 3, 640x360 
0x12CB3460, 36963311681205432, 231579101, 231579104, 3, 640x360 
0x12CB3460, 36963311681525456, 231579131, 231579134, 3, 640x360 
0x12CB3460, 36963311681846240, 231579162, 231579179, 17, 640x360 
0x12CB3460, 36963311682165488, 231579191, 231579194, 3, 640x360 
0x12CB3460, 36963311682487320, 231579231, 231579234, 3, 640x360 
0x12CB3460, 36963311682805896, 231579262, 231579280, 18, 640x360 
0x12CB3460, 36963311683125384, 231579292, 231579295, 3, 640x360 
0x12CB3460, 36963311683447016, 231579321, 231579323, 2, 640x360 
0x12CB3460, 36963311683767376, 231579354, 231579358, 4, 640x360 
0x12CB3460, 36963311684085440, 231579381, 231579385, 4, 640x360 
0x12CB3460, 36963311684406376, 231579421, 231579424, 3, 640x360 
0x12CB3460, 36963311684887872, 231579462, 231579467, 5, 640x360 
0x12CB3460, 36963311685207488, 231579501, 231579504, 3, 640x360 
0x12CB3460, 36963311685525712, 231579530, 231579533, 3, 640x360 
0x12CB3460, 36963311685848768, 231579562, 231579566, 4, 640x360 
0x12CB3460, 36963311686165744, 231579592, 231579595, 3, 640x360 
0x12CB3460, 36963311686488008, 231579622, 231579627, 5, 640x360 
0x12CB3460, 36963311686805496, 231579660, 231579664, 4, 640x360 
0x12CB3460, 36963311687126400, 231579691, 231579694, 3, 640x360 
0x12CB3460, 36963311687445848, 231579720, 231579723, 3, 640x360 
0x12CB3460, 36963311687765352, 231579752, 231579755, 3, 640x360 
0x12CB3460, 36963311688085576, 231579792, 231579795, 3, 640x360 
0x12CB3460, 36963311688566832, 231579830, 231579834, 4, 640x360 
0x12CB3460, 36963311688888240, 231579867, 231579869, 2, 640x360 
0x12CB3460, 36963311689205112, 231579901, 231579907, 6, 640x360 
0x12CB3460, 36963311689525344, 231579931, 231579933, 2, 640x360 
0x12CB3460, 36963311689847528, 231579962, 231579966, 4, 640x360 
0x12CB3460, 36963311690166048, 231579992, 231579995, 3, 640x360 
0x12CB3460, 36963311690486880, 231580032, 231580037, 5, 640x360 
0x12CB3460, 36963311690805624, 231580061, 231580064, 3, 640x360 
0x12CB3460, 36963311691125712, 231580091, 231580094, 3, 640x360 
0x12CB3460, 36963311691446400, 231580121, 231580124, 3, 640x360 
0x12CB3460, 36963311691766168, 231580151, 231580157, 6, 640x360 
0x12CB3460, 36963311692086464, 231580191, 231580194, 3, 640x360 
0x12CB3460, 36963311692565152, 231580230, 231580234, 4, 640x360 
0x12CB3460, 36963311692885224, 231580262, 231580266, 4, 640x360 
0x12CB3460, 36963311693206016, 231580302, 231580304, 2, 640x360 
0x12CB3460, 36963311693526920, 231580330, 231580333, 3, 640x360 
0x12CB3460, 36963311693847584, 231580384, 231580388, 4, 640x360 
0x12CB3460, 36963311694168712, 231580392, 231580395, 3, 640x360 
0x12CB3460, 36963311694486584, 231580422, 231580426, 4, 640x360 
0x12CB3460, 36963311694805760, 231580461, 231580463, 2, 640x360 
0x12CB3460, 36963311695125224, 231580491, 231580494, 3, 640x360 
0x12CB3460, 36963311695445168, 231580522, 231580524, 2, 640x360 
0x12CB3460, 36963311695765464, 231580550, 231580553, 3, 640x360 
0x12CB3460, 36963311696087264, 231580591, 231580595, 4, 640x360 
0x12CB3460, 36963311696568440, 231580632, 231580636, 4, 640x360 
0x12CB3460, 36963311696885712, 231580671, 231580674, 3, 640x360 
0x12CB3460, 36963311697207480, 231580701, 231580704, 3, 640x360 
0x12CB3460, 36963311697527368, 231580731, 231580734, 3, 640x360 
0x12CB3460, 36963311697846688, 231580762, 231580764, 2, 640x360 
0x12CB3460, 36963311698166216, 231580791, 231580794, 3, 640x360 
0x12CB3460, 36963311698488376, 231580831, 231580835, 4, 640x360 
0x12CB3460, 36963311698808336, 231580879, 231580882, 3, 640x360 
0x12CB3460, 36963311699127064, 231580891, 231580894, 3, 640x360 
0x12CB3460, 36963311699445920, 231580920, 231580923, 3, 640x360 
0x12CB3460, 36963311699766960, 231580952, 231580955, 3, 640x360 
0x12CB3460, 36963311700247984, 231581001, 231581004, 3, 640x360 
0x12CB3460, 36963311700565224, 231581031, 231581034, 3, 640x360 
0x12CB3460, 36963311700889056, 231581071, 231581074, 3, 640x360 
0x12CB3460, 36963311701208216, 231581101, 231581104, 3, 640x360 
0x12CB3460, 36963311701525400, 231581131, 231581134, 3, 640x360 
0x12CB3460, 36963311701845544, 231581161, 231581163, 2, 640x360 
0x12CB3460, 36963311702166840, 231581192, 231581195, 3, 640x360 
0x12CB3460, 36963311702484696, 231581222, 231581225, 3, 640x360 
0x12CB3460, 36963311702805240, 231581261, 231581264, 3, 640x360 
0x12CB3460, 36963311703125800, 231581291, 231581294, 3, 640x360 
0x12CB3460, 36963311703447096, 231581321, 231581323, 2, 640x360 
0x12CB3460, 36963311703767960, 231581357, 231581364, 7, 640x360 
0x12CB3460, 36963311704244624, 231581401, 231581404, 3, 640x360 
0x12CB3460, 36963311704565096, 231581431, 231581434, 3, 640x360 
0x12CB3460, 36963311704887624, 231581472, 231581477, 5, 640x360 
0x12CB3460, 36963311705206688, 231581501, 231581504, 3, 640x360 
0x12CB3460, 36963311705527280, 231581531, 231581534, 3, 640x360 
0x12CB3460, 36963311705845800, 231581561, 231581564, 3, 640x360 
0x12CB3460, 36963311706167336, 231581592, 231581595, 3, 640x360 
0x12CB3460, 36963311706488024, 231581623, 231581627, 4, 640x360 
0x12CB3460, 36963311706808792, 231581662, 231581665, 3, 640x360 
0x12CB3460, 36963311707126984, 231581692, 231581695, 3, 640x360 
0x12CB3460, 36963311707447016, 231581721, 231581724, 3, 640x360 
0x12CB3460, 36963311707767000, 231581751, 231581754, 3, 640x360 
0x12CB3460, 36963311708248200, 231581802, 231581804, 2, 640x360 
0x12CB3460, 36963311708567880, 231581831, 231581835, 4, 640x360 
0x12CB3460, 36963311708892400, 231581886, 231581889, 3, 640x360 
0x12CB3460, 36963311709205560, 231581901, 231581903, 2, 640x360 
0x12CB3460, 36963311709524904, 231581932, 231581934, 2, 640x360 
0x12CB3460, 36963311709847328, 231581962, 231581964, 2, 640x360 
0x12CB3460, 36963311710167312, 231581991, 231581994, 3, 640x360 
0x12CB3460, 36963311710487192, 231582031, 231582035, 4, 640x360 
0x12CB3460, 36963311710807368, 231582061, 231582064, 3, 640x360 
0x12CB3460, 36963311711125736, 231582091, 231582093, 2, 640x360 
0x12CB3460, 36963311711446848, 231582121, 231582124, 3, 640x360 
0x12CB3460, 36963311711926688, 231582171, 231582174, 3, 640x360 
0x12CB3460, 36963311712244944, 231582200, 231582203, 3, 640x360 
0x12CB3460, 36963311712567080, 231582231, 231582235, 4, 640x360 
0x12CB3460, 36963311712885552, 231582271, 231582274, 3, 640x360 
0x12CB3460, 36963311713206432, 231582300, 231582303, 3, 640x360 
0x12CB3460, 36963311713528888, 231582331, 231582333, 2, 640x360 
0x12CB3460, 36963311713857312, 231582377, 231582380, 3, 640x360 
0x12CB3460, 36963311714165496, 231582391, 231582394, 3, 640x360 
0x12CB3460, 36963311714484888, 231582431, 231582434, 3, 640x360 
0x12CB3460, 36963311714806312, 231582462, 231582480, 18, 640x360 
0x12CB3460, 36963311715129024, 231582492, 231582495, 3, 640x360 
0x12CB3460, 36963311715447912, 231582521, 231582524, 3, 640x360 
0x12CB3460, 36963311715928432, 231582571, 231582574, 3, 640x360 
0x12CB3460, 36963311716247304, 231582603, 231582605, 2, 640x360 
0x12CB3460, 36963311716568968, 231582637, 231582642, 5, 640x360 
0x12CB3460, 36963311716886840, 231582671, 231582674, 3, 640x360 
0x12CB3460, 36963311717208080, 231582701, 231582703, 2, 640x360 
0x12CB3460, 36963311717527656, 231582732, 231582734, 2, 640x360 
0x12CB3460, 36963311717846440, 231582761, 231582779, 18, 640x360 
0x12CB3460, 36963311718167040, 231582793, 231582796, 3, 640x360 
0x12CB3460, 36963311718488184, 231582830, 231582833, 3, 640x360 
0x12CB3460, 36963311718806832, 231582872, 231582875, 3, 640x360 
0x12CB3460, 36963311719126048, 231582890, 231582893, 3, 640x360 
0x12CB3460, 36963311719604928, 231582941, 231582944, 3, 640x360 
0x12CB3460, 36963311719926208, 231582971, 231582973, 2, 640x360 
0x12CB3460, 36963311720245856, 231583001, 231583004, 3, 640x360 
0x12CB3460, 36963311720568760, 231583031, 231583034, 3, 640x360 
0x12CB3460, 36963311720886800, 231583061, 231583065, 4, 640x360 
0x12CB3460, 36963311721205960, 231583102, 231583105, 3, 640x360 
0x12CB3460, 36963311721526752, 231583131, 231583134, 3, 640x360 
0x12CB3460, 36963311721846640, 231583160, 231583179, 19, 640x360 
0x12CB3460, 36963311722167944, 231583192, 231583195, 3, 640x360 
0x12CB3460, 36963311722488808, 231583232, 231583235, 3, 640x360 
0x12CB3460, 36963311722807472, 231583262, 231583265, 3, 640x360 
0x12CB3460, 36963311723126336, 231583291, 231583293, 2, 640x360 
0x12CB3460, 36963311723607272, 231583341, 231583344, 3, 640x360 
0x12CB3460, 36963311723928568, 231583389, 231583392, 3, 640x360 
0x12CB3460, 36963311724245992, 231583401, 231583404, 3, 640x360 
0x12CB3460, 36963311724566528, 231583432, 231583434, 2, 640x360 
0x12CB3460, 36963311724888176, 231583471, 231583474, 3, 640x360 
0x12CB3460, 36963311725208888, 231583501, 231583506, 5, 640x360 
0x12CB3460, 36963311725526016, 231583531, 231583534, 3, 640x360 
0x12CB3460, 36963311725846848, 231583561, 231583564, 3, 640x360 
0x12CB3460, 36963311726167480, 231583593, 231583596, 3, 640x360 
0x12CB3460, 36963311726489384, 231583632, 231583636, 4, 640x360 
0x12CB3460, 36963311726809544, 231583667, 231583670, 3, 640x360 
0x12CB3460, 36963311727126744, 231583691, 231583694, 3, 640x360 
0x12CB3460, 36963311727605056, 231583742, 231583744, 2, 640x360 
0x12CB3460, 36963311727926936, 231583771, 231583774, 3, 640x360 
0x12CB3460, 36963311728247488, 231583801, 231583804, 3, 640x360 
0x12CB3460, 36963311728565744, 231583832, 231583835, 3, 640x360 
0x12CB3460, 36963311728891520, 231583875, 231583878, 3, 640x360 
0x12CB3460, 36963311729205888, 231583901, 231583904, 3, 640x360 
0x12CB3460, 36963311729526224, 231583930, 231583933, 3, 640x360 
0x12CB3460, 36963311729846800, 231583961, 231583965, 4, 640x360 
0x12CB3460, 36963311730166440, 231583990, 231583994, 4, 640x360 
0x12CB3460, 36963311730485712, 231584021, 231584024, 3, 640x360 
0x12CB3460, 36963311730807160, 231584061, 231584065, 4, 640x360 
0x12CB3460, 36963311731285056, 231584102, 231584106, 4, 640x360 
0x12CB3460, 36963311731605880, 231584141, 231584157, 16, 640x360 
0x12CB3460, 36963311731927992, 231584171, 231584174, 3, 640x360 
0x12CB3460, 36963311732245616, 231584201, 231584204, 3, 640x360 
0x12CB3460, 36963311732565368, 231584230, 231584234, 4, 640x360 
0x12CB3460, 36963311732886904, 231584271, 231584274, 3, 640x360 
0x12CB3460, 36963311733204968, 231584301, 231584304, 3, 640x360 
0x12CB3460, 36963311733524944, 231584330, 231584333, 3, 640x360 
0x12CB3460, 36963311733846896, 231584371, 231584374, 3, 640x360 
0x12CB3460, 36963311734165544, 231584391, 231584393, 2, 640x360 
0x12CB3460, 36963311734486960, 231584422, 231584426, 4, 640x360 
0x12CB3460, 36963311734806208, 231584462, 231584465, 3, 640x360 
0x12CB3460, 36963311735286608, 231584512, 231584514, 2, 640x360 
0x12CB3460, 36963311735605144, 231584541, 231584543, 2, 640x360 
0x12CB3460, 36963311735925208, 231584571, 231584574, 3, 640x360 
0x12CB3460, 36963311736248288, 231584602, 231584605, 3, 640x360 
0x12CB3460, 36963311736568176, 231584631, 231584635, 4, 640x360 
0x12CB3460, 36963311736886504, 231584662, 231584666, 4, 640x360 
0x12CB3460, 36963311737207136, 231584701, 231584704, 3, 640x360 
0x12CB3460, 36963311737526632, 231584731, 231584733, 2, 640x360 
0x12CB3460, 36963311737847448, 231584762, 231584765, 3, 640x360 
0x12CB3460, 36963311738166768, 231584791, 231584794, 3, 640x360 
0x12CB3460, 36963311738487312, 231584822, 231584826, 4, 640x360 
0x12CB3460, 36963311738806952, 231584880, 231584884, 4, 640x360 
0x12CB3460, 36963311739286224, 231584911, 231584914, 3, 640x360 
0x12CB3460, 36963311739605416, 231584940, 231584943, 3, 640x360 
0x12CB3460, 36963311739926728, 231584971, 231584975, 4, 640x360 
0x12CB3460, 36963311740244704, 231585000, 231585003, 3, 640x360 
0x12CB3460, 36963311740566424, 231585031, 231585035, 4, 640x360 
0x12CB3460, 36963311740884760, 231585061, 231585065, 4, 640x360 
0x12CB3460, 36963311741205816, 231585101, 231585104, 3, 640x360 
0x12CB3460, 36963311741526712, 231585132, 231585135, 3, 640x360 
0x12CB3460, 36963311741846040, 231585162, 231585165, 3, 640x360 
0x12CB3460, 36963311742166888, 231585191, 231585194, 3, 640x360 
0x12CB3460, 36963311742487160, 231585231, 231585233, 2, 640x360 
0x12CB3460, 36963311742966584, 231585270, 231585274, 4, 640x360 
0x12CB3460, 36963311743284976, 231585302, 231585306, 4, 640x360 
0x12CB3460, 36963311743605296, 231585341, 231585344, 3, 640x360 
0x12CB3460, 36963311743925368, 231585377, 231585380, 3, 640x360 
0x12CB3460, 36963311744244704, 231585402, 231585404, 2, 640x360 
0x12CB3460, 36963311744566344, 231585432, 231585434, 2, 640x360 
0x12CB3460, 36963311744887560, 231585462, 231585466, 4, 640x360 
0x12CB3460, 36963311745205904, 231585501, 231585504, 3, 640x360 
0x12CB3460, 36963311745526176, 231585531, 231585533, 2, 640x360 
0x12CB3460, 36963311745845640, 231585562, 231585564, 2, 640x360 
0x12CB3460, 36963311746167248, 231585592, 231585596, 4, 640x360 
0x12CB3460, 36963311746488880, 231585632, 231585636, 4, 640x360 
0x12CB3460, 36963311746968200, 231585671, 231585675, 4, 640x360 
0x12CB3460, 36963311747286400, 231585702, 231585713, 11, 640x360 
0x12CB3460, 36963311747607160, 231585742, 231585745, 3, 640x360 
0x12CB3460, 36963311747927600, 231585772, 231585775, 3, 640x360 
0x12CB3460, 36963311748247672, 231585801, 231585804, 3, 640x360 
0x12CB3460, 36963311748567304, 231585832, 231585835, 3, 640x360 
0x12CB3460, 36963311748888208, 231585875, 231585878, 3, 640x360 
0x12CB3460, 36963311749205496, 231585901, 231585904, 3, 640x360 
0x12CB3460, 36963311749525816, 231585931, 231585934, 3, 640x360 
0x12CB3460, 36963311749846952, 231585962, 231585965, 3, 640x360 
0x12CB3460, 36963311750165648, 231585991, 231585994, 3, 640x360 
0x12CB3460, 36963311750646120, 231586041, 231586045, 4, 640x360 
0x12CB3460, 36963311750965672, 231586071, 231586073, 2, 640x360 
0x12CB3460, 36963311751286248, 231586102, 231586106, 4, 640x360 
0x12CB3460, 36963311751604680, 231586140, 231586157, 17, 640x360 
0x12CB3460, 36963311751926568, 231586171, 231586174, 3, 640x360 
0x12CB3460, 36963311752246968, 231586201, 231586203, 2, 640x360 
0x12CB3460, 36963311752564944, 231586232, 231586235, 3, 640x360 
0x12CB3460, 36963311752884520, 231586262, 231586266, 4, 640x360 
0x12CB3460, 36963311753205720, 231586301, 231586304, 3, 640x360 
0x12CB3460, 36963311753527336, 231586330, 231586333, 3, 640x360 
0x12CB3460, 36963311753845576, 231586374, 231586377, 3, 640x360 
0x12CB3460, 36963311754164968, 231586391, 231586394, 3, 640x360 
0x12CB3460, 36963311754644880, 231586442, 231586445, 3, 640x360 
0x12CB3460, 36963311754967136, 231586471, 231586475, 4, 640x360 
0x12CB3460, 36963311755285680, 231586503, 231586506, 3, 640x360 
0x12CB3460, 36963311755605640, 231586542, 231586545, 3, 640x360 
0x12CB3460, 36963311755927952, 231586571, 231586574, 3, 640x360 
0x12CB3460, 36963311756249792, 231586602, 231586605, 3, 640x360 
0x12CB3460, 36963311756567040, 231586633, 231586636, 3, 640x360 
0x12CB3460, 36963311756886176, 231586663, 231586667, 4, 640x360 
0x12CB3460, 36963311757205064, 231586701, 231586703, 2, 640x360 
0x12CB3460, 36963311757527376, 231586732, 231586735, 3, 640x360 
0x12CB3460, 36963311757845856, 231586762, 231586764, 2, 640x360 
0x12CB3460, 36963311758168592, 231586793, 231586796, 3, 640x360 
0x12CB3460, 36963311758645600, 231586842, 231586844, 2, 640x360 
0x12CB3460, 36963311758968432, 231586884, 231586887, 3, 640x360 
0x12CB3460, 36963311759284496, 231586901, 231586905, 4, 640x360 
0x12CB3460, 36963311759604776, 231586941, 231586944, 3, 640x360 
0x12CB3460, 36963311759924504, 231586971, 231586973, 2, 640x360 
0x12CB3460, 36963311760246712, 231587001, 231587004, 3, 640x360 
0x12CB3460, 36963311760566320, 231587031, 231587034, 3, 640x360 
0x12CB3460, 36963311760885176, 231587062, 231587066, 4, 640x360 
0x12CB3460, 36963311761205072, 231587102, 231587112, 10, 640x360 
0x12CB3460, 36963311761526504, 231587131, 231587134, 3, 640x360 
0x12CB3460, 36963311761846080, 231587161, 231587164, 3, 640x360 
0x12CB3460, 36963311762326592, 231587211, 231587214, 3, 640x360 
0x12CB3460, 36963311762645680, 231587240, 231587243, 3, 640x360 
0x12CB3460, 36963311762964640, 231587271, 231587274, 3, 640x360 
0x12CB3460, 36963311763286632, 231587302, 231587307, 5, 640x360 
0x12CB3460, 36963311763606176, 231587341, 231587344, 3, 640x360 
0x12CB3460, 36963311763928080, 231587376, 231587379, 3, 640x360 
0x12CB3460, 36963311764246944, 231587401, 231587404, 3, 640x360 
0x12CB3460, 36963311764564648, 231587432, 231587435, 3, 640x360 
0x12CB3460, 36963311764885152, 231587462, 231587466, 4, 640x360 
0x12CB3460, 36963311765208752, 231587502, 231587505, 3, 640x360 
0x12CB3460, 36963311765525960, 231587531, 231587535, 4, 640x360 
0x12CB3460, 36963311765846112, 231587562, 231587564, 2, 640x360 
0x12CB3460, 36963311766328120, 231587613, 231587616, 3, 640x360 
0x12CB3460, 36963311766646920, 231587643, 231587647, 4, 640x360 
0x12CB3460, 36963311766966520, 231587670, 231587674, 4, 640x360 
0x12CB3460, 36963311767286080, 231587702, 231587706, 4, 640x360 
0x12CB3460, 36963311767606896, 231587734, 231587738, 4, 640x360 
0x12CB3460, 36963311767927000, 231587771, 231587774, 3, 640x360 
0x12CB3460, 36963311768246328, 231587801, 231587804, 3, 640x360 
0x12CB3460, 36963311768566352, 231587831, 231587834, 3, 640x360 
0x12CB3460, 36963311768889744, 231587875, 231587887, 12, 640x360 
0x12CB3460, 36963311769204944, 231587901, 231587904, 3, 640x360 
0x12CB3460, 36963311769526928, 231587930, 231587933, 3, 640x360 
0x12CB3460, 36963311769847280, 231587962, 231587965, 3, 640x360 
0x12CB3460, 36963311770326672, 231588011, 231588014, 3, 640x360 
0x12CB3460, 36963311770645352, 231588041, 231588044, 3, 640x360 
0x12CB3460, 36963311770964712, 231588071, 231588074, 3, 640x360 
0x12CB3460, 36963311771284224, 231588102, 231588105, 3, 640x360 
0x12CB3460, 36963311771606904, 231588142, 231588144, 2, 640x360 
0x12CB3460, 36963311771925936, 231588171, 231588174, 3, 640x360 
0x12CB3460, 36963311772245792, 231588201, 231588204, 3, 640x360 
0x12CB3460, 36963311772565768, 231588231, 231588234, 3, 640x360 
0x12CB3460, 36963311772886296, 231588262, 231588267, 5, 640x360 
0x12CB3460, 36963311773205744, 231588300, 231588303, 3, 640x360 
0x12CB3460, 36963311773530472, 231588331, 231588334, 3, 640x360 
0x12CB3460, 36963311774004440, 231588376, 231588379, 3, 640x360 
0x12CB3460, 36963311774324072, 231588412, 231588414, 2, 640x360 
0x12CB3460, 36963311774644680, 231588441, 231588444, 3, 640x360 
0x12CB3460, 36963311774965272, 231588472, 231588474, 2, 640x360 
0x12CB3460, 36963311775286296, 231588502, 231588506, 4, 640x360 
0x12CB3460, 36963311775607904, 231588541, 231588544, 3, 640x360 
0x12CB3460, 36963311775927952, 231588571, 231588574, 3, 640x360 
0x12CB3460, 36963311776249272, 231588602, 231588606, 4, 640x360 
0x12CB3460, 36963311776566640, 231588632, 231588636, 4, 640x360 
0x12CB3460, 36963311776889872, 231588664, 231588667, 3, 640x360 
0x12CB3460, 36963311777205104, 231588701, 231588704, 3, 640x360 
0x12CB3460, 36963311777525272, 231588732, 231588735, 3, 640x360 
0x12CB3460, 36963311778004696, 231588781, 231588784, 3, 640x360 
0x12CB3460, 36963311778326256, 231588811, 231588814, 3, 640x360 
0x12CB3460, 36963311778646792, 231588841, 231588843, 2, 640x360 
0x12CB3460, 36963311778965168, 231588875, 231588878, 3, 640x360 
0x12CB3460, 36963311779285920, 231588901, 231588905, 4, 640x360 
0x12CB3460, 36963311779606504, 231588941, 231588944, 3, 640x360 
0x12CB3460, 36963311779925904, 231588971, 231588973, 2, 640x360 
0x12CB3460, 36963311780245248, 231589001, 231589004, 3, 640x360 
0x12CB3460, 36963311780566032, 231589030, 231589034, 4, 640x360 
0x12CB3460, 36963311780885272, 231589061, 231589065, 4, 640x360 
0x12CB3460, 36963311781205080, 231589100, 231589103, 3, 640x360 
0x12CB3460, 36963311781525496, 231589131, 231589134, 3, 640x360 
0x12CB3460, 36963311782007264, 231589181, 231589183, 2, 640x360 
0x12CB3460, 36963311782327368, 231589212, 231589215, 3, 640x360 
0x12CB3460, 36963311782646528, 231589243, 231589246, 3, 640x360 
0x12CB3460, 36963311782967984, 231589271, 231589274, 3, 640x360 
0x12CB3460, 36963311783288568, 231589312, 231589317, 5, 640x360 
0x12CB3460, 36963311783607560, 231589341, 231589344, 3, 640x360 
0x12CB3460, 36963311783926976, 231589379, 231589382, 3, 640x360 
0x12CB3460, 36963311784245184, 231589401, 231589408, 7, 640x360 
0x12CB3460, 36963311784565784, 231589431, 231589434, 3, 640x360 
0x12CB3460, 36963311784886592, 231589462, 231589466, 4, 640x360 
0x12CB3460, 36963311785205800, 231589502, 231589504, 2, 640x360 
0x12CB3460, 36963311785687120, 231589551, 231589554, 3, 640x360 
0x12CB3460, 36963311786005600, 231589581, 231589584, 3, 640x360 
0x12CB3460, 36963311786327912, 231589612, 231589616, 4, 640x360 
0x12CB3460, 36963311786648376, 231589644, 231589647, 3, 640x360 
0x12CB3460, 36963311786966032, 231589671, 231589674, 3, 640x360 
0x12CB3460, 36963311787285176, 231589702, 231589706, 4, 640x360 
0x12CB3460, 36963311787605360, 231589742, 231589745, 3, 640x360 
0x12CB3460, 36963311787925264, 231589771, 231589774, 3, 640x360 
0x12CB3460, 36963311788246552, 231589801, 231589804, 3, 640x360 
0x12CB3460, 36963311788565856, 231589832, 231589835, 3, 640x360 
0x12CB3460, 36963311788889464, 231589873, 231589877, 4, 640x360 
0x12CB3460, 36963311789206144, 231589901, 231589904, 3, 640x360 
0x12CB3460, 36963311789686232, 231589942, 231589946, 4, 640x360 
0x12CB3460, 36963311790004456, 231589980, 231589983, 3, 640x360 
0x12CB3460, 36963311790326048, 231590011, 231590014, 3, 640x360 
0x12CB3460, 36963311790645168, 231590041, 231590045, 4, 640x360 
0x12CB3460, 36963311790966008, 231590071, 231590074, 3, 640x360 
0x12CB3460, 36963311791286224, 231590111, 231590114, 3, 640x360 
0x12CB3460, 36963311791606744, 231590141, 231590144, 3, 640x360 
0x12CB3460, 36963311791925904, 231590171, 231590174, 3, 640x360 
0x12CB3460, 36963311792246176, 231590201, 231590204, 3, 640x360 
0x12CB3460, 36963311792566040, 231590230, 231590234, 4, 640x360 
0x12CB3460, 36963311792886416, 231590262, 231590266, 4, 640x360 
0x12CB3460, 36963311793365952, 231590312, 231590315, 3, 640x360 
0x12CB3460, 36963311793685360, 231590342, 231590346, 4, 640x360 
0x12CB3460, 36963311794004560, 231590374, 231590378, 4, 640x360 
0x12CB3460, 36963311794325632, 231590412, 231590414, 2, 640x360 
0x12CB3460, 36963311794644888, 231590441, 231590444, 3, 640x360 
0x12CB3460, 36963311794966248, 231590471, 231590474, 3, 640x360 
0x12CB3460, 36963311795285088, 231590502, 231590505, 3, 640x360 
0x12CB3460, 36963311795605696, 231590541, 231590543, 2, 640x360 
0x12CB3460, 36963311795924464, 231590571, 231590574, 3, 640x360 
0x12CB3460, 36963311796245680, 231590601, 231590603, 2, 640x360 
0x12CB3460, 36963311796565776, 231590632, 231590634, 2, 640x360 
0x12CB3460, 36963311796885320, 231590671, 231590674, 3, 640x360 
0x12CB3460, 36963311797365424, 231590712, 231590715, 3, 640x360 
0x12CB3460, 36963311797685552, 231590742, 231590745, 3, 640x360 
0x12CB3460, 36963311798004768, 231590781, 231590784, 3, 640x360 
0x12CB3460, 36963311798325064, 231590810, 231590814, 4, 640x360 
0x12CB3460, 36963311798646728, 231590841, 231590844, 3, 640x360 
0x12CB3460, 36963311798967992, 231590883, 231590886, 3, 640x360 
0x12CB3460, 36963311799284704, 231590902, 231590905, 3, 640x360 
0x12CB3460, 36963311799604768, 231590942, 231590944, 2, 640x360 
0x12CB3460, 36963311799926056, 231590971, 231590973, 2, 640x360 
0x12CB3460, 36963311800247744, 231591001, 231591003, 2, 640x360 
0x12CB3460, 36963311800565048, 231591032, 231591034, 2, 640x360 
0x12CB3460, 36963311800885960, 231591062, 231591066, 4, 640x360 
0x12CB3460, 36963311801365440, 231591111, 231591115, 4, 640x360 
0x12CB3460, 36963311801685680, 231591142, 231591146, 4, 640x360 
0x12CB3460, 36963311802005888, 231591181, 231591184, 3, 640x360 
0x12CB3460, 36963311802325296, 231591212, 231591215, 3, 640x360 
0x12CB3460, 36963311802645384, 231591241, 231591244, 3, 640x360 
0x12CB3460, 36963311802964608, 231591272, 231591275, 3, 640x360 
0x12CB3460, 36963311803285872, 231591302, 231591306, 4, 640x360 
0x12CB3460, 36963311803607648, 231591341, 231591344, 3, 640x360 
0x12CB3460, 36963311803926232, 231591375, 231591379, 4, 640x360 
0x12CB3460, 36963311804244408, 231591400, 231591404, 4, 640x360 
0x12CB3460, 36963311804565840, 231591431, 231591434, 3, 640x360 
0x12CB3460, 36963311805046896, 231591481, 231591484, 3, 640x360 
0x12CB3460, 36963311805364368, 231591511, 231591515, 4, 640x360 
0x12CB3460, 36963311805683960, 231591541, 231591545, 4, 640x360 
0x12CB3460, 36963311806004832, 231591581, 231591584, 3, 640x360 
0x12CB3460, 36963311806325432, 231591611, 231591614, 3, 640x360 
0x12CB3460, 36963311806645976, 231591643, 231591646, 3, 640x360 
0x12CB3460, 36963311806964568, 231591671, 231591674, 3, 640x360 
0x12CB3460, 36963311807285352, 231591702, 231591705, 3, 640x360 
0x12CB3460, 36963311807605616, 231591740, 231591743, 3, 640x360 
0x12CB3460, 36963311807924360, 231591771, 231591774, 3, 640x360 
0x12CB3460, 36963311808246840, 231591801, 231591803, 2, 640x360 
0x12CB3460, 36963311808567056, 231591833, 231591836, 3, 640x360 
0x12CB3460, 36963311809043928, 231591881, 231591883, 2, 640x360 
0x12CB3460, 36963311809363928, 231591911, 231591915, 4, 640x360 
0x12CB3460, 36963311809684896, 231591943, 231591946, 3, 640x360 
0x12CB3460, 36963311810004264, 231591981, 231591984, 3, 640x360 
0x12CB3460, 36963311810325728, 231592010, 231592015, 5, 640x360 
0x12CB3460, 36963311810645008, 231592042, 231592045, 3, 640x360 
0x12CB3460, 36963311810965800, 231592072, 231592074, 2, 640x360 
0x12CB3460, 36963311811285624, 231592102, 231592106, 4, 640x360 
0x12CB3460, 36963311811605888, 231592141, 231592144, 3, 640x360 
0x12CB3460, 36963311811925208, 231592171, 231592173, 2, 640x360 
0x12CB3460, 36963311812245368, 231592201, 231592204, 3, 640x360 
0x12CB3460, 36963311812566296, 231592231, 231592234, 3, 640x360 
0x12CB3460, 36963311813045672, 231592282, 231592284, 2, 640x360 
0x12CB3460, 36963311813364528, 231592311, 231592314, 3, 640x360 
0x12CB3460, 36963311813685264, 231592342, 231592345, 3, 640x360 
0x12CB3460, 36963311814004952, 231592379, 231592382, 3, 640x360 
0x12CB3460, 36963311814326672, 231592411, 231592414, 3, 640x360 
0x12CB3460, 36963311814644920, 231592440, 231592443, 3, 640x360 
0x12CB3460, 36963311814965528, 231592472, 231592475, 3, 640x360 
0x12CB3460, 36963311815287232, 231592502, 231592507, 5, 640x360 
0x12CB3460, 36963311815605792, 231592542, 231592545, 3, 640x360 
0x12CB3460, 36963311815925632, 231592571, 231592574, 3, 640x360 
0x12CB3460, 36963311816246424, 231592602, 231592604, 2, 640x360 
0x12CB3460, 36963311816725200, 231592652, 231592656, 4, 640x360 
0x12CB3460, 36963311817044408, 231592681, 231592684, 3, 640x360 
0x12CB3460, 36963311817364504, 231592712, 231592714, 2, 640x360 
0x12CB3460, 36963311817687088, 231592742, 231592745, 3, 640x360 
0x12CB3460, 36963311818006176, 231592781, 231592784, 3, 640x360 
0x12CB3460, 36963311818326608, 231592811, 231592814, 3, 640x360 
0x12CB3460, 36963311818646928, 231592841, 231592844, 3, 640x360 
0x12CB3460, 36963311818966032, 231592891, 231592894, 3, 640x360 
0x12CB3460, 36963311819284160, 231592911, 231592914, 3, 640x360 
0x12CB3460, 36963311819604800, 231592940, 231592943, 3, 640x360 
0x12CB3460, 36963311819926008, 231592972, 231592975, 3, 640x360 
0x12CB3460, 36963311820245752, 231593000, 231593003, 3, 640x360 
0x12CB3460, 36963311820726736, 231593052, 231593055, 3, 640x360 
0x12CB3460, 36963311821045328, 231593081, 231593083, 2, 640x360 
0x12CB3460, 36963311821364432, 231593112, 231593115, 3, 640x360 
0x12CB3460, 36963311821684216, 231593152, 231593154, 2, 640x360 
0x12CB3460, 36963311822006416, 231593181, 231593184, 3, 640x360 
0x12CB3460, 36963311822325608, 231593211, 231593214, 3, 640x360 
0x12CB3460, 36963311822644400, 231593240, 231593243, 3, 640x360 
0x12CB3460, 36963311822966056, 231593271, 231593275, 4, 640x360 
0x12CB3460, 36963311823285480, 231593311, 231593314, 3, 640x360 
0x12CB3460, 36963311823605608, 231593334, 231593339, 5, 640x360 
0x12CB3460, 36963311823927008, 231593382, 231593388, 6, 640x360 
0x12CB3460, 36963311824245512, 231593401, 231593404, 3, 640x360 
0x12CB3460, 36963311824724448, 231593451, 231593454, 3, 640x360 
0x12CB3460, 36963311825047184, 231593481, 231593484, 3, 640x360 
0x12CB3460, 36963311825366416, 231593511, 231593515, 4, 640x360 
0x12CB3460, 36963311825686912, 231593542, 231593561, 19, 640x360 
0x12CB3460, 36963311826006200, 231593581, 231593584, 3, 640x360 
0x12CB3460, 36963311826331872, 231593613, 231593617, 4, 640x360 
0x12CB3460, 36963311826646328, 231593641, 231593644, 3, 640x360 
0x12CB3460, 36963311826967048, 231593671, 231593675, 4, 640x360 
0x12CB3460, 36963311827284496, 231593702, 231593705, 3, 640x360 
0x12CB3460, 36963311827606696, 231593742, 231593744, 2, 640x360 
0x12CB3460, 36963311827926040, 231593771, 231593774, 3, 640x360 
0x12CB3460, 36963311828404720, 231593814, 231593818, 4, 640x360 
0x12CB3460, 36963311828724344, 231593850, 231593853, 3, 640x360 
0x12CB3460, 36963311829045384, 231593889, 231593892, 3, 640x360 
0x12CB3460, 36963311829363896, 231593911, 231593914, 3, 640x360 
0x12CB3460, 36963311829685800, 231593951, 231593953, 2, 640x360 
0x12CB3460, 36963311830005416, 231593981, 231593984, 3, 640x360 
0x12CB3460, 36963311830325720, 231594011, 231594014, 3, 640x360 
0x12CB3460, 36963311830647856, 231594041, 231594044, 3, 640x360 
0x12CB3460, 36963311830964856, 231594070, 231594073, 3, 640x360 
0x12CB3460, 36963311831284720, 231594102, 231594105, 3, 640x360 
0x12CB3460, 36963311831606232, 231594141, 231594144, 3, 640x360 
0x12CB3460, 36963311831925920, 231594170, 231594173, 3, 640x360 
0x12CB3460, 36963311832405272, 231594221, 231594224, 3, 640x360 
0x12CB3460, 36963311832725000, 231594251, 231594254, 3, 640x360 
0x12CB3460, 36963311833045208, 231594281, 231594284, 3, 640x360 
0x12CB3460, 36963311833365584, 231594311, 231594315, 4, 640x360 
0x12CB3460, 36963311833684536, 231594342, 231594355, 13, 640x360 
0x12CB3460, 36963311834005776, 231594381, 231594384, 3, 640x360 
0x12CB3460, 36963311834324200, 231594412, 231594415, 3, 640x360 
0x12CB3460, 36963311834645176, 231594442, 231594444, 2, 640x360 
0x12CB3460, 36963311834966272, 231594472, 231594475, 3, 640x360 
0x12CB3460, 36963311835285840, 231594504, 231594507, 3, 640x360 
0x12CB3460, 36963311835606720, 231594541, 231594544, 3, 640x360 
0x12CB3460, 36963311836087656, 231594583, 231594586, 3, 640x360 
0x12CB3460, 36963311836405216, 231594621, 231594624, 3, 640x360 
0x12CB3460, 36963311836726216, 231594652, 231594656, 4, 640x360 
0x12CB3460, 36963311837046304, 231594681, 231594684, 3, 640x360 
0x12CB3460, 36963311837367568, 231594711, 231594716, 5, 640x360 
0x12CB3460, 36963311837685416, 231594742, 231594745, 3, 640x360 
0x12CB3460, 36963311838004800, 231594781, 231594784, 3, 640x360 
0x12CB3460, 36963311838324800, 231594811, 231594814, 3, 640x360 
0x12CB3460, 36963311838646704, 231594841, 231594845, 4, 640x360 
0x12CB3460, 36963311838965624, 231594876, 231594879, 3, 640x360 
0x12CB3460, 36963311839285720, 231594912, 231594915, 3, 640x360 
0x12CB3460, 36963311839606136, 231594941, 231594944, 3, 640x360 
0x12CB3460, 36963311840086056, 231594991, 231594994, 3, 640x360 
0x12CB3460, 36963311840405056, 231595020, 231595024, 4, 640x360 
0x12CB3460, 36963311840725840, 231595050, 231595053, 3, 640x360 
0x12CB3460, 36963311841045248, 231595081, 231595083, 2, 640x360 
0x12CB3460, 36963311841365640, 231595111, 231595114, 3, 640x360 
0x12CB3460, 36963311841685952, 231595143, 231595147, 4, 640x360 
0x12CB3460, 36963311842007536, 231595182, 231595185, 3, 640x360 
0x12CB3460, 36963311842325624, 231595211, 231595214, 3, 640x360 
0x12CB3460, 36963311842645072, 231595240, 231595243, 3, 640x360 
0x12CB3460, 36963311842964584, 231595272, 231595274, 2, 640x360 
0x12CB3460, 36963311843286744, 231595312, 231595316, 4, 640x360 
0x12CB3460, 36963311843605784, 231595342, 231595345, 3, 640x360 
0x12CB3460, 36963311844085608, 231595382, 231595386, 4, 640x360 
0x12CB3460, 36963311844405952, 231595421, 231595424, 3, 640x360 
0x12CB3460, 36963311844724384, 231595451, 231595454, 3, 640x360 
0x12CB3460, 36963311845045600, 231595481, 231595484, 3, 640x360 
0x12CB3460, 36963311845365688, 231595511, 231595515, 4, 640x360 
0x12CB3460, 36963311845686472, 231595542, 231595546, 4, 640x360 
0x12CB3460, 36963311846006432, 231595582, 231595584, 2, 640x360 
0x12CB3460, 36963311846327208, 231595611, 231595614, 3, 640x360 
0x12CB3460, 36963311846646840, 231595641, 231595645, 4, 640x360 
0x12CB3460, 36963311846966440, 231595672, 231595675, 3, 640x360 
0x12CB3460, 36963311847286944, 231595711, 231595714, 3, 640x360 
0x12CB3460, 36963311847765392, 231595752, 231595756, 4, 640x360 
0x12CB3460, 36963311848086744, 231595783, 231595787, 4, 640x360 
0x12CB3460, 36963311848404904, 231595822, 231595825, 3, 640x360 
0x12CB3460, 36963311848724936, 231595875, 231595879, 4, 640x360 
0x12CB3460, 36963311849044760, 231595892, 231595895, 3, 640x360 
0x12CB3460, 36963311849365072, 231595911, 231595914, 3, 640x360 
0x12CB3460, 36963311849684120, 231595941, 231595945, 4, 640x360 
0x12CB3460, 36963311850004120, 231595981, 231595986, 5, 640x360 
0x12CB3460, 36963311850323624, 231596010, 231596014, 4, 640x360 
0x12CB3460, 36963311850644296, 231596041, 231596044, 3, 640x360 
0x12CB3460, 36963311850964968, 231596070, 231596073, 3, 640x360 
0x12CB3460, 36963311851284528, 231596102, 231596105, 3, 640x360 
0x12CB3460, 36963311851768896, 231596152, 231596155, 3, 640x360 
0x12CB3460, 36963311852085576, 231596182, 231596186, 4, 640x360 
0x12CB3460, 36963311852403960, 231596221, 231596224, 3, 640x360 
0x12CB3460, 36963311852727192, 231596250, 231596253, 3, 640x360 
0x12CB3460, 36963311853044312, 231596282, 231596284, 2, 640x360 
0x12CB3460, 36963311853365632, 231596311, 231596314, 3, 640x360 
0x12CB3460, 36963311853684680, 231596341, 231596347, 6, 640x360 
0x12CB3460, 36963311854005248, 231596381, 231596384, 3, 640x360 
0x12CB3460, 36963311854323864, 231596411, 231596415, 4, 640x360 
0x12CB3460, 36963311854646432, 231596442, 231596444, 2, 640x360 
0x12CB3460, 36963311854964640, 231596471, 231596474, 3, 640x360 
0x12CB3460, 36963311855285384, 231596502, 231596506, 4, 640x360 
0x12CB3460, 36963311855765752, 231596551, 231596554, 3, 640x360 
0x12CB3460, 36963311856084192, 231596582, 231596586, 4, 640x360 
0x12CB3460, 36963311856405000, 231596622, 231596637, 15, 640x360 
0x12CB3460, 36963311856725208, 231596653, 231596656, 3, 640x360 
0x12CB3460, 36963311857045232, 231596681, 231596683, 2, 640x360 
0x12CB3460, 36963311857365864, 231596712, 231596715, 3, 640x360 
0x12CB3460, 36963311857684000, 231596751, 231596753, 2, 640x360 
0x12CB3460, 36963311858004312, 231596781, 231596783, 2, 640x360 
0x12CB3460, 36963311858324648, 231596812, 231596816, 4, 640x360 
0x12CB3460, 36963311858646024, 231596841, 231596844, 3, 640x360 
0x12CB3460, 36963311858965992, 231596876, 231596879, 3, 640x360 
0x12CB3460, 36963311859445512, 231596920, 231596923, 3, 640x360 
0x12CB3460, 36963311859764104, 231596951, 231596955, 4, 640x360 
0x12CB3460, 36963311860085456, 231596982, 231596985, 3, 640x360 
0x12CB3460, 36963311860404400, 231597021, 231597024, 3, 640x360 
0x12CB3460, 36963311860725128, 231597051, 231597054, 3, 640x360 
0x12CB3460, 36963311861044176, 231597081, 231597083, 2, 640x360 
0x12CB3460, 36963311861364632, 231597112, 231597114, 2, 640x360 
0x12CB3460, 36963311861683952, 231597141, 231597145, 4, 640x360 
0x12CB3460, 36963311862004464, 231597180, 231597183, 3, 640x360 
0x12CB3460, 36963311862324840, 231597211, 231597214, 3, 640x360 
0x12CB3460, 36963311862647448, 231597242, 231597245, 3, 640x360 
0x12CB3460, 36963311862965008, 231597271, 231597274, 3, 640x360 
0x12CB3460, 36963311863444640, 231597322, 231597325, 3, 640x360 
0x12CB3460, 36963311863766328, 231597374, 231597377, 3, 640x360 
0x12CB3460, 36963311864084968, 231597382, 231597386, 4, 640x360 
0x12CB3460, 36963311864405448, 231597421, 231597437, 16, 640x360 
0x12CB3460, 36963311864724736, 231597451, 231597454, 3, 640x360 
0x12CB3460, 36963311865047280, 231597481, 231597484, 3, 640x360 
0x12CB3460, 36963311865365256, 231597512, 231597515, 3, 640x360 
0x12CB3460, 36963311865685224, 231597542, 231597546, 4, 640x360 
0x12CB3460, 36963311866005216, 231597581, 231597585, 4, 640x360 
0x12CB3460, 36963311866324896, 231597611, 231597614, 3, 640x360 
0x12CB3460, 36963311866647560, 231597641, 231597644, 3, 640x360 
0x12CB3460, 36963311867124736, 231597691, 231597694, 3, 640x360 
0x12CB3460, 36963311867445576, 231597722, 231597725, 3, 640x360 
0x12CB3460, 36963311867764952, 231597752, 231597754, 2, 640x360 
0x12CB3460, 36963311868084344, 231597782, 231597785, 3, 640x360 
0x12CB3460, 36963311868407040, 231597821, 231597824, 3, 640x360 
0x12CB3460, 36963311868724176, 231597870, 231597873, 3, 640x360 
0x12CB3460, 36963311869045112, 231597881, 231597884, 3, 640x360 
0x12CB3460, 36963311869364192, 231597911, 231597914, 3, 640x360 
0x12CB3460, 36963311869685248, 231597942, 231597946, 4, 640x360 
0x12CB3460, 36963311870005904, 231597981, 231597984, 3, 640x360 
0x12CB3460, 36963311870326040, 231598013, 231598016, 3, 640x360 
0x12CB3460, 36963311870646352, 231598042, 231598045, 3, 640x360 
0x12CB3460, 36963311871125280, 231598091, 231598093, 2, 640x360 
0x12CB3460, 36963311871446040, 231598122, 231598125, 3, 640x360 
0x12CB3460, 36963311871765600, 231598151, 231598154, 3, 640x360 
0x12CB3460, 36963311872083808, 231598182, 231598185, 3, 640x360 
0x12CB3460, 36963311872405760, 231598221, 231598224, 3, 640x360 
0x12CB3460, 36963311872724344, 231598251, 231598254, 3, 640x360 
0x12CB3460, 36963311873044240, 231598281, 231598284, 3, 640x360 
0x12CB3460, 36963311873364160, 231598312, 231598314, 2, 640x360 
0x12CB3460, 36963311873685096, 231598351, 231598354, 3, 640x360 
0x12CB3460, 36963311874005024, 231598379, 231598382, 3, 640x360 
0x12CB3460, 36963311874325368, 231598412, 231598415, 3, 640x360 
0x12CB3460, 36963311874646352, 231598441, 231598444, 3, 640x360 
0x12CB3460, 36963311875127448, 231598492, 231598495, 3, 640x360 
0x12CB3460, 36963311875445592, 231598521, 231598523, 2, 640x360 
0x12CB3460, 36963311875763952, 231598552, 231598554, 2, 640x360 
0x12CB3460, 36963311876085216, 231598582, 231598586, 4, 640x360 
0x12CB3460, 36963311876405784, 231598614, 231598618, 4, 640x360 
0x12CB3460, 36963311876724584, 231598652, 231598657, 5, 640x360 
0x12CB3460, 36963311877044024, 231598681, 231598683, 2, 640x360 
0x12CB3460, 36963311877365312, 231598712, 231598715, 3, 640x360 
0x12CB3460, 36963311877683872, 231598742, 231598746, 4, 640x360 
0x12CB3460, 36963311878005144, 231598774, 231598778, 4, 640x360 
0x12CB3460, 36963311878325576, 231598813, 231598818, 5, 640x360 
0x12CB3460, 36963311878803488, 231598894, 231598898, 4, 640x360 
0x12CB3460, 36963311879445432, 231598921, 231598923, 2, 640x360 
0x12CB3460, 36963311879764400, 231598951, 231598954, 3, 640x360 
0x12CB3460, 36963311880083936, 231598982, 231598986, 4, 640x360 
0x12CB3460, 36963311880406560, 231599020, 231599023, 3, 640x360 
0x12CB3460, 36963311880725584, 231599050, 231599054, 4, 640x360 
0x12CB3460, 36963311881044064, 231599081, 231599084, 3, 640x360 
0x12CB3460, 36963311881365024, 231599112, 231599115, 3, 640x360 
0x12CB3460, 36963311881685608, 231599142, 231599146, 4, 640x360 
0x12CB3460, 36963311882007984, 231599181, 231599184, 3, 640x360 
0x12CB3460, 36963311882325400, 231599211, 231599214, 3, 640x360 
0x12CB3460, 36963311882805680, 231599261, 231599264, 3, 640x360 
0x12CB3460, 36963311883125032, 231599291, 231599294, 3, 640x360 
0x12CB3460, 36963311883445760, 231599322, 231599325, 3, 640x360 
0x12CB3460, 36963311883765408, 231599351, 231599354, 3, 640x360 
0x12CB3460, 36963311884085280, 231599383, 231599386, 3, 640x360 
0x12CB3460, 36963311884404128, 231599421, 231599424, 3, 640x360 
0x12CB3460, 36963311884724520, 231599452, 231599455, 3, 640x360 
0x12CB3460, 36963311885045752, 231599482, 231599485, 3, 640x360 
0x12CB3460, 36963311885364040, 231599511, 231599515, 4, 640x360 
0x12CB3460, 36963311885685584, 231599551, 231599554, 3, 640x360 
0x12CB3460, 36963311886005648, 231599581, 231599584, 3, 640x360 
0x12CB3460, 36963311886327264, 231599611, 231599615, 4, 640x360 
0x12CB3460, 36963311886803512, 231599661, 231599665, 4, 640x360 
0x12CB3460, 36963311887125256, 231599691, 231599694, 3, 640x360 
0x12CB3460, 36963311887443440, 231599721, 231599724, 3, 640x360 
0x12CB3460, 36963311887764912, 231599750, 231599754, 4, 640x360 
0x12CB3460, 36963311888085616, 231599782, 231599786, 4, 640x360 
0x12CB3460, 36963311888405616, 231599821, 231599824, 3, 640x360 
0x12CB3460, 36963311888728848, 231599869, 231599874, 5, 640x360 
0x12CB3460, 36963311889043896, 231599881, 231599883, 2, 640x360 
0x12CB3460, 36963311889365232, 231599912, 231599914, 2, 640x360 
0x12CB3460, 36963311889683856, 231599941, 231599945, 4, 640x360 
0x12CB3460, 36963311890005048, 231599980, 231599984, 4, 640x360 
0x12CB3460, 36963311890483336, 231600031, 231600034, 3, 640x360 
0x12CB3460, 36963311890803888, 231600061, 231600064, 3, 640x360 
0x12CB3460, 36963311891123464, 231600091, 231600094, 3, 640x360 
0x12CB3460, 36963311891444992, 231600121, 231600124, 3, 640x360 
0x12CB3460, 36963311891764904, 231600152, 231600155, 3, 640x360 
0x12CB3460, 36963311892084544, 231600182, 231600186, 4, 640x360 
0x12CB3460, 36963311892405272, 231600222, 231600225, 3, 640x360 
0x12CB3460, 36963311892724448, 231600251, 231600254, 3, 640x360 
0x12CB3460, 36963311893044672, 231600280, 231600283, 3, 640x360 
0x12CB3460, 36963311893363976, 231600312, 231600315, 3, 640x360 
0x12CB3460, 36963311893684200, 231600366, 231600369, 3, 640x360 
0x12CB3460, 36963311894006888, 231600381, 231600384, 3, 640x360 
0x12CB3460, 36963311894483312, 231600421, 231600425, 4, 640x360 
0x12CB3460, 36963311894805360, 231600461, 231600464, 3, 640x360 
0x12CB3460, 36963311895124712, 231600492, 231600495, 3, 640x360 
0x12CB3460, 36963311895443832, 231600521, 231600523, 2, 640x360 
0x12CB3460, 36963311895763944, 231600551, 231600554, 3, 640x360 
0x12CB3460, 36963311896083704, 231600581, 231600584, 3, 640x360 
0x12CB3460, 36963311896404400, 231600620, 231600623, 3, 640x360 
0x12CB3460, 36963311896723888, 231600651, 231600653, 2, 640x360 
0x12CB3460, 36963311897047128, 231600680, 231600684, 4, 640x360 
0x12CB3460, 36963311897364168, 231600712, 231600715, 3, 640x360 
0x12CB3460, 36963311897685456, 231600742, 231600746, 4, 640x360 
0x12CB3460, 36963311898004992, 231600780, 231600783, 3, 640x360 
0x12CB3460, 36963311898483832, 231600831, 231600836, 5, 640x360 
0x12CB3460, 36963311898804712, 231600874, 231600877, 3, 640x360 
0x12CB3460, 36963311899124448, 231600891, 231600894, 3, 640x360 
0x12CB3460, 36963311899444832, 231600920, 231600923, 3, 640x360 
0x12CB3460, 36963311899764832, 231600951, 231600955, 4, 640x360 
0x12CB3460, 36963311900084056, 231600991, 231600994, 3, 640x360 
0x12CB3460, 36963311900405104, 231601021, 231601023, 2, 640x360 
0x12CB3460, 36963311900724272, 231601052, 231601055, 3, 640x360 
0x12CB3460, 36963311901045248, 231601081, 231601084, 3, 640x360 
0x12CB3460, 36963311901363816, 231601112, 231601116, 4, 640x360 
0x12CB3460, 36963311901683888, 231601142, 231601146, 4, 640x360 
0x12CB3460, 36963311902164312, 231601190, 231601194, 4, 640x360 
0x12CB3460, 36963311902485136, 231601222, 231601225, 3, 640x360 
0x12CB3460, 36963311902803424, 231601261, 231601264, 3, 640x360 
0x12CB3460, 36963311903124296, 231601292, 231601309, 17, 640x360 
0x12CB3460, 36963311903446248, 231601321, 231601324, 3, 640x360 
0x12CB3460, 36963311903767344, 231601375, 231601378, 3, 640x360 
0x12CB3460, 36963311904084152, 231601381, 231601385, 4, 640x360 
0x12CB3460, 36963311904404232, 231601421, 231601423, 2, 640x360 
0x12CB3460, 36963311904725464, 231601451, 231601455, 4, 640x360 
0x12CB3460, 36963311905044904, 231601481, 231601483, 2, 640x360 
0x12CB3460, 36963311905365712, 231601512, 231601515, 3, 640x360 
0x12CB3460, 36963311905686440, 231601551, 231601554, 3, 640x360 
0x12CB3460, 36963311906165592, 231601591, 231601595, 4, 640x360 
0x12CB3460, 36963311906484800, 231601623, 231601627, 4, 640x360 
0x12CB3460, 36963311906805824, 231601661, 231601664, 3, 640x360 
0x12CB3460, 36963311907125232, 231601692, 231601695, 3, 640x360 
0x12CB3460, 36963311907446368, 231601721, 231601724, 3, 640x360 
0x12CB3460, 36963311907764544, 231601750, 231601753, 3, 640x360 
0x12CB3460, 36963311908085304, 231601782, 231601786, 4, 640x360 
0x12CB3460, 36963311908404952, 231601821, 231601824, 3, 640x360 
0x12CB3460, 36963311908725600, 231601874, 231601878, 4, 640x360 
0x12CB3460, 36963311909047072, 231601881, 231601883, 2, 640x360 
0x12CB3460, 36963311909364336, 231601912, 231601914, 2, 640x360 
0x12CB3460, 36963311909845280, 231601961, 231601964, 3, 640x360 
0x12CB3460, 36963311910165408, 231601992, 231601994, 2, 640x360 
0x12CB3460, 36963311910483600, 231602021, 231602025, 4, 640x360 
0x12CB3460, 36963311910804648, 231602060, 231602064, 4, 640x360 
0x12CB3460, 36963311911123680, 231602091, 231602093, 2, 640x360 
0x12CB3460, 36963311911445832, 231602121, 231602123, 2, 640x360 
0x12CB3460, 36963311911764792, 231602152, 231602155, 3, 640x360 
0x12CB3460, 36963311912087408, 231602184, 231602188, 4, 640x360 
0x12CB3460, 36963311912404376, 231602221, 231602224, 3, 640x360 
0x12CB3460, 36963311912724488, 231602251, 231602254, 3, 640x360 
0x12CB3460, 36963311913044792, 231602281, 231602284, 3, 640x360 
0x12CB3460, 36963311913364312, 231602312, 231602315, 3, 640x360 
0x12CB3460, 36963311913845680, 231602369, 231602373, 4, 640x360 
0x12CB3460, 36963311914164800, 231602391, 231602394, 3, 640x360 
0x12CB3460, 36963311914484512, 231602422, 231602425, 3, 640x360 
0x12CB3460, 36963311914803960, 231602460, 231602464, 4, 640x360 
0x12CB3460, 36963311915123904, 231602491, 231602507, 16, 640x360 
0x12CB3460, 36963311915444504, 231602521, 231602524, 3, 640x360 
0x12CB3460, 36963311915764224, 231602551, 231602554, 3, 640x360 
0x12CB3460, 36963311916084400, 231602582, 231602585, 3, 640x360 
0x12CB3460, 36963311916405496, 231602621, 231602624, 3, 640x360 
0x12CB3460, 36963311916725432, 231602651, 231602654, 3, 640x360 
0x12CB3460, 36963311917046592, 231602680, 231602683, 3, 640x360 
0x12CB3460, 36963311917365000, 231602712, 231602716, 4, 640x360 
0x12CB3460, 36963311917845904, 231602761, 231602765, 4, 640x360 
0x12CB3460, 36963311918165064, 231602792, 231602795, 3, 640x360 
0x12CB3460, 36963311918486048, 231602832, 231602836, 4, 640x360 
0x12CB3460, 36963311918805272, 231602879, 231602882, 3, 640x360 
0x12CB3460, 36963311919127360, 231602891, 231602910, 19, 640x360 
0x12CB3460, 36963311919445432, 231602921, 231602924, 3, 640x360 
0x12CB3460, 36963311919766400, 231602951, 231602954, 3, 640x360 
0x12CB3460, 36963311920084664, 231602982, 231602986, 4, 640x360 
0x12CB3460, 36963311920406264, 231603021, 231603024, 3, 640x360 
0x12CB3460, 36963311920725656, 231603051, 231603054, 3, 640x360 
0x12CB3460, 36963311921043960, 231603082, 231603084, 2, 640x360 
0x12CB3460, 36963311921524400, 231603130, 231603133, 3, 640x360 
0x12CB3460, 36963311921845256, 231603162, 231603164, 2, 640x360 
0x12CB3460, 36963311922163928, 231603191, 231603194, 3, 640x360 
0x12CB3460, 36963311922485504, 231603222, 231603226, 4, 640x360 
0x12CB3460, 36963311922804536, 231603261, 231603264, 3, 640x360 
0x12CB3460, 36963311923124104, 231603292, 231603310, 18, 640x360 
0x12CB3460, 36963311923444560, 231603322, 231603324, 2, 640x360 
0x12CB3460, 36963311923763336, 231603363, 231603366, 3, 640x360 
0x12CB3460, 36963311924084264, 231603381, 231603385, 4, 640x360 
0x12CB3460, 36963311924403920, 231603422, 231603425, 3, 640x360 
0x12CB3460, 36963311924724336, 231603451, 231603454, 3, 640x360 
0x12CB3460, 36963311925045328, 231603482, 231603485, 3, 640x360 
0x12CB3460, 36963311925526184, 231603532, 231603535, 3, 640x360 
0x12CB3460, 36963311925844352, 231603560, 231603564, 4, 640x360 
0x12CB3460, 36963311926164128, 231603591, 231603594, 3, 640x360 
0x12CB3460, 36963311926485848, 231603622, 231603625, 3, 640x360 
0x12CB3460, 36963311926805080, 231603662, 231603665, 3, 640x360 
0x12CB3460, 36963311927126456, 231603691, 231603694, 3, 640x360 
0x12CB3460, 36963311927444656, 231603721, 231603724, 3, 640x360 
0x12CB3460, 36963311927764056, 231603751, 231603754, 3, 640x360 
0x12CB3460, 36963311928083952, 231603791, 231603795, 4, 640x360 
0x12CB3460, 36963311928405288, 231603821, 231603824, 3, 640x360 
0x12CB3460, 36963311928724848, 231603851, 231603854, 3, 640x360 
0x12CB3460, 36963311929044168, 231603881, 231603884, 3, 640x360 
0x12CB3460, 36963311929525176, 231603931, 231603934, 3, 640x360 
0x12CB3460, 36963311929845200, 231603961, 231603964, 3, 640x360 
0x12CB3460, 36963311930164032, 231603992, 231603995, 3, 640x360 
0x12CB3460, 36963311930487040, 231604031, 231604034, 3, 640x360 
0x12CB3460, 36963311930804856, 231604060, 231604063, 3, 640x360 
0x12CB3460, 36963311931124944, 231604091, 231604093, 2, 640x360 
0x12CB3460, 36963311931445136, 231604121, 231604123, 2, 640x360 
0x12CB3460, 36963311931765560, 231604152, 231604155, 3, 640x360 
0x12CB3460, 36963311932086928, 231604192, 231604195, 3, 640x360 
0x12CB3460, 36963311932406536, 231604221, 231604224, 3, 640x360 
0x12CB3460, 36963311932724464, 231604250, 231604253, 3, 640x360 
0x12CB3460, 36963311933205400, 231604301, 231604303, 2, 640x360 
0x12CB3460, 36963311933524896, 231604330, 231604333, 3, 640x360 
0x12CB3460, 36963311933847304, 231604372, 231604375, 3, 640x360 
0x12CB3460, 36963311934168008, 231604390, 231604395, 5, 640x360 
0x12CB3460, 36963311934484920, 231604422, 231604426, 4, 640x360 
0x12CB3460, 36963311934804120, 231604462, 231604479, 17, 640x360 
0x12CB3460, 36963311935123872, 231604491, 231604493, 2, 640x360 
0x12CB3460, 36963311935445080, 231604521, 231604524, 3, 640x360 
0x12CB3460, 36963311935764632, 231604551, 231604553, 2, 640x360 
0x12CB3460, 36963311936084304, 231604581, 231604585, 4, 640x360 
0x12CB3460, 36963311936404720, 231604621, 231604624, 3, 640x360 
0x12CB3460, 36963311936724632, 231604652, 231604654, 2, 640x360 
0x12CB3460, 36963311937206648, 231604701, 231604704, 3, 640x360 
0x12CB3460, 36963311937526168, 231604731, 231604735, 4, 640x360 
0x12CB3460, 36963311937844976, 231604761, 231604764, 3, 640x360 
0x12CB3460, 36963311938164120, 231604791, 231604794, 3, 640x360 
0x12CB3460, 36963311938483608, 231604821, 231604824, 3, 640x360 
0x12CB3460, 36963311938804832, 231604874, 231604878, 4, 640x360 
0x12CB3460, 36963311939124376, 231604891, 231604893, 2, 640x360 
0x12CB3460, 36963311939444624, 231604921, 231604924, 3, 640x360 
0x12CB3460, 36963311939765312, 231604951, 231604955, 4, 640x360 
0x12CB3460, 36963311940085176, 231604982, 231604986, 4, 640x360 
0x12CB3460, 36963311940404864, 231605020, 231605023, 3, 640x360 
0x12CB3460, 36963311940725336, 231605051, 231605054, 3, 640x360 
0x12CB3460, 36963311941203552, 231605101, 231605103, 2, 640x360 
0x12CB3460, 36963311941523664, 231605131, 231605134, 3, 640x360 
0x12CB3460, 36963311941846368, 231605161, 231605164, 3, 640x360 
0x12CB3460, 36963311942164472, 231605193, 231605196, 3, 640x360 
0x12CB3460, 36963311942484096, 231605222, 231605226, 4, 640x360 
0x12CB3460, 36963311942804888, 231605261, 231605265, 4, 640x360 
0x12CB3460, 36963311943125000, 231605292, 231605294, 2, 640x360 
0x12CB3460, 36963311943445880, 231605321, 231605324, 3, 640x360 
0x12CB3460, 36963311943765520, 231605352, 231605355, 3, 640x360 
0x12CB3460, 36963311944086288, 231605384, 231605388, 4, 640x360 
0x12CB3460, 36963311944405464, 231605421, 231605423, 2, 640x360 
0x12CB3460, 36963311944886376, 231605463, 231605466, 3, 640x360 
0x12CB3460, 36963311945204312, 231605501, 231605504, 3, 640x360 
0x12CB3460, 36963311945524424, 231605531, 231605534, 3, 640x360 
0x12CB3460, 36963311945847472, 231605562, 231605565, 3, 640x360 
0x12CB3460, 36963311946164336, 231605591, 231605594, 3, 640x360 
0x12CB3460, 36963311946486096, 231605623, 231605627, 4, 640x360 
0x12CB3460, 36963311946807064, 231605660, 231605664, 4, 640x360 
0x12CB3460, 36963311947127648, 231605691, 231605696, 5, 640x360 
0x12CB3460, 36963311947444864, 231605721, 231605724, 3, 640x360 
0x12CB3460, 36963311947763424, 231605750, 231605753, 3, 640x360 
0x12CB3460, 36963311948085032, 231605782, 231605785, 3, 640x360 
0x12CB3460, 36963311948405128, 231605821, 231605824, 3, 640x360 
0x12CB3460, 36963311948886600, 231605875, 231605878, 3, 640x360 
0x12CB3460, 36963311949203296, 231605901, 231605904, 3, 640x360 
0x12CB3460, 36963311949524792, 231605931, 231605933, 2, 640x360 
0x12CB3460, 36963311949843560, 231605962, 231605965, 3, 640x360 
0x12CB3460, 36963311950165168, 231605991, 231605994, 3, 640x360 
0x12CB3460, 36963311950483960, 231606022, 231606026, 4, 640x360 
0x12CB3460, 36963311950805976, 231606061, 231606065, 4, 640x360 
0x12CB3460, 36963311951123640, 231606091, 231606094, 3, 640x360 
0x12CB3460, 36963311951444016, 231606121, 231606123, 2, 640x360 
0x12CB3460, 36963311951765048, 231606152, 231606155, 3, 640x360 
0x12CB3460, 36963311952084672, 231606192, 231606195, 3, 640x360 
0x12CB3460, 36963311952563280, 231606232, 231606235, 3, 640x360 
0x12CB3460, 36963311952884408, 231606271, 231606274, 3, 640x360 
0x12CB3460, 36963311953205536, 231606301, 231606304, 3, 640x360 
0x12CB3460, 36963311953524888, 231606330, 231606334, 4, 640x360 
0x12CB3460, 36963311953844584, 231606363, 231606367, 4, 640x360 
0x12CB3460, 36963311954166368, 231606390, 231606394, 4, 640x360 
0x12CB3460, 36963311954484184, 231606422, 231606425, 3, 640x360 
0x12CB3460, 36963311954804904, 231606461, 231606464, 3, 640x360 
0x12CB3460, 36963311955123976, 231606491, 231606494, 3, 640x360 
0x12CB3460, 36963311955445312, 231606521, 231606524, 3, 640x360 
0x12CB3460, 36963311955765504, 231606551, 231606554, 3, 640x360 
0x12CB3460, 36963311956086840, 231606583, 231606587, 4, 640x360 
0x12CB3460, 36963311956564976, 231606632, 231606635, 3, 640x360 
0x12CB3460, 36963311956883848, 231606664, 231606667, 3, 640x360 
0x12CB3460, 36963311957205240, 231606701, 231606704, 3, 640x360 
0x12CB3460, 36963311957527904, 231606731, 231606734, 3, 640x360 
0x12CB3460, 36963311957844896, 231606761, 231606765, 4, 640x360 
0x12CB3460, 36963311958165352, 231606791, 231606794, 3, 640x360 
0x12CB3460, 36963311958484248, 231606822, 231606825, 3, 640x360 
0x12CB3460, 36963311958804936, 231606878, 231606881, 3, 640x360 
0x12CB3460, 36963311959128120, 231606891, 231606893, 2, 640x360 
0x12CB3460, 36963311959445048, 231606920, 231606923, 3, 640x360 
0x12CB3460, 36963311959764360, 231606952, 231606955, 3, 640x360 
0x12CB3460, 36963311960084864, 231606982, 231606986, 4, 640x360 
0x12CB3460, 36963311960564936, 231607032, 231607035, 3, 640x360 
0x12CB3460, 36963311960884352, 231607062, 231607066, 4, 640x360 
0x12CB3460, 36963311961203400, 231607101, 231607103, 2, 640x360 
0x12CB3460, 36963311961523960, 231607132, 231607134, 2, 640x360 
0x12CB3460, 36963311961845600, 231607162, 231607165, 3, 640x360 
0x12CB3460, 36963311962163648, 231607192, 231607196, 4, 640x360 
0x12CB3460, 36963311962483640, 231607221, 231607225, 4, 640x360 
0x12CB3460, 36963311962804200, 231607260, 231607264, 4, 640x360 
0x12CB3460, 36963311963124408, 231607291, 231607294, 3, 640x360 
0x12CB3460, 36963311963445600, 231607322, 231607324, 2, 640x360 
0x12CB3460, 36963311963763392, 231607374, 231607377, 3, 640x360 
0x12CB3460, 36963311964244648, 231607400, 231607403, 3, 640x360 
0x12CB3460, 36963311964563448, 231607431, 231607435, 4, 640x360 
0x12CB3460, 36963311964885704, 231607462, 231607466, 4, 640x360 
0x12CB3460, 36963311965206520, 231607502, 231607505, 3, 640x360 
0x12CB3460, 36963311965528712, 231607532, 231607535, 3, 640x360 
0x12CB3460, 36963311965844336, 231607560, 231607564, 4, 640x360 
0x12CB3460, 36963311966165200, 231607591, 231607595, 4, 640x360 
0x12CB3460, 36963311966484704, 231607632, 231607635, 3, 640x360 
0x12CB3460, 36963311966803576, 231607661, 231607664, 3, 640x360 
0x12CB3460, 36963311967124840, 231607692, 231607697, 5, 640x360 
0x12CB3460, 36963311967444272, 231607721, 231607723, 2, 640x360 
0x12CB3460, 36963311967763216, 231607751, 231607754, 3, 640x360 
0x12CB3460, 36963311968245480, 231607801, 231607805, 4, 640x360 
0x12CB3460, 36963311968562752, 231607830, 231607833, 3, 640x360 
0x12CB3460, 36963311968885960, 231607873, 231607877, 4, 640x360 
0x12CB3460, 36963311969203360, 231607901, 231607904, 3, 640x360 
0x12CB3460, 36963311969525080, 231607931, 231607934, 3, 640x360 
0x12CB3460, 36963311969845688, 231607962, 231607965, 3, 640x360 
0x12CB3460, 36963311970165952, 231607992, 231607995, 3, 640x360 
0x12CB3460, 36963311970486576, 231608032, 231608035, 3, 640x360 
0x12CB3460, 36963311970804504, 231608061, 231608065, 4, 640x360 
0x12CB3460, 36963311971123208, 231608091, 231608094, 3, 640x360 
0x12CB3460, 36963311971445568, 231608121, 231608124, 3, 640x360 
0x12CB3460, 36963311971765720, 231608152, 231608155, 3, 640x360 
0x12CB3460, 36963311972245328, 231608202, 231608205, 3, 640x360 
0x12CB3460, 36963311972565352, 231608231, 231608234, 3, 640x360 
0x12CB3460, 36963311972884096, 231608262, 231608265, 3, 640x360 
0x12CB3460, 36963311973204344, 231608301, 231608304, 3, 640x360 
0x12CB3460, 36963311973523624, 231608331, 231608333, 2, 640x360 
0x12CB3460, 36963311973844080, 231608382, 231608385, 3, 640x360 
0x12CB3460, 36963311974164152, 231608392, 231608394, 2, 640x360 
0x12CB3460, 36963311974483960, 231608421, 231608425, 4, 640x360 
0x12CB3460, 36963311974803648, 231608461, 231608464, 3, 640x360 
0x12CB3460, 36963311975124216, 231608491, 231608494, 3, 640x360 
0x12CB3460, 36963311975444576, 231608520, 231608524, 4, 640x360 
0x12CB3460, 36963311975925288, 231608572, 231608575, 3, 640x360 
0x12CB3460, 36963311976242776, 231608600, 231608613, 13, 640x360 
0x12CB3460, 36963311976562928, 231608632, 231608634, 2, 640x360 
0x12CB3460, 36963311976884672, 231608662, 231608666, 4, 640x360 
0x12CB3460, 36963311977204152, 231608701, 231608704, 3, 640x360 
0x12CB3460, 36963311977524480, 231608730, 231608733, 3, 640x360 
0x12CB3460, 36963311977843744, 231608761, 231608765, 4, 640x360 
0x12CB3460, 36963311978164528, 231608792, 231608796, 4, 640x360 
0x12CB3460, 36963311978483952, 231608831, 231608834, 3, 640x360 
0x12CB3460, 36963311978805112, 231608879, 231608882, 3, 640x360 
0x12CB3460, 36963311979124512, 231608891, 231608894, 3, 640x360 
0x12CB3460, 36963311979444448, 231608922, 231608924, 2, 640x360 
0x12CB3460, 36963311979925280, 231608971, 231608974, 3, 640x360 
0x12CB3460, 36963311980245024, 231609001, 231609004, 3, 640x360 
0x12CB3460, 36963311980563440, 231609032, 231609034, 2, 640x360 
0x12CB3460, 36963311980886104, 231609071, 231609074, 3, 640x360 
0x12CB3460, 36963311981204624, 231609100, 231609103, 3, 640x360 
0x12CB3460, 36963311981523848, 231609132, 231609134, 2, 640x360 
0x12CB3460, 36963311981844656, 231609161, 231609164, 3, 640x360 
0x12CB3460, 36963311982163512, 231609192, 231609195, 3, 640x360 
0x12CB3460, 36963311982485680, 231609231, 231609234, 3, 640x360 
0x12CB3460, 36963311982803992, 231609260, 231609263, 3, 640x360 
0x12CB3460, 36963311983123856, 231609291, 231609294, 3, 640x360 
0x12CB3460, 36963311983603752, 231609342, 231609345, 3, 640x360 
0x12CB3460, 36963311983923624, 231609377, 231609380, 3, 640x360 
0x12CB3460, 36963311984242736, 231609400, 231609403, 3, 640x360 
0x12CB3460, 36963311984564808, 231609431, 231609434, 3, 640x360 
0x12CB3460, 36963311984884336, 231609471, 231609473, 2, 640x360 
0x12CB3460, 36963311985203672, 231609501, 231609503, 2, 640x360 
0x12CB3460, 36963311985523992, 231609531, 231609533, 2, 640x360 
0x12CB3460, 36963311985845240, 231609561, 231609565, 4, 640x360 
0x12CB3460, 36963311986164232, 231609591, 231609609, 18, 640x360 
0x12CB3460, 36963311986486264, 231609632, 231609635, 3, 640x360 
0x12CB3460, 36963311986804248, 231609661, 231609664, 3, 640x360 
0x12CB3460, 36963311987123480, 231609691, 231609693, 2, 640x360 
0x12CB3460, 36963311987606344, 231609740, 231609743, 3, 640x360 
0x12CB3460, 36963311987925056, 231609771, 231609773, 2, 640x360 
0x12CB3460, 36963311988243880, 231609801, 231609804, 3, 640x360 
0x12CB3460, 36963311988566368, 231609831, 231609834, 3, 640x360 
0x12CB3460, 36963311988884904, 231609884, 231609888, 4, 640x360 
0x12CB3460, 36963311989204016, 231609900, 231609903, 3, 640x360 
0x12CB3460, 36963311989524432, 231609931, 231609934, 3, 640x360 
0x12CB3460, 36963311989845816, 231609961, 231609964, 3, 640x360 
0x12CB3460, 36963311990163944, 231609993, 231609996, 3, 640x360 
0x12CB3460, 36963311990485928, 231610023, 231610027, 4, 640x360 
0x12CB3460, 36963311990804160, 231610061, 231610065, 4, 640x360 
0x12CB3460, 36963311991124608, 231610090, 231610093, 3, 640x360 
0x12CB3460, 36963311991604872, 231610142, 231610144, 2, 640x360 
0x12CB3460, 36963311991925344, 231610171, 231610173, 2, 640x360 
0x12CB3460, 36963311992245488, 231610201, 231610204, 3, 640x360 
0x12CB3460, 36963311992563064, 231610231, 231610234, 3, 640x360 
0x12CB3460, 36963311992882936, 231610262, 231610265, 3, 640x360 
0x12CB3460, 36963311993205264, 231610301, 231610304, 3, 640x360 
0x12CB3460, 36963311993524312, 231610331, 231610334, 3, 640x360 
0x12CB3460, 36963311993846224, 231610375, 231610378, 3, 640x360 
0x12CB3460, 36963311994164608, 231610391, 231610394, 3, 640x360 
0x12CB3460, 36963311994484544, 231610431, 231610434, 3, 640x360 
0x12CB3460, 36963311994804768, 231610460, 231610463, 3, 640x360 
0x12CB3460, 36963311995283032, 231610511, 231610514, 3, 640x360 
0x12CB3460, 36963311995603248, 231610540, 231610543, 3, 640x360 
0x12CB3460, 36963311995923336, 231610571, 231610574, 3, 640x360 
0x12CB3460, 36963311996245040, 231610601, 231610604, 3, 640x360 
0x12CB3460, 36963311996564752, 231610631, 231610634, 3, 640x360 
0x12CB3460, 36963311996883688, 231610662, 231610666, 4, 640x360 
0x12CB3460, 36963311997203856, 231610701, 231610703, 2, 640x360 
0x12CB3460, 36963311997523984, 231610731, 231610734, 3, 640x360 
0x12CB3460, 36963311997844256, 231610761, 231610764, 3, 640x360 
0x12CB3460, 36963311998164608, 231610791, 231610794, 3, 640x360 
0x12CB3460, 36963311998485296, 231610831, 231610834, 3, 640x360 
0x12CB3460, 36963311998803392, 231610882, 231610886, 4, 640x360 
0x12CB3460, 36963311999284328, 231610901, 231610905, 4, 640x360 
0x12CB3460, 36963311999603184, 231610941, 231610943, 2, 640x360 
0x12CB3460, 36963311999923928, 231610971, 231610974, 3, 640x360 
0x12CB3460, 36963312000243224, 231611001, 231611003, 2, 640x360 
0x12CB3460, 36963312000564216, 231611030, 231611034, 4, 640x360 
0x12CB3460, 36963312000884848, 231611064, 231611067, 3, 640x360 
0x12CB3460, 36963312001204344, 231611101, 231611104, 3, 640x360 
0x12CB3460, 36963312001524296, 231611131, 231611134, 3, 640x360 
0x12CB3460, 36963312001845384, 231611162, 231611165, 3, 640x360 
0x12CB3460, 36963312002163464, 231611190, 231611194, 4, 640x360 
0x12CB3460, 36963312002483456, 231611222, 231611226, 4, 640x360 
0x12CB3460, 36963312002803352, 231611261, 231611264, 3, 640x360 
0x12CB3460, 36963312003284040, 231611302, 231611306, 4, 640x360 
0x12CB3460, 36963312003604872, 231611341, 231611344, 3, 640x360 
0x12CB3460, 36963312003931488, 231611379, 231611383, 4, 640x360 
0x12CB3460, 36963312004242864, 231611400, 231611403, 3, 640x360 
0x12CB3460, 36963312004564528, 231611431, 231611434, 3, 640x360 
0x12CB3460, 36963312004883680, 231611463, 231611466, 3, 640x360 
0x12CB3460, 36963312005205392, 231611500, 231611503, 3, 640x360 
0x12CB3460, 36963312005526712, 231611532, 231611535, 3, 640x360 
0x12CB3460, 36963312005844632, 231611561, 231611565, 4, 640x360 
0x12CB3460, 36963312006163920, 231611592, 231611595, 3, 640x360 
0x12CB3460, 36963312006484048, 231611631, 231611634, 3, 640x360 
0x12CB3460, 36963312006966472, 231611671, 231611675, 4, 640x360 
0x12CB3460, 36963312007283608, 231611702, 231611707, 5, 640x360 
0x12CB3460, 36963312007605544, 231611741, 231611744, 3, 640x360 
0x12CB3460, 36963312007925648, 231611771, 231611773, 2, 640x360 
0x12CB3460, 36963312008245032, 231611802, 231611805, 3, 640x360 
0x12CB3460, 36963312008565248, 231611832, 231611835, 3, 640x360 
0x12CB3460, 36963312008888752, 231611871, 231611888, 17, 640x360 
0x12CB3460, 36963312009204568, 231611901, 231611903, 2, 640x360 
0x12CB3460, 36963312009524152, 231611930, 231611933, 3, 640x360 
0x12CB3460, 36963312009844328, 231611961, 231611964, 3, 640x360 
0x12CB3460, 36963312010165920, 231611991, 231611994, 3, 640x360 
0x12CB3460, 36963312010487520, 231612022, 231612026, 4, 640x360 
0x12CB3460, 36963312010963952, 231612071, 231612074, 3, 640x360 
0x12CB3460, 36963312011284496, 231612111, 231612114, 3, 640x360 
0x12CB3460, 36963312011604800, 231612140, 231612143, 3, 640x360 
0x12CB3460, 36963312011925280, 231612173, 231612175, 2, 640x360 
0x12CB3460, 36963312012244256, 231612201, 231612204, 3, 640x360 
0x12CB3460, 36963312012563904, 231612231, 231612234, 3, 640x360 
0x12CB3460, 36963312012883136, 231612262, 231612281, 19, 640x360 
0x12CB3460, 36963312013203648, 231612301, 231612303, 2, 640x360 
0x12CB3460, 36963312013524872, 231612331, 231612334, 3, 640x360 
0x12CB3460, 36963312013845160, 231612369, 231612372, 3, 640x360 
0x12CB3460, 36963312014162824, 231612391, 231612394, 3, 640x360 
0x12CB3460, 36963312014485064, 231612431, 231612434, 3, 640x360 
0x12CB3460, 36963312014964488, 231612471, 231612474, 3, 640x360 
0x12CB3460, 36963312015285280, 231612511, 231612529, 18, 640x360 
0x12CB3460, 36963312015603216, 231612541, 231612545, 4, 640x360 
0x12CB3460, 36963312015922728, 231612571, 231612574, 3, 640x360 
0x12CB3460, 36963312016244048, 231612600, 231612603, 3, 640x360 
0x12CB3460, 36963312016563944, 231612631, 231612634, 3, 640x360 
0x12CB3460, 36963312016883168, 231612661, 231612666, 5, 640x360 
0x12CB3460, 36963312017209184, 231612701, 231612704, 3, 640x360 
0x12CB3460, 36963312017524008, 231612731, 231612734, 3, 640x360 
0x12CB3460, 36963312017844448, 231612760, 231612763, 3, 640x360 
0x12CB3460, 36963312018163504, 231612791, 231612794, 3, 640x360 
0x12CB3460, 36963312018644312, 231612841, 231612844, 3, 640x360 
0x12CB3460, 36963312018966472, 231612883, 231612886, 3, 640x360 
0x12CB3460, 36963312019283680, 231612902, 231612905, 3, 640x360 
0x12CB3460, 36963312019604648, 231612941, 231612944, 3, 640x360 
0x12CB3460, 36963312019926192, 231612970, 231612974, 4, 640x360 
0x12CB3460, 36963312020245552, 231613002, 231613005, 3, 640x360 
0x12CB3460, 36963312020566528, 231613032, 231613035, 3, 640x360 
0x12CB3460, 36963312020883288, 231613071, 231613074, 3, 640x360 
0x12CB3460, 36963312021203816, 231613100, 231613103, 3, 640x360 
0x12CB3460, 36963312021523368, 231613131, 231613134, 3, 640x360 
0x12CB3460, 36963312021844376, 231613161, 231613164, 3, 640x360 
0x12CB3460, 36963312022165512, 231613191, 231613196, 5, 640x360 
0x12CB3460, 36963312022643248, 231613241, 231613243, 2, 640x360 
0x12CB3460, 36963312022964656, 231613271, 231613288, 17, 640x360 
0x12CB3460, 36963312023284128, 231613301, 231613305, 4, 640x360 
0x12CB3460, 36963312023604448, 231613340, 231613343, 3, 640x360 
0x12CB3460, 36963312023924048, 231613374, 231613377, 3, 640x360 
0x12CB3460, 36963312024242776, 231613401, 231613403, 2, 640x360 
0x12CB3460, 36963312024564264, 231613431, 231613435, 4, 640x360 
0x12CB3460, 36963312024884128, 231613462, 231613466, 4, 640x360 
0x12CB3460, 36963312025204184, 231613501, 231613503, 2, 640x360 
0x12CB3460, 36963312025523728, 231613530, 231613533, 3, 640x360 
0x12CB3460, 36963312025844288, 231613561, 231613565, 4, 640x360 
0x12CB3460, 36963312026327016, 231613612, 231613616, 4, 640x360 
0x12CB3460, 36963312026646400, 231613643, 231613646, 3, 640x360 
0x12CB3460, 36963312026965616, 231613672, 231613675, 3, 640x360 
0x12CB3460, 36963312027284544, 231613711, 231613714, 3, 640x360 
0x12CB3460, 36963312027604064, 231613733, 231613738, 5, 640x360 
0x12CB3460, 36963312027925360, 231613771, 231613774, 3, 640x360 
0x12CB3460, 36963312028243928, 231613801, 231613804, 3, 640x360 
0x12CB3460, 36963312028565320, 231613831, 231613834, 3, 640x360 
0x12CB3460, 36963312028887560, 231613874, 231613877, 3, 640x360 
0x12CB3460, 36963312029203624, 231613901, 231613903, 2, 640x360 
0x12CB3460, 36963312029524320, 231613930, 231613933, 3, 640x360 
0x12CB3460, 36963312029844304, 231613961, 231613964, 3, 640x360 
0x12CB3460, 36963312030324776, 231614012, 231614015, 3, 640x360 
0x12CB3460, 36963312030644128, 231614042, 231614045, 3, 640x360 
0x12CB3460, 36963312030963720, 231614070, 231614073, 3, 640x360 
0x12CB3460, 36963312031284432, 231614101, 231614105, 4, 640x360 
0x12CB3460, 36963312031603520, 231614141, 231614144, 3, 640x360 
0x12CB3460, 36963312031924680, 231614170, 231614173, 3, 640x360 
0x12CB3460, 36963312032246088, 231614201, 231614205, 4, 640x360 
0x12CB3460, 36963312032563536, 231614231, 231614235, 4, 640x360 
0x12CB3460, 36963312032884952, 231614263, 231614267, 4, 640x360 
0x12CB3460, 36963312033203704, 231614301, 231614305, 4, 640x360 
0x12CB3460, 36963312033523848, 231614331, 231614334, 3, 640x360 
0x12CB3460, 36963312033843824, 231614386, 231614390, 4, 640x360 
0x12CB3460, 36963312034323592, 231614410, 231614414, 4, 640x360 
0x12CB3460, 36963312034643432, 231614441, 231614444, 3, 640x360 
0x12CB3460, 36963312034964584, 231614471, 231614475, 4, 640x360 
0x12CB3460, 36963312035283824, 231614502, 231614506, 4, 640x360 
0x12CB3460, 36963312035603696, 231614541, 231614543, 2, 640x360 
0x12CB3460, 36963312035926800, 231614570, 231614573, 3, 640x360 
0x12CB3460, 36963312036243352, 231614601, 231614613, 12, 640x360 
0x12CB3460, 36963312036563088, 231614631, 231614635, 4, 640x360 
0x12CB3460, 36963312036884776, 231614662, 231614666, 4, 640x360 
0x12CB3460, 36963312037204928, 231614700, 231614703, 3, 640x360 
0x12CB3460, 36963312037525176, 231614731, 231614734, 3, 640x360 
0x12CB3460, 36963312038002616, 231614781, 231614784, 3, 640x360 
0x12CB3460, 36963312038322912, 231614811, 231614814, 3, 640x360 
0x12CB3460, 36963312038646200, 231614841, 231614844, 3, 640x360 
0x12CB3460, 36963312038964576, 231614878, 231614881, 3, 640x360 
0x12CB3460, 36963312039283640, 231614911, 231614914, 3, 640x360 
0x12CB3460, 36963312039604104, 231614941, 231614944, 3, 640x360 
0x12CB3460, 36963312039924064, 231614971, 231614974, 3, 640x360 
0x12CB3460, 36963312040243656, 231615002, 231615005, 3, 640x360 
0x12CB3460, 36963312040563624, 231615032, 231615034, 2, 640x360 
0x12CB3460, 36963312040885336, 231615061, 231615065, 4, 640x360 
0x12CB3460, 36963312041204664, 231615100, 231615103, 3, 640x360 
0x12CB3460, 36963312041525696, 231615130, 231615138, 8, 640x360 
0x12CB3460, 36963312042004064, 231615182, 231615185, 3, 640x360 
0x12CB3460, 36963312042323696, 231615211, 231615214, 3, 640x360 
0x12CB3460, 36963312042642688, 231615241, 231615244, 3, 640x360 
0x12CB3460, 36963312042964176, 231615271, 231615274, 3, 640x360 
0x12CB3460, 36963312043282960, 231615302, 231615306, 4, 640x360 
0x12CB3460, 36963312043604384, 231615341, 231615343, 2, 640x360 
0x12CB3460, 36963312043924808, 231615374, 231615377, 3, 640x360 
0x12CB3460, 36963312044242616, 231615401, 231615414, 13, 640x360 
0x12CB3460, 36963312044564264, 231615430, 231615433, 3, 640x360 
0x12CB3460, 36963312044882960, 231615470, 231615474, 4, 640x360 
0x12CB3460, 36963312045204720, 231615501, 231615504, 3, 640x360 
0x12CB3460, 36963312045524216, 231615530, 231615534, 4, 640x360 
0x12CB3460, 36963312046002656, 231615581, 231615584, 3, 640x360 
0x12CB3460, 36963312046324064, 231615611, 231615615, 4, 640x360 
0x12CB3460, 36963312046644016, 231615641, 231615644, 3, 640x360 
0x12CB3460, 36963312046964440, 231615671, 231615674, 3, 640x360 
0x12CB3460, 36963312047283584, 231615701, 231615704, 3, 640x360 
0x12CB3460, 36963312047603512, 231615733, 231615737, 4, 640x360 
0x12CB3460, 36963312047924592, 231615771, 231615774, 3, 640x360 
0x12CB3460, 36963312048243760, 231615801, 231615804, 3, 640x360 
0x12CB3460, 36963312048565296, 231615831, 231615834, 3, 640x360 
0x12CB3460, 36963312048886392, 231615882, 231615885, 3, 640x360 
0x12CB3460, 36963312049203704, 231615901, 231615904, 3, 640x360 
0x12CB3460, 36963312049684344, 231615951, 231615953, 2, 640x360 
0x12CB3460, 36963312050004544, 231615981, 231615983, 2, 640x360 
0x12CB3460, 36963312050322872, 231616012, 231616015, 3, 640x360 
0x12CB3460, 36963312050646144, 231616042, 231616045, 3, 640x360 
0x12CB3460, 36963312050963480, 231616070, 231616074, 4, 640x360 
0x12CB3460, 36963312051282936, 231616101, 231616105, 4, 640x360 
0x12CB3460, 36963312051603536, 231616141, 231616144, 3, 640x360 
0x12CB3460, 36963312051925000, 231616172, 231616175, 3, 640x360 
0x12CB3460, 36963312052245640, 231616201, 231616204, 3, 640x360 
0x12CB3460, 36963312052564648, 231616232, 231616234, 2, 640x360 
0x12CB3460, 36963312052883560, 231616271, 231616274, 3, 640x360 
0x12CB3460, 36963312053204464, 231616301, 231616304, 3, 640x360 
0x12CB3460, 36963312053685328, 231616342, 231616345, 3, 640x360 
0x12CB3460, 36963312054004248, 231616377, 231616380, 3, 640x360 
0x12CB3460, 36963312054322512, 231616411, 231616414, 3, 640x360 
0x12CB3460, 36963312054642936, 231616441, 231616444, 3, 640x360 
0x12CB3460, 36963312054963456, 231616471, 231616474, 3, 640x360 
0x12CB3460, 36963312055283784, 231616502, 231616505, 3, 640x360 
0x12CB3460, 36963312055606168, 231616541, 231616544, 3, 640x360 
0x12CB3460, 36963312055925104, 231616571, 231616573, 2, 640x360 
0x12CB3460, 36963312056243760, 231616601, 231616604, 3, 640x360 
0x12CB3460, 36963312056562720, 231616631, 231616634, 3, 640x360 
0x12CB3460, 36963312056883168, 231616663, 231616666, 3, 640x360 
0x12CB3460, 36963312057204376, 231616700, 231616703, 3, 640x360 
0x12CB3460, 36963312057684920, 231616751, 231616753, 2, 640x360 
0x12CB3460, 36963312058004360, 231616781, 231616784, 3, 640x360 
0x12CB3460, 36963312058325032, 231616811, 231616814, 3, 640x360 
0x12CB3460, 36963312058645976, 231616842, 231616845, 3, 640x360 
0x12CB3460, 36963312058963744, 231616877, 231616880, 3, 640x360 
0x12CB3460, 36963312059283528, 231616901, 231616905, 4, 640x360 
0x12CB3460, 36963312059602792, 231616941, 231616944, 3, 640x360 
0x12CB3460, 36963312059925704, 231616971, 231616975, 4, 640x360 
0x12CB3460, 36963312060245040, 231617001, 231617004, 3, 640x360 
0x12CB3460, 36963312060564240, 231617031, 231617035, 4, 640x360 
0x12CB3460, 36963312060883656, 231617061, 231617065, 4, 640x360 
0x12CB3460, 36963312061364176, 231617110, 231617113, 3, 640x360 
0x12CB3460, 36963312061683624, 231617142, 231617146, 4, 640x360 
0x12CB3460, 36963312062003504, 231617182, 231617185, 3, 640x360 
0x12CB3460, 36963312062326872, 231617211, 231617215, 4, 640x360 
0x12CB3460, 36963312062644480, 231617241, 231617243, 2, 640x360 
0x12CB3460, 36963312062963928, 231617271, 231617274, 3, 640x360 
0x12CB3460, 36963312063282856, 231617301, 231617305, 4, 640x360 
0x12CB3460, 36963312063602792, 231617342, 231617344, 2, 640x360 
0x12CB3460, 36963312063924864, 231617378, 231617381, 3, 640x360 
0x12CB3460, 36963312064245744, 231617400, 231617403, 3, 640x360 
0x12CB3460, 36963312064563016, 231617431, 231617434, 3, 640x360 
0x12CB3460, 36963312064883624, 231617471, 231617473, 2, 640x360 
0x12CB3460, 36963312065366088, 231617512, 231617516, 4, 640x360 
0x12CB3460, 36963312065685264, 231617552, 231617554, 2, 640x360 
0x12CB3460, 36963312066004960, 231617581, 231617583, 2, 640x360 
0x12CB3460, 36963312066325216, 231617610, 231617613, 3, 640x360 
0x12CB3460, 36963312066647000, 231617643, 231617647, 4, 640x360 
0x12CB3460, 36963312066966056, 231617671, 231617674, 3, 640x360 
0x12CB3460, 36963312067284448, 231617702, 231617719, 17, 640x360 
0x12CB3460, 36963312067604104, 231617741, 231617744, 3, 640x360 
0x12CB3460, 36963312067927192, 231617770, 231617773, 3, 640x360 
0x12CB3460, 36963312068244320, 231617801, 231617803, 2, 640x360 
0x12CB3460, 36963312068564232, 231617831, 231617833, 2, 640x360 
0x12CB3460, 36963312069042192, 231617880, 231617882, 2, 640x360 
0x12CB3460, 36963312069363440, 231617911, 231617914, 3, 640x360 
0x12CB3460, 36963312069682728, 231617942, 231617945, 3, 640x360 
0x12CB3460, 36963312070003624, 231617981, 231617984, 3, 640x360 
0x12CB3460, 36963312070324016, 231618011, 231618014, 3, 640x360 
0x12CB3460, 36963312070645400, 231618041, 231618044, 3, 640x360 
0x12CB3460, 36963312070962592, 231618071, 231618074, 3, 640x360 
0x12CB3460, 36963312071283560, 231618111, 231618114, 3, 640x360 
0x12CB3460, 36963312071604800, 231618141, 231618143, 2, 640x360 
0x12CB3460, 36963312071923512, 231618172, 231618175, 3, 640x360 
0x12CB3460, 36963312072244560, 231618200, 231618203, 3, 640x360 
0x12CB3460, 36963312072565920, 231618232, 231618235, 3, 640x360 
0x12CB3460, 36963312073044984, 231618281, 231618284, 3, 640x360 
0x12CB3460, 36963312073363176, 231618311, 231618314, 3, 640x360 
0x12CB3460, 36963312073683480, 231618342, 231618345, 3, 640x360 
0x12CB3460, 36963312074002600, 231618375, 231618379, 4, 640x360 
0x12CB3460, 36963312074322328, 231618411, 231618415, 4, 640x360 
0x12CB3460, 36963312074644728, 231618441, 231618458, 17, 640x360 
0x12CB3460, 36963312074965144, 231618473, 231618476, 3, 640x360 
0x12CB3460, 36963312075286560, 231618510, 231618513, 3, 640x360 
0x12CB3460, 36963312075605136, 231618541, 231618543, 2, 640x360 
0x12CB3460, 36963312075926640, 231618571, 231618574, 3, 640x360 
0x12CB3460, 36963312076244368, 231618601, 231618604, 3, 640x360 
0x12CB3460, 36963312076564008, 231618630, 231618634, 4, 640x360 
0x12CB3460, 36963312077046816, 231618682, 231618685, 3, 640x360 
0x12CB3460, 36963312077367832, 231618713, 231618717, 4, 640x360 
0x12CB3460, 36963312077683504, 231618742, 231618745, 3, 640x360 
0x12CB3460, 36963312078002592, 231618780, 231618783, 3, 640x360 
0x12CB3460, 36963312078323104, 231618812, 231618815, 3, 640x360 
0x12CB3460, 36963312078644808, 231618841, 231618844, 3, 640x360 
0x12CB3460, 36963312078965504, 231618883, 231618886, 3, 640x360 
0x12CB3460, 36963312079282960, 231618901, 231618905, 4, 640x360 
0x12CB3460, 36963312079603968, 231618941, 231618944, 3, 640x360 
0x12CB3460, 36963312079924000, 231618970, 231618973, 3, 640x360 
0x12CB3460, 36963312080243312, 231619002, 231619005, 3, 640x360 
0x12CB3460, 36963312080724920, 231619050, 231619053, 3, 640x360 
0x12CB3460, 36963312081043352, 231619081, 231619088, 7, 640x360 
0x12CB3460, 36963312081364072, 231619110, 231619113, 3, 640x360 
0x12CB3460, 36963312081684464, 231619142, 231619146, 4, 640x360 
0x12CB3460, 36963312082005512, 231619181, 231619184, 3, 640x360 
0x12CB3460, 36963312082326088, 231619211, 231619217, 6, 640x360 
0x12CB3460, 36963312082643616, 231619241, 231619244, 3, 640x360 
0x12CB3460, 36963312082963504, 231619270, 231619274, 4, 640x360 
0x12CB3460, 36963312083284256, 231619302, 231619305, 3, 640x360 
0x12CB3460, 36963312083603744, 231619341, 231619344, 3, 640x360 
0x12CB3460, 36963312083924720, 231619378, 231619381, 3, 640x360 
0x12CB3460, 36963312084242584, 231619400, 231619403, 3, 640x360 
0x12CB3460, 36963312084724672, 231619451, 231619454, 3, 640x360 
0x12CB3460, 36963312085045080, 231619481, 231619484, 3, 640x360 
0x12CB3460, 36963312085364048, 231619512, 231619515, 3, 640x360 
0x12CB3460, 36963312085684224, 231619551, 231619554, 3, 640x360 
0x12CB3460, 36963312086002816, 231619581, 231619583, 2, 640x360 
0x12CB3460, 36963312086322920, 231619612, 231619615, 3, 640x360 
0x12CB3460, 36963312086643904, 231619642, 231619645, 3, 640x360 
0x12CB3460, 36963312086963872, 231619672, 231619675, 3, 640x360 
0x12CB3460, 36963312087286392, 231619711, 231619716, 5, 640x360 
0x12CB3460, 36963312087604880, 231619741, 231619743, 2, 640x360 
0x12CB3460, 36963312087924800, 231619771, 231619774, 3, 640x360 
0x12CB3460, 36963312088244560, 231619801, 231619804, 3, 640x360 
0x12CB3460, 36963312088725904, 231619874, 231619878, 4, 640x360 
0x12CB3460, 36963312089043208, 231619881, 231619884, 3, 640x360 
0x12CB3460, 36963312089363848, 231619911, 231619914, 3, 640x360 
0x12CB3460, 36963312089684600, 231619942, 231619945, 3, 640x360 
0x12CB3460, 36963312090004160, 231619981, 231619985, 4, 640x360 
0x12CB3460, 36963312090325864, 231620011, 231620014, 3, 640x360 
0x12CB3460, 36963312090643424, 231620041, 231620044, 3, 640x360 
0x12CB3460, 36963312090962616, 231620072, 231620075, 3, 640x360 
0x12CB3460, 36963312091284152, 231620111, 231620114, 3, 640x360 
0x12CB3460, 36963312091605816, 231620141, 231620143, 2, 640x360 
0x12CB3460, 36963312091925080, 231620171, 231620174, 3, 640x360 
0x12CB3460, 36963312092402528, 231620221, 231620224, 3, 640x360 
0x12CB3460, 36963312092722040, 231620251, 231620253, 2, 640x360 
0x12CB3460, 36963312093043448, 231620280, 231620283, 3, 640x360 
0x12CB3460, 36963312093366440, 231620312, 231620315, 3, 640x360 
0x12CB3460, 36963312093682368, 231620342, 231620346, 4, 640x360 
0x12CB3460, 36963312094003232, 231620384, 231620387, 3, 640x360 
0x12CB3460, 36963312094322632, 231620411, 231620414, 3, 640x360 
0x12CB3460, 36963312094643848, 231620440, 231620443, 3, 640x360 
0x12CB3460, 36963312094962928, 231620471, 231620474, 3, 640x360 
0x12CB3460, 36963312095282960, 231620502, 231620506, 4, 640x360 
0x12CB3460, 36963312095603032, 231620541, 231620545, 4, 640x360 
0x12CB3460, 36963312095926296, 231620570, 231620573, 3, 640x360 
0x12CB3460, 36963312096404760, 231620621, 231620624, 3, 640x360 
0x12CB3460, 36963312096725256, 231620651, 231620654, 3, 640x360 
0x12CB3460, 36963312097044008, 231620681, 231620684, 3, 640x360 
0x12CB3460, 36963312097364336, 231620711, 231620714, 3, 640x360 
0x12CB3460, 36963312097687216, 231620743, 231620746, 3, 640x360 
0x12CB3460, 36963312098003416, 231620781, 231620783, 2, 640x360 
0x12CB3460, 36963312098323048, 231620811, 231620813, 2, 640x360 
0x12CB3460, 36963312098645744, 231620842, 231620845, 3, 640x360 
0x12CB3460, 36963312098965536, 231620892, 231620894, 2, 640x360 
0x12CB3460, 36963312099285448, 231620911, 231620914, 3, 640x360 
0x12CB3460, 36963312099603096, 231620940, 231620943, 3, 640x360 
0x12CB3460, 36963312100083000, 231620981, 231620985, 4, 640x360 
0x12CB3460, 36963312100406616, 231621021, 231621024, 3, 640x360 
0x12CB3460, 36963312100727184, 231621051, 231621054, 3, 640x360 
0x12CB3460, 36963312101042544, 231621081, 231621084, 3, 640x360 
0x12CB3460, 36963312101363824, 231621111, 231621114, 3, 640x360 
0x12CB3460, 36963312101685920, 231621142, 231621146, 4, 640x360 
0x12CB3460, 36963312102003200, 231621181, 231621184, 3, 640x360 
0x12CB3460, 36963312102323968, 231621210, 231621213, 3, 640x360 
0x12CB3460, 36963312102643536, 231621240, 231621243, 3, 640x360 
0x12CB3460, 36963312102964064, 231621271, 231621274, 3, 640x360 
0x12CB3460, 36963312103282408, 231621301, 231621305, 4, 640x360 
0x12CB3460, 36963312103603888, 231621341, 231621344, 3, 640x360 
0x12CB3460, 36963312104082928, 231621382, 231621387, 5, 640x360 
0x12CB3460, 36963312104402464, 231621414, 231621418, 4, 640x360 
0x12CB3460, 36963312104724368, 231621451, 231621454, 3, 640x360 
0x12CB3460, 36963312105045136, 231621482, 231621484, 2, 640x360 
0x12CB3460, 36963312105363576, 231621511, 231621515, 4, 640x360 
0x12CB3460, 36963312105683520, 231621542, 231621546, 4, 640x360 
0x12CB3460, 36963312106003568, 231621581, 231621584, 3, 640x360 
0x12CB3460, 36963312106325216, 231621611, 231621614, 3, 640x360 
0x12CB3460, 36963312106643792, 231621640, 231621647, 7, 640x360 
0x12CB3460, 36963312106963640, 231621671, 231621688, 17, 640x360 
0x12CB3460, 36963312107284640, 231621710, 231621713, 3, 640x360 
0x12CB3460, 36963312107604168, 231621741, 231621744, 3, 640x360 
0x12CB3460, 36963312108082136, 231621791, 231621794, 3, 640x360 
0x12CB3460, 36963312108409592, 231621821, 231621824, 3, 640x360 
0x12CB3460, 36963312108726008, 231621851, 231621878, 27, 640x360 
0x12CB3460, 36963312109042952, 231621879, 231621884, 5, 640x360 
0x12CB3460, 36963312109362168, 231621910, 231621914, 4, 640x360 
0x12CB3460, 36963312109684000, 231621942, 231621961, 19, 640x360 
0x12CB3460, 36963312110003368, 231621981, 231621984, 3, 640x360 
0x12CB3460, 36963312110325560, 231622011, 231622014, 3, 640x360 
0x12CB3460, 36963312110643088, 231622042, 231622045, 3, 640x360 
0x12CB3460, 36963312110962208, 231622071, 231622074, 3, 640x360 
0x12CB3460, 36963312111283672, 231622111, 231622114, 3, 640x360 
0x12CB3460, 36963312111764784, 231622152, 231622154, 2, 640x360 
0x12CB3460, 36963312112085640, 231622191, 231622196, 5, 640x360 
0x12CB3460, 36963312112403552, 231622221, 231622223, 2, 640x360 
0x12CB3460, 36963312112723696, 231622250, 231622254, 4, 640x360 
0x12CB3460, 36963312113043464, 231622281, 231622284, 3, 640x360 
0x12CB3460, 36963312113364304, 231622311, 231622314, 3, 640x360 
0x12CB3460, 36963312113683096, 231622342, 231622345, 3, 640x360 
0x12CB3460, 36963312114003232, 231622378, 231622381, 3, 640x360 
0x12CB3460, 36963312114322784, 231622410, 231622413, 3, 640x360 
0x12CB3460, 36963312114643432, 231622441, 231622444, 3, 640x360 
0x12CB3460, 36963312114964016, 231622471, 231622474, 3, 640x360 
0x12CB3460, 36963312115283784, 231622503, 231622506, 3, 640x360 
0x12CB3460, 36963312115765696, 231622551, 231622555, 4, 640x360 
0x12CB3460, 36963312116084944, 231622584, 231622587, 3, 640x360 
0x12CB3460, 36963312116403672, 231622620, 231622623, 3, 640x360 
0x12CB3460, 36963312116724272, 231622652, 231622655, 3, 640x360 
0x12CB3460, 36963312117043256, 231622681, 231622684, 3, 640x360 
0x12CB3460, 36963312117363864, 231622711, 231622715, 4, 640x360 
0x12CB3460, 36963312117683272, 231622751, 231622754, 3, 640x360 
0x12CB3460, 36963312118003056, 231622781, 231622783, 2, 640x360 
0x12CB3460, 36963312118324456, 231622810, 231622814, 4, 640x360 
0x12CB3460, 36963312118644072, 231622841, 231622843, 2, 640x360 
0x12CB3460, 36963312118963696, 231622877, 231622880, 3, 640x360 
0x12CB3460, 36963312119282608, 231622901, 231622905, 4, 640x360 
0x12CB3460, 36963312119764840, 231622950, 231622954, 4, 640x360 
0x12CB3460, 36963312120081880, 231622981, 231622985, 4, 640x360 
0x12CB3460, 36963312120403648, 231623021, 231623024, 3, 640x360 
0x12CB3460, 36963312120723104, 231623050, 231623053, 3, 640x360 
0x12CB3460, 36963312121043016, 231623081, 231623083, 2, 640x360 
0x12CB3460, 36963312121363664, 231623110, 231623113, 3, 640x360 
0x12CB3460, 36963312121684184, 231623142, 231623145, 3, 640x360 
0x12CB3460, 36963312122003160, 231623181, 231623185, 4, 640x360 
0x12CB3460, 36963312122322432, 231623210, 231623213, 3, 640x360 
0x12CB3460, 36963312122643432, 231623241, 231623243, 2, 640x360 
0x12CB3460, 36963312122964064, 231623270, 231623273, 3, 640x360 
0x12CB3460, 36963312123445176, 231623322, 231623324, 2, 640x360 
0x12CB3460, 36963312123766352, 231623352, 231623358, 6, 640x360 
0x12CB3460, 36963312124083072, 231623395, 231623399, 4, 640x360 
0x12CB3460, 36963312124403152, 231623420, 231623423, 3, 640x360 
0x12CB3460, 36963312124723680, 231623451, 231623454, 3, 640x360 
0x12CB3460, 36963312125044288, 231623481, 231623484, 3, 640x360 
0x12CB3460, 36963312125364896, 231623513, 231623516, 3, 640x360 
0x12CB3460, 36963312125683440, 231623551, 231623555, 4, 640x360 
0x12CB3460, 36963312126004248, 231623582, 231623585, 3, 640x360 
0x12CB3460, 36963312126326024, 231623611, 231623615, 4, 640x360 
0x12CB3460, 36963312126645456, 231623640, 231623644, 4, 640x360 
0x12CB3460, 36963312126963488, 231623672, 231623674, 2, 640x360 
0x12CB3460, 36963312127444976, 231623721, 231623724, 3, 640x360 
0x12CB3460, 36963312127763152, 231623751, 231623754, 3, 640x360 
0x12CB3460, 36963312128083920, 231623781, 231623785, 4, 640x360 
0x12CB3460, 36963312128404648, 231623822, 231623824, 2, 640x360 
0x12CB3460, 36963312128725712, 231623878, 231623882, 4, 640x360 
0x12CB3460, 36963312129363296, 231623911, 231623915, 4, 640x360 
0x12CB3460, 36963312129682336, 231623942, 231623945, 3, 640x360 
0x12CB3460, 36963312130003272, 231623980, 231623983, 3, 640x360 
0x12CB3460, 36963312130325352, 231624012, 231624015, 3, 640x360 
0x12CB3460, 36963312130644680, 231624042, 231624045, 3, 640x360 
0x12CB3460, 36963312130963416, 231624071, 231624073, 2, 640x360 
0x12CB3460, 36963312131443976, 231624121, 231624124, 3, 640x360 
0x12CB3460, 36963312131764488, 231624151, 231624155, 4, 640x360 
0x12CB3460, 36963312132083024, 231624182, 231624186, 4, 640x360 
0x12CB3460, 36963312132406192, 231624214, 231624218, 4, 640x360 
0x12CB3460, 36963312132722192, 231624251, 231624264, 13, 640x360 
0x12CB3460, 36963312133043024, 231624281, 231624284, 3, 640x360 
0x12CB3460, 36963312133363952, 231624311, 231624314, 3, 640x360 
0x12CB3460, 36963312133683248, 231624341, 231624345, 4, 640x360 
0x12CB3460, 36963312134002744, 231624375, 231624379, 4, 640x360 
0x12CB3460, 36963312134322328, 231624411, 231624414, 3, 640x360 
0x12CB3460, 36963312134643024, 231624441, 231624444, 3, 640x360 
0x12CB3460, 36963312135124864, 231624492, 231624495, 3, 640x360 
0x12CB3460, 36963312135445440, 231624521, 231624524, 3, 640x360 
0x12CB3460, 36963312135762448, 231624551, 231624554, 3, 640x360 
0x12CB3460, 36963312136085952, 231624591, 231624594, 3, 640x360 
0x12CB3460, 36963312136403336, 231624620, 231624623, 3, 640x360 
0x12CB3460, 36963312136726736, 231624653, 231624656, 3, 640x360 
0x12CB3460, 36963312137044784, 231624682, 231624685, 3, 640x360 
0x12CB3460, 36963312137363184, 231624711, 231624714, 3, 640x360 
0x12CB3460, 36963312137683224, 231624742, 231624745, 3, 640x360 
0x12CB3460, 36963312138003536, 231624781, 231624789, 8, 640x360 
0x12CB3460, 36963312138324280, 231624810, 231624813, 3, 640x360 
0x12CB3460, 36963312138642784, 231624841, 231624844, 3, 640x360 
0x12CB3460, 36963312139123600, 231624891, 231624895, 4, 640x360 
0x12CB3460, 36963312139442992, 231624920, 231624923, 3, 640x360 
0x12CB3460, 36963312139762248, 231624951, 231624954, 3, 640x360 
0x12CB3460, 36963312140084112, 231624982, 231624985, 3, 640x360 
0x12CB3460, 36963312140403176, 231625020, 231625023, 3, 640x360 
0x12CB3460, 36963312140724528, 231625051, 231625054, 3, 640x360 
0x12CB3460, 36963312141043352, 231625080, 231625083, 3, 640x360 
0x12CB3460, 36963312141361824, 231625111, 231625114, 3, 640x360 
0x12CB3460, 36963312141682584, 231625151, 231625154, 3, 640x360 
0x12CB3460, 36963312142003920, 231625181, 231625184, 3, 640x360 
0x12CB3460, 36963312142325416, 231625212, 231625215, 3, 640x360 
0x12CB3460, 36963312142807024, 231625260, 231625263, 3, 640x360 
0x12CB3460, 36963312143122032, 231625291, 231625294, 3, 640x360 
0x12CB3460, 36963312143444528, 231625322, 231625325, 3, 640x360 
0x12CB3460, 36963312143762056, 231625376, 231625384, 8, 640x360 
0x12CB3460, 36963312144083008, 231625384, 231625387, 3, 640x360 
0x12CB3460, 36963312144404232, 231625421, 231625439, 18, 640x360 
0x12CB3460, 36963312144722680, 231625450, 231625454, 4, 640x360 
0x12CB3460, 36963312145043248, 231625481, 231625483, 2, 640x360 
0x12CB3460, 36963312145362656, 231625511, 231625516, 5, 640x360 
0x12CB3460, 36963312145683376, 231625541, 231625546, 5, 640x360 
0x12CB3460, 36963312146003936, 231625580, 231625583, 3, 640x360 
0x12CB3460, 36963312146323096, 231625611, 231625614, 3, 640x360 
0x12CB3460, 36963312146803472, 231625665, 231625668, 3, 640x360 
0x12CB3460, 36963312147124136, 231625691, 231625694, 3, 640x360 
0x12CB3460, 36963312147442696, 231625721, 231625724, 3, 640x360 
0x12CB3460, 36963312147762960, 231625751, 231625754, 3, 640x360 
0x12CB3460, 36963312148083448, 231625791, 231625794, 3, 640x360 
0x12CB3460, 36963312148404816, 231625821, 231625824, 3, 640x360 
0x12CB3460, 36963312148723952, 231625883, 231625886, 3, 640x360 
0x12CB3460, 36963312149362240, 231625911, 231625914, 3, 640x360 
0x12CB3460, 36963312149683736, 231625951, 231625954, 3, 640x360 
0x12CB3460, 36963312150002704, 231625981, 231625984, 3, 640x360 
0x12CB3460, 36963312150323024, 231626011, 231626014, 3, 640x360 
0x12CB3460, 36963312150802496, 231626061, 231626064, 3, 640x360 
0x12CB3460, 36963312151121904, 231626091, 231626094, 3, 640x360 
0x12CB3460, 36963312151442552, 231626122, 231626124, 2, 640x360 
0x12CB3460, 36963312151763552, 231626152, 231626155, 3, 640x360 
0x12CB3460, 36963312152083688, 231626182, 231626185, 3, 640x360 
0x12CB3460, 36963312152402432, 231626221, 231626225, 4, 640x360 
0x12CB3460, 36963312152722376, 231626250, 231626253, 3, 640x360 
0x12CB3460, 36963312153041720, 231626281, 231626284, 3, 640x360 
0x12CB3460, 36963312153364176, 231626311, 231626315, 4, 640x360 
0x12CB3460, 36963312153682104, 231626342, 231626346, 4, 640x360 
0x12CB3460, 36963312154003008, 231626373, 231626377, 4, 640x360 
0x12CB3460, 36963312154483832, 231626421, 231626425, 4, 640x360 
0x12CB3460, 36963312154803856, 231626461, 231626465, 4, 640x360 
0x12CB3460, 36963312155124304, 231626491, 231626494, 3, 640x360 
0x12CB3460, 36963312155443888, 231626522, 231626524, 2, 640x360 
0x12CB3460, 36963312155764400, 231626551, 231626554, 3, 640x360 
0x12CB3460, 36963312156083736, 231626591, 231626596, 5, 640x360 
0x12CB3460, 36963312156404200, 231626615, 231626618, 3, 640x360 
0x12CB3460, 36963312156722288, 231626651, 231626654, 3, 640x360 
0x12CB3460, 36963312157043464, 231626681, 231626684, 3, 640x360 
0x12CB3460, 36963312157363432, 231626712, 231626716, 4, 640x360 
0x12CB3460, 36963312157682720, 231626741, 231626745, 4, 640x360 
0x12CB3460, 36963312158003712, 231626782, 231626784, 2, 640x360 
0x12CB3460, 36963312158482408, 231626822, 231626826, 4, 640x360 
0x12CB3460, 36963312158802584, 231626875, 231626878, 3, 640x360 
0x12CB3460, 36963312159123016, 231626891, 231626894, 3, 640x360 
0x12CB3460, 36963312159443336, 231626921, 231626924, 3, 640x360 
0x12CB3460, 36963312159762368, 231626951, 231626954, 3, 640x360 
0x12CB3460, 36963312160083328, 231626981, 231626985, 4, 640x360 
0x12CB3460, 36963312160404200, 231627021, 231627024, 3, 640x360 
0x12CB3460, 36963312160723016, 231627050, 231627054, 4, 640x360 
0x12CB3460, 36963312161043104, 231627081, 231627085, 4, 640x360 
0x12CB3460, 36963312161362608, 231627111, 231627114, 3, 640x360 
0x12CB3460, 36963312161684440, 231627141, 231627146, 5, 640x360 
0x12CB3460, 36963312162003000, 231627182, 231627184, 2, 640x360 
0x12CB3460, 36963312162483304, 231627231, 231627234, 3, 640x360 
0x12CB3460, 36963312162801520, 231627261, 231627263, 2, 640x360 
0x12CB3460, 36963312163121992, 231627291, 231627294, 3, 640x360 
0x12CB3460, 36963312163443296, 231627321, 231627324, 3, 640x360 
0x12CB3460, 36963312163763848, 231627376, 231627382, 6, 640x360 
0x12CB3460, 36963312164085672, 231627382, 231627386, 4, 640x360 
0x12CB3460, 36963312164403472, 231627421, 231627423, 2, 640x360 
0x12CB3460, 36963312164722048, 231627450, 231627454, 4, 640x360 
0x12CB3460, 36963312165041816, 231627480, 231627483, 3, 640x360 
0x12CB3460, 36963312165362528, 231627512, 231627515, 3, 640x360 
0x12CB3460, 36963312165685688, 231627551, 231627564, 13, 640x360 
0x12CB3460, 36963312166162040, 231627592, 231627594, 2, 640x360 
0x12CB3460, 36963312166485376, 231627622, 231627627, 5, 640x360 
0x12CB3460, 36963312166805840, 231627661, 231627664, 3, 640x360 
0x12CB3460, 36963312167123432, 231627691, 231627694, 3, 640x360 
0x12CB3460, 36963312167442728, 231627721, 231627724, 3, 640x360 
0x12CB3460, 36963312167762640, 231627751, 231627753, 2, 640x360 
0x12CB3460, 36963312168082408, 231627781, 231627785, 4, 640x360 
0x12CB3460, 36963312168404536, 231627820, 231627824, 4, 640x360 
0x12CB3460, 36963312168724952, 231627852, 231627880, 28, 640x360 
0x12CB3460, 36963312169044416, 231627890, 231627893, 3, 640x360 
0x12CB3460, 36963312169362712, 231627910, 231627914, 4, 640x360 
0x12CB3460, 36963312169682312, 231627941, 231627945, 4, 640x360 
0x12CB3460, 36963312170162136, 231627991, 231627994, 3, 640x360 
0x12CB3460, 36963312170483800, 231628022, 231628026, 4, 640x360 
0x12CB3460, 36963312170801560, 231628060, 231628063, 3, 640x360 
0x12CB3460, 36963312171123176, 231628091, 231628093, 2, 640x360 
0x12CB3460, 36963312171443448, 231628120, 231628123, 3, 640x360 
0x12CB3460, 36963312171763800, 231628151, 231628154, 3, 640x360 
0x12CB3460, 36963312172082968, 231628182, 231628185, 3, 640x360 
0x12CB3460, 36963312172403672, 231628214, 231628219, 5, 640x360 
0x12CB3460, 36963312172721720, 231628251, 231628253, 2, 640x360 
0x12CB3460, 36963312173042656, 231628280, 231628283, 3, 640x360 
0x12CB3460, 36963312173363272, 231628311, 231628314, 3, 640x360 
0x12CB3460, 36963312173683688, 231628342, 231628345, 3, 640x360 
0x12CB3460, 36963312174163368, 231628390, 231628394, 4, 640x360 
0x12CB3460, 36963312174483400, 231628422, 231628425, 3, 640x360 
0x12CB3460, 36963312174802576, 231628460, 231628462, 2, 640x360 
0x12CB3460, 36963312175121848, 231628491, 231628494, 3, 640x360 
0x12CB3460, 36963312175442960, 231628520, 231628523, 3, 640x360 
0x12CB3460, 36963312175762304, 231628551, 231628555, 4, 640x360 
0x12CB3460, 36963312176082216, 231628591, 231628593, 2, 640x360 
0x12CB3460, 36963312176402544, 231628620, 231628623, 3, 640x360 
0x12CB3460, 36963312176722680, 231628651, 231628654, 3, 640x360 
0x12CB3460, 36963312177044192, 231628681, 231628684, 3, 640x360 
0x12CB3460, 36963312177364528, 231628710, 231628717, 7, 640x360 
0x12CB3460, 36963312177843712, 231628761, 231628764, 3, 640x360 
0x12CB3460, 36963312178165032, 231628791, 231628795, 4, 640x360 
0x12CB3460, 36963312178481904, 231628821, 231628825, 4, 640x360 
0x12CB3460, 36963312178803120, 231628873, 231628876, 3, 640x360 
0x12CB3460, 36963312179121984, 231628891, 231628893, 2, 640x360 
0x12CB3460, 36963312179442112, 231628920, 231628923, 3, 640x360 
0x12CB3460, 36963312179762448, 231628951, 231628955, 4, 640x360 
0x12CB3460, 36963312180082120, 231628991, 231628994, 3, 640x360 
0x12CB3460, 36963312180404456, 231629021, 231629024, 3, 640x360 
0x12CB3460, 36963312180726752, 231629052, 231629055, 3, 640x360 
0x12CB3460, 36963312181043224, 231629081, 231629084, 3, 640x360 
0x12CB3460, 36963312181363528, 231629111, 231629115, 4, 640x360 
0x12CB3460, 36963312181841504, 231629161, 231629164, 3, 640x360 
0x12CB3460, 36963312182162072, 231629192, 231629194, 2, 640x360 
0x12CB3460, 36963312182481592, 231629221, 231629225, 4, 640x360 
0x12CB3460, 36963312182801856, 231629260, 231629263, 3, 640x360 
0x12CB3460, 36963312183123344, 231629291, 231629293, 2, 640x360 
0x12CB3460, 36963312183444520, 231629321, 231629324, 3, 640x360 
0x12CB3460, 36963312183764520, 231629350, 231629357, 7, 640x360 
0x12CB3460, 36963312184083160, 231629385, 231629388, 3, 640x360 
0x12CB3460, 36963312184402232, 231629421, 231629424, 3, 640x360 
0x12CB3460, 36963312184723536, 231629451, 231629454, 3, 640x360 
0x12CB3460, 36963312185044448, 231629481, 231629484, 3, 640x360 
0x12CB3460, 36963312185525128, 231629531, 231629536, 5, 640x360 
0x12CB3460, 36963312185846208, 231629561, 231629579, 18, 640x360 
0x12CB3460, 36963312186162568, 231629590, 231629595, 5, 640x360 
0x12CB3460, 36963312186483056, 231629621, 231629625, 4, 640x360 
0x12CB3460, 36963312186802488, 231629661, 231629664, 3, 640x360 
0x12CB3460, 36963312187122904, 231629693, 231629696, 3, 640x360 
0x12CB3460, 36963312187443936, 231629722, 231629724, 2, 640x360 
0x12CB3460, 36963312187763792, 231629751, 231629754, 3, 640x360 
0x12CB3460, 36963312188084728, 231629791, 231629794, 3, 640x360 
0x12CB3460, 36963312188406888, 231629821, 231629826, 5, 640x360 
0x12CB3460, 36963312188727664, 231629880, 231629883, 3, 640x360 
0x12CB3460, 36963312189523320, 231629930, 231629933, 3, 640x360 
0x12CB3460, 36963312189843616, 231629961, 231629963, 2, 640x360 
0x12CB3460, 36963312190162696, 231629991, 231629994, 3, 640x360 
0x12CB3460, 36963312190485128, 231630022, 231630026, 4, 640x360 
0x12CB3460, 36963312190803016, 231630060, 231630066, 6, 640x360 
0x12CB3460, 36963312191121808, 231630090, 231630093, 3, 640x360 
0x12CB3460, 36963312191443256, 231630121, 231630124, 3, 640x360 
0x12CB3460, 36963312191763240, 231630151, 231630154, 3, 640x360 
0x12CB3460, 36963312192082568, 231630182, 231630186, 4, 640x360 
0x12CB3460, 36963312192402496, 231630220, 231630223, 3, 640x360 
0x12CB3460, 36963312192726152, 231630250, 231630253, 3, 640x360 
0x12CB3460, 36963312193042064, 231630281, 231630284, 3, 640x360 
0x12CB3460, 36963312193521488, 231630330, 231630333, 3, 640x360 
0x12CB3460, 36963312193844408, 231630372, 231630375, 3, 640x360 
0x12CB3460, 36963312194162600, 231630392, 231630395, 3, 640x360 
0x12CB3460, 36963312194483296, 231630422, 231630426, 4, 640x360 
0x12CB3460, 36963312194802800, 231630461, 231630463, 2, 640x360 
0x12CB3460, 36963312195123544, 231630491, 231630495, 4, 640x360 
0x12CB3460, 36963312195443104, 231630521, 231630524, 3, 640x360 
0x12CB3460, 36963312195762760, 231630552, 231630556, 4, 640x360 
0x12CB3460, 36963312196082272, 231630581, 231630584, 3, 640x360 
0x12CB3460, 36963312196402640, 231630620, 231630623, 3, 640x360 
0x12CB3460, 36963312196722872, 231630651, 231630654, 3, 640x360 
0x12CB3460, 36963312197204984, 231630702, 231630705, 3, 640x360 
0x12CB3460, 36963312197523392, 231630731, 231630734, 3, 640x360 
0x12CB3460, 36963312197843240, 231630760, 231630763, 3, 640x360 
0x12CB3460, 36963312198163920, 231630791, 231630794, 3, 640x360 
0x12CB3460, 36963312198482584, 231630833, 231630835, 2, 640x360 
0x12CB3460, 36963312198803992, 231630889, 231630892, 3, 640x360 
0x12CB3460, 36963312199442648, 231630921, 231630924, 3, 640x360 
0x12CB3460, 36963312199762072, 231630951, 231630954, 3, 640x360 
0x12CB3460, 36963312200083816, 231630982, 231630986, 4, 640x360 
0x12CB3460, 36963312200403216, 231631021, 231631025, 4, 640x360 
0x12CB3460, 36963312200724472, 231631052, 231631055, 3, 640x360 
0x12CB3460, 36963312201201832, 231631100, 231631103, 3, 640x360 
0x12CB3460, 36963312201522536, 231631131, 231631134, 3, 640x360 
0x12CB3460, 36963312201843168, 231631161, 231631163, 2, 640x360 
0x12CB3460, 36963312202161768, 231631191, 231631195, 4, 640x360 
0x12CB3460, 36963312202482232, 231631231, 231631234, 3, 640x360 
0x12CB3460, 36963312202804248, 231631260, 231631263, 3, 640x360 
0x12CB3460, 36963312203122824, 231631291, 231631293, 2, 640x360 
0x12CB3460, 36963312203443376, 231631320, 231631323, 3, 640x360 
0x12CB3460, 36963312203762832, 231631375, 231631378, 3, 640x360 
0x12CB3460, 36963312204082600, 231631382, 231631386, 4, 640x360 
0x12CB3460, 36963312204403744, 231631420, 231631423, 3, 640x360 
0x12CB3460, 36963312204722536, 231631451, 231631454, 3, 640x360 
0x12CB3460, 36963312205205176, 231631501, 231631503, 2, 640x360 
0x12CB3460, 36963312205523992, 231631532, 231631535, 3, 640x360 
0x12CB3460, 36963312205842464, 231631560, 231631563, 3, 640x360 
0x12CB3460, 36963312206161760, 231631591, 231631594, 3, 640x360 
0x12CB3460, 36963312206484312, 231631631, 231631634, 3, 640x360 
0x12CB3460, 36963312206802576, 231631660, 231631663, 3, 640x360 
0x12CB3460, 36963312207123976, 231631690, 231631693, 3, 640x360 
0x12CB3460, 36963312207444368, 231631722, 231631724, 2, 640x360 
0x12CB3460, 36963312207762368, 231631751, 231631754, 3, 640x360 
0x12CB3460, 36963312208082848, 231631782, 231631785, 3, 640x360 
0x12CB3460, 36963312208404072, 231631821, 231631824, 3, 640x360 
0x12CB3460, 36963312208886584, 231631877, 231631880, 3, 640x360 
0x12CB3460, 36963312209202480, 231631900, 231631903, 3, 640x360 
0x12CB3460, 36963312209523136, 231631932, 231631934, 2, 640x360 
0x12CB3460, 36963312209843784, 231631961, 231631963, 2, 640x360 
0x12CB3460, 36963312210165256, 231631991, 231631995, 4, 640x360 
0x12CB3460, 36963312210485728, 231632023, 231632027, 4, 640x360 
0x12CB3460, 36963312210802864, 231632054, 231632059, 5, 640x360 
0x12CB3460, 36963312211121520, 231632091, 231632093, 2, 640x360 
0x12CB3460, 36963312211443544, 231632120, 231632123, 3, 640x360 
0x12CB3460, 36963312211763976, 231632151, 231632154, 3, 640x360 
0x12CB3460, 36963312212084784, 231632191, 231632195, 4, 640x360 
0x12CB3460, 36963312212403944, 231632221, 231632224, 3, 640x360 
0x12CB3460, 36963312212882648, 231632271, 231632274, 3, 640x360 
0x12CB3460, 36963312213201776, 231632301, 231632315, 14, 640x360 
0x12CB3460, 36963312213523432, 231632332, 231632335, 3, 640x360 
0x12CB3460, 36963312213842520, 231632379, 231632382, 3, 640x360 
0x12CB3460, 36963312214161552, 231632390, 231632396, 6, 640x360 
0x12CB3460, 36963312214482056, 231632421, 231632439, 18, 640x360 
0x12CB3460, 36963312214801944, 231632461, 231632463, 2, 640x360 
0x12CB3460, 36963312215121456, 231632490, 231632493, 3, 640x360 
0x12CB3460, 36963312215444248, 231632521, 231632524, 3, 640x360 
0x12CB3460, 36963312215761952, 231632552, 231632555, 3, 640x360 
0x12CB3460, 36963312216082408, 231632581, 231632585, 4, 640x360 
0x12CB3460, 36963312216563552, 231632630, 231632634, 4, 640x360 
0x12CB3460, 36963312216882880, 231632670, 231632673, 3, 640x360 
0x12CB3460, 36963312217202120, 231632701, 231632703, 2, 640x360 
0x12CB3460, 36963312217523720, 231632731, 231632734, 3, 640x360 
0x12CB3460, 36963312217842488, 231632760, 231632763, 3, 640x360 
0x12CB3460, 36963312218161944, 231632791, 231632794, 3, 640x360 
0x12CB3460, 36963312218483752, 231632831, 231632834, 3, 640x360 
0x12CB3460, 36963312218803992, 231632871, 231632875, 4, 640x360 
0x12CB3460, 36963312219123992, 231632891, 231632893, 2, 640x360 
0x12CB3460, 36963312219442968, 231632920, 231632923, 3, 640x360 
0x12CB3460, 36963312219762144, 231632951, 231632955, 4, 640x360 
0x12CB3460, 36963312220083048, 231632991, 231632994, 3, 640x360 
0x12CB3460, 36963312220566544, 231633031, 231633034, 3, 640x360 
0x12CB3460, 36963312220884112, 231633070, 231633073, 3, 640x360 
0x12CB3460, 36963312221202872, 231633100, 231633103, 3, 640x360 
0x12CB3460, 36963312221521656, 231633132, 231633135, 3, 640x360 
0x12CB3460, 36963312221842760, 231633161, 231633164, 3, 640x360 
0x12CB3460, 36963312222163432, 231633192, 231633195, 3, 640x360 
0x12CB3460, 36963312222482064, 231633221, 231633228, 7, 640x360 
0x12CB3460, 36963312222801560, 231633260, 231633263, 3, 640x360 
0x12CB3460, 36963312223121800, 231633290, 231633293, 3, 640x360 
0x12CB3460, 36963312223444240, 231633321, 231633324, 3, 640x360 
0x12CB3460, 36963312223763672, 231633374, 231633377, 3, 640x360 
0x12CB3460, 36963312224082528, 231633383, 231633387, 4, 640x360 
0x12CB3460, 36963312224563168, 231633431, 231633434, 3, 640x360 
0x12CB3460, 36963312224881624, 231633471, 231633474, 3, 640x360 
0x12CB3460, 36963312225205280, 231633501, 231633504, 3, 640x360 
0x12CB3460, 36963312225525520, 231633532, 231633535, 3, 640x360 
0x12CB3460, 36963312225845456, 231633562, 231633581, 19, 640x360 
0x12CB3460, 36963312226163776, 231633591, 231633595, 4, 640x360 
0x12CB3460, 36963312226483320, 231633622, 231633625, 3, 640x360 
0x12CB3460, 36963312226802576, 231633661, 231633664, 3, 640x360 
0x12CB3460, 36963312227123176, 231633693, 231633696, 3, 640x360 
0x12CB3460, 36963312227444296, 231633721, 231633725, 4, 640x360 
0x12CB3460, 36963312227762128, 231633751, 231633754, 3, 640x360 
0x12CB3460, 36963312228244424, 231633801, 231633804, 3, 640x360 
0x12CB3460, 36963312228562728, 231633833, 231633837, 4, 640x360 
0x12CB3460, 36963312228885528, 231633881, 231633884, 3, 640x360 
0x12CB3460, 36963312229202032, 231633900, 231633903, 3, 640x360 
0x12CB3460, 36963312229522984, 231633931, 231633934, 3, 640x360 
0x12CB3460, 36963312229843480, 231633960, 231633963, 3, 640x360 
0x12CB3460, 36963312230164768, 231633990, 231633995, 5, 640x360 
0x12CB3460, 36963312230483816, 231634031, 231634035, 4, 640x360 
0x12CB3460, 36963312230802224, 231634061, 231634068, 7, 640x360 
0x12CB3460, 36963312231122272, 231634091, 231634108, 17, 640x360 
0x12CB3460, 36963312231442736, 231634120, 231634123, 3, 640x360 
0x12CB3460, 36963312231763608, 231634152, 231634164, 12, 640x360 
0x12CB3460, 36963312232245664, 231634200, 231634204, 4, 640x360 
0x12CB3460, 36963312232561808, 231634231, 231634234, 3, 640x360 
0x12CB3460, 36963312232881464, 231634261, 231634265, 4, 640x360 
0x12CB3460, 36963312233203056, 231634301, 231634303, 2, 640x360 
0x12CB3460, 36963312233522008, 231634330, 231634333, 3, 640x360 
0x12CB3460, 36963312233844936, 231634377, 231634380, 3, 640x360 
0x12CB3460, 36963312234162688, 231634391, 231634396, 5, 640x360 
0x12CB3460, 36963312234483512, 231634421, 231634425, 4, 640x360 
0x12CB3460, 36963312234801776, 231634461, 231634464, 3, 640x360 
0x12CB3460, 36963312235122496, 231634490, 231634493, 3, 640x360 
0x12CB3460, 36963312235443440, 231634521, 231634524, 3, 640x360 
0x12CB3460, 36963312235763168, 231634551, 231634554, 3, 640x360 
0x12CB3460, 36963312236243520, 231634600, 231634603, 3, 640x360 
0x12CB3460, 36963312236563776, 231634630, 231634634, 4, 640x360 
0x12CB3460, 36963312236882160, 231634671, 231634674, 3, 640x360 
0x12CB3460, 36963312237203528, 231634702, 231634705, 3, 640x360 
0x12CB3460, 36963312237522496, 231634730, 231634733, 3, 640x360 
0x12CB3460, 36963312237841648, 231634761, 231634764, 3, 640x360 
0x12CB3460, 36963312238164208, 231634790, 231634793, 3, 640x360 
0x12CB3460, 36963312238483720, 231634830, 231634834, 4, 640x360 
0x12CB3460, 36963312238805104, 231634882, 231634886, 4, 640x360 
0x12CB3460, 36963312239123760, 231634891, 231634895, 4, 640x360 
0x12CB3460, 36963312239441552, 231634920, 231634923, 3, 640x360 
0x12CB3460, 36963312239924160, 231634971, 231634974, 3, 640x360 
0x12CB3460, 36963312240242968, 231635001, 231635004, 3, 640x360 
0x12CB3460, 36963312240565408, 231635030, 231635035, 5, 640x360 
0x12CB3460, 36963312240883864, 231635062, 231635066, 4, 640x360 
0x12CB3460, 36963312241201280, 231635101, 231635104, 3, 640x360 
0x12CB3460, 36963312241523144, 231635131, 231635133, 2, 640x360 
0x12CB3460, 36963312241843312, 231635160, 231635163, 3, 640x360 
0x12CB3460, 36963312242161976, 231635190, 231635193, 3, 640x360 
0x12CB3460, 36963312242481464, 231635222, 231635226, 4, 640x360 
0x12CB3460, 36963312242802864, 231635260, 231635264, 4, 640x360 
0x12CB3460, 36963312243122856, 231635290, 231635293, 3, 640x360 
0x12CB3460, 36963312243443056, 231635321, 231635324, 3, 640x360 
0x12CB3460, 36963312243921280, 231635371, 231635374, 3, 640x360 
0x12CB3460, 36963312244243064, 231635401, 231635404, 3, 640x360 
0x12CB3460, 36963312244562440, 231635431, 231635439, 8, 640x360 
0x12CB3460, 36963312244881624, 231635462, 231635466, 4, 640x360 
0x12CB3460, 36963312245202448, 231635500, 231635503, 3, 640x360 
0x12CB3460, 36963312245522608, 231635532, 231635534, 2, 640x360 
0x12CB3460, 36963312245845640, 231635561, 231635564, 3, 640x360 
0x12CB3460, 36963312246162776, 231635591, 231635595, 4, 640x360 
0x12CB3460, 36963312246485568, 231635630, 231635633, 3, 640x360 
0x12CB3460, 36963312246803176, 231635660, 231635664, 4, 640x360 
0x12CB3460, 36963312247124800, 231635692, 231635695, 3, 640x360 
0x12CB3460, 36963312247452568, 231635722, 231635741, 19, 640x360 
0x12CB3460, 36963312247921232, 231635771, 231635774, 3, 640x360 
0x12CB3460, 36963312248243416, 231635800, 231635803, 3, 640x360 
0x12CB3460, 36963312248562000, 231635832, 231635835, 3, 640x360 
0x12CB3460, 36963312248884944, 231635880, 231635889, 9, 640x360 
0x12CB3460, 36963312249201440, 231635900, 231635903, 3, 640x360 
0x12CB3460, 36963312249522280, 231635931, 231635933, 2, 640x360 
0x12CB3460, 36963312249842512, 231635960, 231635963, 3, 640x360 
0x12CB3460, 36963312250164176, 231635991, 231635994, 3, 640x360 
0x12CB3460, 36963312250484400, 231636031, 231636035, 4, 640x360 
0x12CB3460, 36963312250804032, 231636055, 231636059, 4, 640x360 
0x12CB3460, 36963312251122272, 231636091, 231636093, 2, 640x360 
0x12CB3460, 36963312251603120, 231636141, 231636143, 2, 640x360 
0x12CB3460, 36963312251921800, 231636172, 231636175, 3, 640x360 
0x12CB3460, 36963312252242816, 231636202, 231636205, 3, 640x360 
0x12CB3460, 36963312252561808, 231636231, 231636234, 3, 640x360 
0x12CB3460, 36963312252882480, 231636261, 231636265, 4, 640x360 
0x12CB3460, 36963312253203744, 231636301, 231636303, 2, 640x360 
0x12CB3460, 36963312253521744, 231636330, 231636333, 3, 640x360 
0x12CB3460, 36963312253844040, 231636374, 231636377, 3, 640x360 
0x12CB3460, 36963312254162720, 231636390, 231636394, 4, 640x360 
0x12CB3460, 36963312254482600, 231636421, 231636425, 4, 640x360 
0x12CB3460, 36963312254801784, 231636460, 231636463, 3, 640x360 
0x12CB3460, 36963312255121912, 231636491, 231636509, 18, 640x360 
0x12CB3460, 36963312255601104, 231636540, 231636544, 4, 640x360 
0x12CB3460, 36963312255921360, 231636571, 231636574, 3, 640x360 
0x12CB3460, 36963312256243336, 231636601, 231636603, 2, 640x360 
0x12CB3460, 36963312256561080, 231636631, 231636634, 3, 640x360 
0x12CB3460, 36963312256881592, 231636671, 231636674, 3, 640x360 
0x12CB3460, 36963312257204168, 231636701, 231636704, 3, 640x360 
0x12CB3460, 36963312257521920, 231636731, 231636733, 2, 640x360 
0x12CB3460, 36963312257841720, 231636760, 231636763, 3, 640x360 
0x12CB3460, 36963312258163512, 231636791, 231636793, 2, 640x360 
0x12CB3460, 36963312258482048, 231636831, 231636834, 3, 640x360 
0x12CB3460, 36963312258804728, 231636880, 231636884, 4, 640x360 
0x12CB3460, 36963312259282152, 231636901, 231636904, 3, 640x360 
0x12CB3460, 36963312259602976, 231636941, 231636944, 3, 640x360 
0x12CB3460, 36963312259921848, 231636970, 231636973, 3, 640x360 
0x12CB3460, 36963312260242400, 231637001, 231637004, 3, 640x360 
0x12CB3460, 36963312260565384, 231637032, 231637035, 3, 640x360 
0x12CB3460, 36963312260884224, 231637070, 231637074, 4, 640x360 
0x12CB3460, 36963312261201808, 231637101, 231637103, 2, 640x360 
0x12CB3460, 36963312261522288, 231637132, 231637134, 2, 640x360 
0x12CB3460, 36963312261841832, 231637160, 231637163, 3, 640x360 
0x12CB3460, 36963312262163208, 231637192, 231637194, 2, 640x360 
0x12CB3460, 36963312262483248, 231637221, 231637224, 3, 640x360 
0x12CB3460, 36963312262802736, 231637260, 231637263, 3, 640x360 
0x12CB3460, 36963312263282576, 231637311, 231637313, 2, 640x360 
0x12CB3460, 36963312263603152, 231637341, 231637343, 2, 640x360 
0x12CB3460, 36963312263922096, 231637375, 231637378, 3, 640x360 
0x12CB3460, 36963312264242760, 231637400, 231637414, 14, 640x360 
0x12CB3460, 36963312264561680, 231637431, 231637434, 3, 640x360 
0x12CB3460, 36963312264883376, 231637471, 231637474, 3, 640x360 
0x12CB3460, 36963312265204976, 231637501, 231637505, 4, 640x360 
0x12CB3460, 36963312265523912, 231637531, 231637534, 3, 640x360 
0x12CB3460, 36963312265845456, 231637565, 231637568, 3, 640x360 
0x12CB3460, 36963312266163736, 231637591, 231637594, 3, 640x360 
0x12CB3460, 36963312266481752, 231637631, 231637633, 2, 640x360 
0x12CB3460, 36963312266802168, 231637661, 231637663, 2, 640x360 
0x12CB3460, 36963312267281208, 231637711, 231637714, 3, 640x360 
0x12CB3460, 36963312267602400, 231637740, 231637743, 3, 640x360 
0x12CB3460, 36963312267922584, 231637770, 231637773, 3, 640x360 
0x12CB3460, 36963312268243184, 231637801, 231637804, 3, 640x360 
0x12CB3460, 36963312268564104, 231637831, 231637834, 3, 640x360 
0x12CB3460, 36963312268883328, 231637874, 231637877, 3, 640x360 
0x12CB3460, 36963312269206536, 231637900, 231637902, 2, 640x360 
0x12CB3460, 36963312269522888, 231637931, 231637933, 2, 640x360 
0x12CB3460, 36963312269841792, 231637960, 231637963, 3, 640x360 
0x12CB3460, 36963312270164752, 231637991, 231637995, 4, 640x360 
0x12CB3460, 36963312270484744, 231638031, 231638034, 3, 640x360 
0x12CB3460, 36963312270962208, 231638071, 231638074, 3, 640x360 
0x12CB3460, 36963312271280688, 231638111, 231638114, 3, 640x360 
0x12CB3460, 36963312271601952, 231638141, 231638144, 3, 640x360 
0x12CB3460, 36963312271924144, 231638172, 231638175, 3, 640x360 
0x12CB3460, 36963312272242264, 231638201, 231638205, 4, 640x360 
0x12CB3460, 36963312272562256, 231638231, 231638235, 4, 640x360 
0x12CB3460, 36963312272882200, 231638262, 231638265, 3, 640x360 
0x12CB3460, 36963312273201592, 231638301, 231638304, 3, 640x360 
0x12CB3460, 36963312273521520, 231638330, 231638333, 3, 640x360 
0x12CB3460, 36963312273845504, 231638380, 231638383, 3, 640x360 
0x12CB3460, 36963312274162576, 231638391, 231638396, 5, 640x360 
0x12CB3460, 36963312274481680, 231638421, 231638425, 4, 640x360 
0x12CB3460, 36963312274962984, 231638470, 231638474, 4, 640x360 
0x12CB3460, 36963312275283688, 231638502, 231638506, 4, 640x360 
0x12CB3460, 36963312275602208, 231638540, 231638543, 3, 640x360 
0x12CB3460, 36963312275921648, 231638571, 231638573, 2, 640x360 
0x12CB3460, 36963312276241432, 231638600, 231638603, 3, 640x360 
0x12CB3460, 36963312276563560, 231638632, 231638635, 3, 640x360 
0x12CB3460, 36963312276881848, 231638671, 231638674, 3, 640x360 
0x12CB3460, 36963312277202200, 231638701, 231638703, 2, 640x360 
0x12CB3460, 36963312277521128, 231638730, 231638734, 4, 640x360 
0x12CB3460, 36963312277841392, 231638760, 231638763, 3, 640x360 
0x12CB3460, 36963312278163376, 231638791, 231638794, 3, 640x360 
0x12CB3460, 36963312278482496, 231638831, 231638834, 3, 640x360 
0x12CB3460, 36963312278960840, 231638871, 231638874, 3, 640x360 
0x12CB3460, 36963312279282152, 231638901, 231638905, 4, 640x360 
0x12CB3460, 36963312279602448, 231638940, 231638943, 3, 640x360 
0x12CB3460, 36963312279920864, 231638970, 231638973, 3, 640x360 
0x12CB3460, 36963312280242816, 231639001, 231639004, 3, 640x360 
0x12CB3460, 36963312280562016, 231639031, 231639034, 3, 640x360 
0x12CB3460, 36963312280882512, 231639061, 231639065, 4, 640x360 
0x12CB3460, 36963312281202056, 231639101, 231639103, 2, 640x360 
0x12CB3460, 36963312281523416, 231639130, 231639133, 3, 640x360 
0x12CB3460, 36963312281843496, 231639161, 231639165, 4, 640x360 
0x12CB3460, 36963312282165800, 231639191, 231639195, 4, 640x360 
0x12CB3460, 36963312282643856, 231639241, 231639244, 3, 640x360 
0x12CB3460, 36963312282962936, 231639271, 231639274, 3, 640x360 
0x12CB3460, 36963312283281368, 231639301, 231639305, 4, 640x360 
0x12CB3460, 36963312283603368, 231639340, 231639343, 3, 640x360 
0x12CB3460, 36963312283921928, 231639377, 231639381, 4, 640x360 
0x12CB3460, 36963312284241824, 231639400, 231639403, 3, 640x360 
0x12CB3460, 36963312284562632, 231639431, 231639434, 3, 640x360 
0x12CB3460, 36963312284882256, 231639472, 231639475, 3, 640x360 
0x12CB3460, 36963312285203384, 231639502, 231639506, 4, 640x360 
0x12CB3460, 36963312285524224, 231639531, 231639540, 9, 640x360 
0x12CB3460, 36963312285847416, 231639562, 231639565, 3, 640x360 
0x12CB3460, 36963312286162408, 231639590, 231639594, 4, 640x360 
0x12CB3460, 36963312286640832, 231639641, 231639643, 2, 640x360 
0x12CB3460, 36963312286961192, 231639671, 231639674, 3, 640x360 
0x12CB3460, 36963312287282832, 231639702, 231639705, 3, 640x360 
0x12CB3460, 36963312287602752, 231639741, 231639744, 3, 640x360 
0x12CB3460, 36963312287922704, 231639770, 231639773, 3, 640x360 
0x12CB3460, 36963312288241352, 231639801, 231639804, 3, 640x360 
0x12CB3460, 36963312288561024, 231639830, 231639833, 3, 640x360 
0x12CB3460, 36963312288881856, 231639874, 231639877, 3, 640x360 
0x12CB3460, 36963312289201704, 231639900, 231639903, 3, 640x360 
0x12CB3460, 36963312289522744, 231639931, 231639934, 3, 640x360 
0x12CB3460, 36963312289842960, 231639961, 231639964, 3, 640x360 
0x12CB3460, 36963312290162624, 231639990, 231639994, 4, 640x360 
0x12CB3460, 36963312290646304, 231640043, 231640046, 3, 640x360 
0x12CB3460, 36963312290961912, 231640071, 231640074, 3, 640x360 
0x12CB3460, 36963312291280920, 231640101, 231640105, 4, 640x360 
0x12CB3460, 36963312291601328, 231640141, 231640144, 3, 640x360 
0x12CB3460, 36963312291921592, 231640170, 231640174, 4, 640x360 
0x12CB3460, 36963312292241976, 231640200, 231640203, 3, 640x360 
0x12CB3460, 36963312292563152, 231640231, 231640234, 3, 640x360 
0x12CB3460, 36963312292880840, 231640271, 231640274, 3, 640x360 
0x12CB3460, 36963312293202824, 231640300, 231640315, 15, 640x360 
0x12CB3460, 36963312293523856, 231640331, 231640334, 3, 640x360 
0x12CB3460, 36963312293849112, 231640375, 231640378, 3, 640x360 
0x12CB3460, 36963312294322496, 231640411, 231640414, 3, 640x360 
0x12CB3460, 36963312294641416, 231640440, 231640443, 3, 640x360 
0x12CB3460, 36963312294961176, 231640472, 231640474, 2, 640x360 
0x12CB3460, 36963312295283848, 231640511, 231640514, 3, 640x360 
0x12CB3460, 36963312295602328, 231640541, 231640543, 2, 640x360 
0x12CB3460, 36963312295922160, 231640571, 231640574, 3, 640x360 
0x12CB3460, 36963312296243152, 231640600, 231640603, 3, 640x360 
0x12CB3460, 36963312296561456, 231640631, 231640634, 3, 640x360 
0x12CB3460, 36963312296881832, 231640670, 231640673, 3, 640x360 
0x12CB3460, 36963312297201568, 231640700, 231640703, 3, 640x360 
0x12CB3460, 36963312297521456, 231640732, 231640736, 4, 640x360 
0x12CB3460, 36963312297841384, 231640760, 231640763, 3, 640x360 
0x12CB3460, 36963312298323312, 231640811, 231640814, 3, 640x360 
0x12CB3460, 36963312298642096, 231640842, 231640845, 3, 640x360 
0x12CB3460, 36963312298961024, 231640875, 231640878, 3, 640x360 
0x12CB3460, 36963312299280768, 231640901, 231640905, 4, 640x360 
0x12CB3460, 36963312299602664, 231640941, 231640959, 18, 640x360 
0x12CB3460, 36963312299921880, 231640970, 231640973, 3, 640x360 
0x12CB3460, 36963312300244576, 231641001, 231641004, 3, 640x360 
0x12CB3460, 36963312300562816, 231641031, 231641035, 4, 640x360 
0x12CB3460, 36963312300882024, 231641064, 231641067, 3, 640x360 
0x12CB3460, 36963312301202088, 231641100, 231641103, 3, 640x360 
0x12CB3460, 36963312301521968, 231641131, 231641134, 3, 640x360 
0x12CB3460, 36963312302000408, 231641181, 231641184, 3, 640x360 
0x12CB3460, 36963312302320880, 231641210, 231641213, 3, 640x360 
0x12CB3460, 36963312302640832, 231641241, 231641243, 2, 640x360 
0x12CB3460, 36963312302962816, 231641272, 231641275, 3, 640x360 
0x12CB3460, 36963312303283232, 231641310, 231641313, 3, 640x360 
0x12CB3460, 36963312303602456, 231641342, 231641345, 3, 640x360 
0x12CB3460, 36963312303922760, 231641382, 231641385, 3, 640x360 
0x12CB3460, 36963312304241040, 231641401, 231641404, 3, 640x360 
0x12CB3460, 36963312304562096, 231641430, 231641433, 3, 640x360 
0x12CB3460, 36963312304881304, 231641470, 231641473, 3, 640x360 
0x12CB3460, 36963312305201960, 231641501, 231641503, 2, 640x360 
0x12CB3460, 36963312305522896, 231641530, 231641533, 3, 640x360 
0x12CB3460, 36963312306003024, 231641581, 231641585, 4, 640x360 
0x12CB3460, 36963312306322768, 231641610, 231641613, 3, 640x360 
0x12CB3460, 36963312306643280, 231641641, 231641644, 3, 640x360 
0x12CB3460, 36963312306963672, 231641671, 231641674, 3, 640x360 
0x12CB3460, 36963312307282928, 231641712, 231641716, 4, 640x360 
0x12CB3460, 36963312307602392, 231641741, 231641744, 3, 640x360 
0x12CB3460, 36963312307921576, 231641771, 231641774, 3, 640x360 
0x12CB3460, 36963312308242568, 231641800, 231641803, 3, 640x360 
0x12CB3460, 36963312308561896, 231641831, 231641834, 3, 640x360 
0x12CB3460, 36963312308887928, 231641874, 231641878, 4, 640x360 
0x12CB3460, 36963312309204360, 231641900, 231641903, 3, 640x360 
0x12CB3460, 36963312309522864, 231641931, 231641933, 2, 640x360 
0x12CB3460, 36963312310003024, 231641980, 231641983, 3, 640x360 
0x12CB3460, 36963312310321592, 231642010, 231642013, 3, 640x360 
0x12CB3460, 36963312310644248, 231642041, 231642045, 4, 640x360 
0x12CB3460, 36963312310961368, 231642071, 231642074, 3, 640x360 
0x12CB3460, 36963312311280832, 231642111, 231642113, 2, 640x360 
0x12CB3460, 36963312311603312, 231642140, 231642144, 4, 640x360 
0x12CB3460, 36963312311921256, 231642171, 231642173, 2, 640x360 
0x12CB3460, 36963312312241352, 231642201, 231642204, 3, 640x360 
0x12CB3460, 36963312312561872, 231642231, 231642235, 4, 640x360 
0x12CB3460, 36963312312881136, 231642271, 231642274, 3, 640x360 
0x12CB3460, 36963312313202976, 231642300, 231642303, 3, 640x360 
0x12CB3460, 36963312313682960, 231642370, 231642373, 3, 640x360 
0x12CB3460, 36963312314001952, 231642381, 231642384, 3, 640x360 
0x12CB3460, 36963312314322064, 231642412, 231642417, 5, 640x360 
0x12CB3460, 36963312314640992, 231642441, 231642444, 3, 640x360 
0x12CB3460, 36963312314961392, 231642472, 231642474, 2, 640x360 
0x12CB3460, 36963312315283600, 231642511, 231642515, 4, 640x360 
0x12CB3460, 36963312315604440, 231642541, 231642544, 3, 640x360 
0x12CB3460, 36963312315922768, 231642571, 231642574, 3, 640x360 
0x12CB3460, 36963312316243120, 231642601, 231642604, 3, 640x360 
0x12CB3460, 36963312316561520, 231642631, 231642634, 3, 640x360 
0x12CB3460, 36963312316882312, 231642672, 231642676, 4, 640x360 
0x12CB3460, 36963312317203872, 231642702, 231642705, 3, 640x360 
0x12CB3460, 36963312317680896, 231642741, 231642746, 5, 640x360 
0x12CB3460, 36963312318002272, 231642780, 231642782, 2, 640x360 
0x12CB3460, 36963312318322744, 231642811, 231642814, 3, 640x360 
0x12CB3460, 36963312318641760, 231642840, 231642843, 3, 640x360 
0x12CB3460, 36963312318962552, 231642875, 231642878, 3, 640x360 
0x12CB3460, 36963312319280928, 231642901, 231642905, 4, 640x360 
0x12CB3460, 36963312319602536, 231642940, 231642943, 3, 640x360 
0x12CB3460, 36963312319921248, 231642970, 231642973, 3, 640x360 
0x12CB3460, 36963312320243592, 231643001, 231643004, 3, 640x360 
0x12CB3460, 36963312320562040, 231643030, 231643036, 6, 640x360 
0x12CB3460, 36963312320880968, 231643061, 231643065, 4, 640x360 
0x12CB3460, 36963312321202224, 231643102, 231643104, 2, 640x360 
0x12CB3460, 36963312321683560, 231643141, 231643145, 4, 640x360 
0x12CB3460, 36963312322002016, 231643181, 231643184, 3, 640x360 
0x12CB3460, 36963312322321680, 231643211, 231643216, 5, 640x360 
0x12CB3460, 36963312322644352, 231643241, 231643244, 3, 640x360 
0x12CB3460, 36963312322960992, 231643271, 231643274, 3, 640x360 
0x12CB3460, 36963312323281496, 231643311, 231643314, 3, 640x360 
0x12CB3460, 36963312323603592, 231643341, 231643345, 4, 640x360 
0x12CB3460, 36963312323923288, 231643382, 231643390, 8, 640x360 
0x12CB3460, 36963312324240752, 231643401, 231643404, 3, 640x360 
0x12CB3460, 36963312324562440, 231643431, 231643434, 3, 640x360 
0x12CB3460, 36963312324882792, 231643462, 231643466, 4, 640x360 
0x12CB3460, 36963312325362080, 231643511, 231643515, 4, 640x360 
0x12CB3460, 36963312325685712, 231643551, 231643554, 3, 640x360 
0x12CB3460, 36963312326002352, 231643574, 231643577, 3, 640x360 
0x12CB3460, 36963312326320944, 231643611, 231643613, 2, 640x360 
0x12CB3460, 36963312326643664, 231643641, 231643643, 2, 640x360 
0x12CB3460, 36963312326962392, 231643672, 231643689, 17, 640x360 
0x12CB3460, 36963312327281736, 231643711, 231643714, 3, 640x360 
0x12CB3460, 36963312327602264, 231643740, 231643743, 3, 640x360 
0x12CB3460, 36963312327921824, 231643771, 231643773, 2, 640x360 
0x12CB3460, 36963312328241424, 231643800, 231643803, 3, 640x360 
0x12CB3460, 36963312328563640, 231643832, 231643835, 3, 640x360 
0x12CB3460, 36963312328883864, 231643873, 231643877, 4, 640x360 
0x12CB3460, 36963312329361872, 231643911, 231643914, 3, 640x360 
0x12CB3460, 36963312329682544, 231643941, 231643945, 4, 640x360 
0x12CB3460, 36963312330001328, 231643981, 231643984, 3, 640x360 
0x12CB3460, 36963312330323504, 231644011, 231644015, 4, 640x360 
0x12CB3460, 36963312330643616, 231644042, 231644046, 4, 640x360 
0x12CB3460, 36963312330962416, 231644070, 231644077, 7, 640x360 
0x12CB3460, 36963312331280840, 231644101, 231644105, 4, 640x360 
0x12CB3460, 36963312331602136, 231644141, 231644144, 3, 640x360 
0x12CB3460, 36963312331921536, 231644171, 231644174, 3, 640x360 
0x12CB3460, 36963312332242464, 231644201, 231644204, 3, 640x360 
0x12CB3460, 36963312332564544, 231644231, 231644234, 3, 640x360 
0x12CB3460, 36963312333042000, 231644280, 231644283, 3, 640x360 
0x12CB3460, 36963312333360696, 231644311, 231644314, 3, 640x360 
0x12CB3460, 36963312333681984, 231644351, 231644355, 4, 640x360 
0x12CB3460, 36963312334003064, 231644379, 231644382, 3, 640x360 
0x12CB3460, 36963312334322408, 231644411, 231644414, 3, 640x360 
0x12CB3460, 36963312334642176, 231644440, 231644443, 3, 640x360 
0x12CB3460, 36963312334962648, 231644471, 231644474, 3, 640x360 
0x12CB3460, 36963312335281448, 231644510, 231644513, 3, 640x360 
0x12CB3460, 36963312335602240, 231644542, 231644544, 2, 640x360 
0x12CB3460, 36963312335923984, 231644572, 231644576, 4, 640x360 
0x12CB3460, 36963312336243000, 231644601, 231644604, 3, 640x360 
0x12CB3460, 36963312336561392, 231644630, 231644633, 3, 640x360 
0x12CB3460, 36963312337043368, 231644682, 231644685, 3, 640x360 
0x12CB3460, 36963312337362592, 231644711, 231644714, 3, 640x360 
0x12CB3460, 36963312337683608, 231644742, 231644746, 4, 640x360 
0x12CB3460, 36963312338002344, 231644781, 231644784, 3, 640x360 
0x12CB3460, 36963312338322552, 231644810, 231644813, 3, 640x360 
0x12CB3460, 36963312338644656, 231644843, 231644847, 4, 640x360 
0x12CB3460, 36963312338962248, 231644874, 231644877, 3, 640x360 
0x12CB3460, 36963312339280784, 231644911, 231644913, 2, 640x360 
0x12CB3460, 36963312339601496, 231644940, 231644943, 3, 640x360 
0x12CB3460, 36963312339921656, 231644971, 231644974, 3, 640x360 
0x12CB3460, 36963312340244008, 231645001, 231645004, 3, 640x360 
0x12CB3460, 36963312340563424, 231645031, 231645034, 3, 640x360 
0x12CB3460, 36963312341045104, 231645082, 231645084, 2, 640x360 
0x12CB3460, 36963312341361640, 231645111, 231645114, 3, 640x360 
0x12CB3460, 36963312341683496, 231645151, 231645153, 2, 640x360 
0x12CB3460, 36963312342002432, 231645180, 231645183, 3, 640x360 
0x12CB3460, 36963312342321176, 231645210, 231645213, 3, 640x360 
0x12CB3460, 36963312342642424, 231645241, 231645244, 3, 640x360 
0x12CB3460, 36963312342961064, 231645271, 231645274, 3, 640x360 
0x12CB3460, 36963312343282176, 231645302, 231645306, 4, 640x360 
0x12CB3460, 36963312343602664, 231645340, 231645344, 4, 640x360 
0x12CB3460, 36963312343925176, 231645375, 231645378, 3, 640x360 
0x12CB3460, 36963312344241760, 231645400, 231645402, 2, 640x360 
0x12CB3460, 36963312344720456, 231645451, 231645455, 4, 640x360 
0x12CB3460, 36963312345040488, 231645481, 231645484, 3, 640x360 
0x12CB3460, 36963312345362600, 231645511, 231645514, 3, 640x360 
0x12CB3460, 36963312345680904, 231645542, 231645545, 3, 640x360 
0x12CB3460, 36963312346004288, 231645580, 231645586, 6, 640x360 
0x12CB3460, 36963312346322016, 231645611, 231645613, 2, 640x360 
0x12CB3460, 36963312346642504, 231645640, 231645643, 3, 640x360 
0x12CB3460, 36963312346961600, 231645671, 231645674, 3, 640x360 
0x12CB3460, 36963312347282152, 231645711, 231645715, 4, 640x360 
0x12CB3460, 36963312347604800, 231645737, 231645742, 5, 640x360 
0x12CB3460, 36963312347921584, 231645771, 231645773, 2, 640x360 
0x12CB3460, 36963312348243240, 231645800, 231645803, 3, 640x360 
0x12CB3460, 36963312348720752, 231645850, 231645853, 3, 640x360 
0x12CB3460, 36963312349040840, 231645884, 231645887, 3, 640x360 
0x12CB3460, 36963312349362208, 231645912, 231645915, 3, 640x360 
0x12CB3460, 36963312349681544, 231645941, 231645945, 4, 640x360 
0x12CB3460, 36963312350002912, 231645981, 231645984, 3, 640x360 
0x12CB3460, 36963312350322488, 231646011, 231646014, 3, 640x360 
0x12CB3460, 36963312350642800, 231646042, 231646045, 3, 640x360 
0x12CB3460, 36963312350961040, 231646071, 231646075, 4, 640x360 
0x12CB3460, 36963312351281408, 231646101, 231646105, 4, 640x360 
0x12CB3460, 36963312351602376, 231646140, 231646143, 3, 640x360 
0x12CB3460, 36963312351921712, 231646170, 231646173, 3, 640x360 
0x12CB3460, 36963312352242672, 231646201, 231646204, 3, 640x360 
0x12CB3460, 36963312352722512, 231646250, 231646253, 3, 640x360 
0x12CB3460, 36963312353041880, 231646281, 231646283, 2, 640x360 
0x12CB3460, 36963312353360848, 231646311, 231646314, 3, 640x360 
0x12CB3460, 36963312353683208, 231646341, 231646345, 4, 640x360 
0x12CB3460, 36963312354000840, 231646374, 231646378, 4, 640x360 
0x12CB3460, 36963312354321336, 231646410, 231646413, 3, 640x360 
0x12CB3460, 36963312354641112, 231646441, 231646459, 18, 640x360 
0x12CB3460, 36963312354961224, 231646471, 231646474, 3, 640x360 
0x12CB3460, 36963312355284080, 231646510, 231646514, 4, 640x360 
0x12CB3460, 36963312355603080, 231646535, 231646539, 4, 640x360 
0x12CB3460, 36963312355923032, 231646572, 231646575, 3, 640x360 
0x12CB3460, 36963312356403008, 231646622, 231646624, 2, 640x360 
0x12CB3460, 36963312356723880, 231646650, 231646654, 4, 640x360 
0x12CB3460, 36963312357043208, 231646683, 231646686, 3, 640x360 
0x12CB3460, 36963312357361320, 231646712, 231646715, 3, 640x360 
0x12CB3460, 36963312357680824, 231646741, 231646745, 4, 640x360 
0x12CB3460, 36963312358001232, 231646781, 231646784, 3, 640x360 
0x12CB3460, 36963312358320920, 231646810, 231646813, 3, 640x360 
0x12CB3460, 36963312358642608, 231646841, 231646844, 3, 640x360 
0x12CB3460, 36963312358961704, 231646876, 231646879, 3, 640x360 
0x12CB3460, 36963312359281216, 231646911, 231646915, 4, 640x360 
0x12CB3460, 36963312359601832, 231646941, 231646943, 2, 640x360 
0x12CB3460, 36963312359922000, 231646971, 231646974, 3, 640x360 
0x12CB3460, 36963312360400920, 231647020, 231647039, 19, 640x360 
0x12CB3460, 36963312360723488, 231647051, 231647054, 3, 640x360 
0x12CB3460, 36963312361041288, 231647081, 231647083, 2, 640x360 
0x12CB3460, 36963312361362456, 231647111, 231647114, 3, 640x360 
0x12CB3460, 36963312361682912, 231647151, 231647154, 3, 640x360 
0x12CB3460, 36963312362001704, 231647181, 231647184, 3, 640x360 
0x12CB3460, 36963312362322376, 231647211, 231647214, 3, 640x360 
0x12CB3460, 36963312362642360, 231647241, 231647244, 3, 640x360 
0x12CB3460, 36963312362962040, 231647270, 231647273, 3, 640x360 
0x12CB3460, 36963312363283032, 231647310, 231647313, 3, 640x360 
0x12CB3460, 36963312363603912, 231647341, 231647344, 3, 640x360 
0x12CB3460, 36963312363924864, 231647390, 231647394, 4, 640x360 
0x12CB3460, 36963312364400248, 231647421, 231647423, 2, 640x360 
0x12CB3460, 36963312364722424, 231647451, 231647454, 3, 640x360 
0x12CB3460, 36963312365042816, 231647481, 231647484, 3, 640x360 
0x12CB3460, 36963312365362856, 231647510, 231647514, 4, 640x360 
0x12CB3460, 36963312365684240, 231647542, 231647546, 4, 640x360 
0x12CB3460, 36963312366004160, 231647582, 231647586, 4, 640x360 
0x12CB3460, 36963312366320528, 231647611, 231647613, 2, 640x360 
0x12CB3460, 36963312366640800, 231647641, 231647644, 3, 640x360 
0x12CB3460, 36963312366962776, 231647672, 231647675, 3, 640x360 
0x12CB3460, 36963312367284552, 231647711, 231647715, 4, 640x360 
0x12CB3460, 36963312367603224, 231647741, 231647745, 4, 640x360 
0x12CB3460, 36963312368080408, 231647782, 231647785, 3, 640x360 
0x12CB3460, 36963312368400880, 231647821, 231647824, 3, 640x360 
0x12CB3460, 36963312368721376, 231647872, 231647876, 4, 640x360 
0x12CB3460, 36963312369043096, 231647881, 231647884, 3, 640x360 
0x12CB3460, 36963312369360848, 231647911, 231647914, 3, 640x360 
0x12CB3460, 36963312369680888, 231647942, 231647946, 4, 640x360 
0x12CB3460, 36963312370001992, 231647981, 231647983, 2, 640x360 
0x12CB3460, 36963312370321656, 231648010, 231648013, 3, 640x360 
0x12CB3460, 36963312370642112, 231648041, 231648044, 3, 640x360 
0x12CB3460, 36963312370960808, 231648071, 231648074, 3, 640x360 
0x12CB3460, 36963312371281344, 231648101, 231648105, 4, 640x360 
0x12CB3460, 36963312371602200, 231648141, 231648143, 2, 640x360 
0x12CB3460, 36963312372080768, 231648182, 231648185, 3, 640x360 
0x12CB3460, 36963312372403568, 231648221, 231648224, 3, 640x360 
0x12CB3460, 36963312372720784, 231648250, 231648253, 3, 640x360 
0x12CB3460, 36963312373041472, 231648280, 231648283, 3, 640x360 
0x12CB3460, 36963312373362728, 231648311, 231648314, 3, 640x360 
0x12CB3460, 36963312373681048, 231648341, 231648346, 5, 640x360 
0x12CB3460, 36963312374001320, 231648378, 231648381, 3, 640x360 
0x12CB3460, 36963312374320672, 231648410, 231648413, 3, 640x360 
0x12CB3460, 36963312374641240, 231648441, 231648443, 2, 640x360 
0x12CB3460, 36963312374960952, 231648470, 231648473, 3, 640x360 
0x12CB3460, 36963312375283128, 231648502, 231648506, 4, 640x360 
0x12CB3460, 36963312375763176, 231648552, 231648555, 3, 640x360 
0x12CB3460, 36963312376082352, 231648582, 231648585, 3, 640x360 
0x12CB3460, 36963312376401944, 231648620, 231648623, 3, 640x360 
0x12CB3460, 36963312376720808, 231648651, 231648665, 14, 640x360 
0x12CB3460, 36963312377043072, 231648681, 231648684, 3, 640x360 
0x12CB3460, 36963312377362544, 231648711, 231648714, 3, 640x360 
0x12CB3460, 36963312377681960, 231648742, 231648745, 3, 640x360 
0x12CB3460, 36963312378001808, 231648780, 231648783, 3, 640x360 
0x12CB3460, 36963312378322088, 231648811, 231648814, 3, 640x360 
0x12CB3460, 36963312378641608, 231648841, 231648845, 4, 640x360 
0x12CB3460, 36963312378960936, 231648868, 231648873, 5, 640x360 
0x12CB3460, 36963312379283208, 231648911, 231648913, 2, 640x360 
0x12CB3460, 36963312379762648, 231648951, 231648954, 3, 640x360 
0x12CB3460, 36963312380080056, 231648981, 231648985, 4, 640x360 
0x12CB3460, 36963312380402192, 231649021, 231649024, 3, 640x360 
0x12CB3460, 36963312380721584, 231649051, 231649055, 4, 640x360 
0x12CB3460, 36963312381040824, 231649081, 231649084, 3, 640x360 
0x12CB3460, 36963312381360664, 231649110, 231649113, 3, 640x360 
0x12CB3460, 36963312381681144, 231649142, 231649146, 4, 640x360 
0x12CB3460, 36963312382001864, 231649181, 231649184, 3, 640x360 
0x12CB3460, 36963312382322496, 231649211, 231649214, 3, 640x360 
0x12CB3460, 36963312382643872, 231649240, 231649244, 4, 640x360 
0x12CB3460, 36963312382962080, 231649271, 231649274, 3, 640x360 
0x12CB3460, 36963312383281896, 231649301, 231649305, 4, 640x360 
0x12CB3460, 36963312383761056, 231649375, 231649378, 3, 640x360 
0x12CB3460, 36963312384081064, 231649381, 231649385, 4, 640x360 
0x12CB3460, 36963312384402288, 231649420, 231649423, 3, 640x360 
0x12CB3460, 36963312384722312, 231649451, 231649455, 4, 640x360 
0x12CB3460, 36963312385042912, 231649481, 231649484, 3, 640x360 
0x12CB3460, 36963312385362768, 231649512, 231649515, 3, 640x360 
0x12CB3460, 36963312385683112, 231649552, 231649556, 4, 640x360 
0x12CB3460, 36963312386004904, 231649581, 231649586, 5, 640x360 
0x12CB3460, 36963312386321192, 231649610, 231649613, 3, 640x360 
0x12CB3460, 36963312386643408, 231649642, 231649645, 3, 640x360 
0x12CB3460, 36963312386965856, 231649672, 231649676, 4, 640x360 
0x12CB3460, 36963312387443536, 231649722, 231649725, 3, 640x360 
0x12CB3460, 36963312387761408, 231649751, 231649754, 3, 640x360 
0x12CB3460, 36963312388081896, 231649791, 231649794, 3, 640x360 
0x12CB3460, 36963312388401152, 231649821, 231649824, 3, 640x360 
0x12CB3460, 36963312388721304, 231649879, 231649882, 3, 640x360 
0x12CB3460, 36963312389360640, 231649911, 231649914, 3, 640x360 
0x12CB3460, 36963312389680600, 231649941, 231649945, 4, 640x360 
0x12CB3460, 36963312390003312, 231649981, 231649984, 3, 640x360 
0x12CB3460, 36963312390322312, 231650011, 231650015, 4, 640x360 
0x12CB3460, 36963312390644984, 231650041, 231650044, 3, 640x360 
0x12CB3460, 36963312390961432, 231650071, 231650074, 3, 640x360 
0x12CB3460, 36963312391440624, 231650120, 231650122, 2, 640x360 
0x12CB3460, 36963312391761920, 231650151, 231650154, 3, 640x360 
0x12CB3460, 36963312392082208, 231650184, 231650187, 3, 640x360 
0x12CB3460, 36963312392402008, 231650221, 231650224, 3, 640x360 
0x12CB3460, 36963312392723184, 231650250, 231650253, 3, 640x360 
0x12CB3460, 36963312393041280, 231650281, 231650283, 2, 640x360 
0x12CB3460, 36963312393363520, 231650310, 231650314, 4, 640x360 
0x12CB3460, 36963312393681784, 231650341, 231650345, 4, 640x360 
0x12CB3460, 36963312394001728, 231650385, 231650388, 3, 640x360 
0x12CB3460, 36963312394320232, 231650410, 231650413, 3, 640x360 
0x12CB3460, 36963312394641240, 231650441, 231650444, 3, 640x360 
0x12CB3460, 36963312394960504, 231650470, 231650473, 3, 640x360 
0x12CB3460, 36963312395440856, 231650521, 231650523, 2, 640x360 
0x12CB3460, 36963312395760296, 231650550, 231650553, 3, 640x360 
0x12CB3460, 36963312396080736, 231650591, 231650593, 2, 640x360 
0x12CB3460, 36963312396402568, 231650621, 231650624, 3, 640x360 
0x12CB3460, 36963312396723656, 231650651, 231650654, 3, 640x360 
0x12CB3460, 36963312397045104, 231650681, 231650685, 4, 640x360 
0x12CB3460, 36963312397364424, 231650713, 231650717, 4, 640x360 
0x12CB3460, 36963312397681544, 231650741, 231650744, 3, 640x360 
0x12CB3460, 36963312398000872, 231650780, 231650783, 3, 640x360 
0x12CB3460, 36963312398321824, 231650811, 231650813, 2, 640x360 
0x12CB3460, 36963312398643200, 231650841, 231650843, 2, 640x360 
0x12CB3460, 36963312399120072, 231650891, 231650896, 5, 640x360 
0x12CB3460, 36963312399444328, 231650920, 231650923, 3, 640x360 
0x12CB3460, 36963312399760632, 231650951, 231650955, 4, 640x360 
0x12CB3460, 36963312400081608, 231650991, 231650993, 2, 640x360 
0x12CB3460, 36963312400402408, 231651021, 231651024, 3, 640x360 
0x12CB3460, 36963312400723776, 231651050, 231651053, 3, 640x360 
0x12CB3460, 36963312401041240, 231651081, 231651084, 3, 640x360 
0x12CB3460, 36963312401361392, 231651111, 231651115, 4, 640x360 
0x12CB3460, 36963312401680088, 231651141, 231651145, 4, 640x360 
0x12CB3460, 36963312402000656, 231651181, 231651183, 2, 640x360 
0x12CB3460, 36963312402320888, 231651211, 231651214, 3, 640x360 
0x12CB3460, 36963312402640544, 231651241, 231651246, 5, 640x360 
0x12CB3460, 36963312403121776, 231651290, 231651293, 3, 640x360 
0x12CB3460, 36963312403440848, 231651321, 231651324, 3, 640x360 
0x12CB3460, 36963312403761688, 231651372, 231651375, 3, 640x360 
0x12CB3460, 36963312404081296, 231651382, 231651385, 3, 640x360 
0x12CB3460, 36963312404402080, 231651421, 231651424, 3, 640x360 
0x12CB3460, 36963312404721536, 231651451, 231651454, 3, 640x360 
0x12CB3460, 36963312405040960, 231651481, 231651484, 3, 640x360 
0x12CB3460, 36963312405361304, 231651511, 231651514, 3, 640x360 
0x12CB3460, 36963312405682488, 231651542, 231651546, 4, 640x360 
0x12CB3460, 36963312406000616, 231651580, 231651583, 3, 640x360 
0x12CB3460, 36963312406321728, 231651611, 231651614, 3, 640x360 
0x12CB3460, 36963312406642992, 231651640, 231651643, 3, 640x360 
0x12CB3460, 36963312407123104, 231651692, 231651695, 3, 640x360 
0x12CB3460, 36963312407441400, 231651721, 231651724, 3, 640x360 
0x12CB3460, 36963312407761192, 231651751, 231651754, 3, 640x360 
0x12CB3460, 36963312408081808, 231651791, 231651793, 2, 640x360 
0x12CB3460, 36963312408401136, 231651820, 231651823, 3, 640x360 
0x12CB3460, 36963312408721768, 231651851, 231651866, 15, 640x360 
0x12CB3460, 36963312409040136, 231651892, 231651895, 3, 640x360 
0x12CB3460, 36963312409361336, 231651911, 231651914, 3, 640x360 
0x12CB3460, 36963312409680952, 231651942, 231651945, 3, 640x360 
0x12CB3460, 36963312410001960, 231651981, 231651983, 2, 640x360 
0x12CB3460, 36963312410321640, 231652011, 231652013, 2, 640x360 
0x12CB3460, 36963312410802920, 231652062, 231652066, 4, 640x360 
0x12CB3460, 36963312411119968, 231652090, 231652093, 3, 640x360 
0x12CB3460, 36963312411441760, 231652120, 231652122, 2, 640x360 
0x12CB3460, 36963312411760392, 231652151, 231652153, 2, 640x360 
0x12CB3460, 36963312412082408, 231652191, 231652209, 18, 640x360 
0x12CB3460, 36963312412401856, 231652220, 231652223, 3, 640x360 
0x12CB3460, 36963312412720960, 231652250, 231652252, 2, 640x360 
0x12CB3460, 36963312413040976, 231652280, 231652283, 3, 640x360 
0x12CB3460, 36963312413360504, 231652310, 231652314, 4, 640x360 
0x12CB3460, 36963312413682216, 231652342, 231652346, 4, 640x360 
0x12CB3460, 36963312414001768, 231652382, 231652384, 2, 640x360 
0x12CB3460, 36963312414321192, 231652411, 231652414, 3, 640x360 
0x12CB3460, 36963312414801624, 231652461, 231652463, 2, 640x360 
0x12CB3460, 36963312415120136, 231652490, 231652493, 3, 640x360 
0x12CB3460, 36963312415440792, 231652521, 231652524, 3, 640x360 
0x12CB3460, 36963312415762152, 231652551, 231652554, 3, 640x360 
0x12CB3460, 36963312416081560, 231652591, 231652594, 3, 640x360 
0x12CB3460, 36963312416400704, 231652620, 231652623, 3, 640x360 
0x12CB3460, 36963312416720656, 231652650, 231652653, 3, 640x360 
0x12CB3460, 36963312417041720, 231652680, 231652683, 3, 640x360 
0x12CB3460, 36963312417360944, 231652711, 231652714, 3, 640x360 
0x12CB3460, 36963312417682168, 231652742, 231652746, 4, 640x360 
0x12CB3460, 36963312418001008, 231652780, 231652790, 10, 640x360 
0x12CB3460, 36963312418482712, 231652831, 231652836, 5, 640x360 
0x12CB3460, 36963312418801024, 231652874, 231652878, 4, 640x360 
0x12CB3460, 36963312419119776, 231652890, 231652893, 3, 640x360 
0x12CB3460, 36963312419441672, 231652921, 231652939, 18, 640x360 
0x12CB3460, 36963312419763512, 231652950, 231652953, 3, 640x360 
0x12CB3460, 36963312420082832, 231652981, 231652985, 4, 640x360 
0x12CB3460, 36963312420401848, 231653020, 231653023, 3, 640x360 
0x12CB3460, 36963312420722192, 231653050, 231653053, 3, 640x360 
0x12CB3460, 36963312421045736, 231653080, 231653082, 2, 640x360 
0x12CB3460, 36963312421360168, 231653111, 231653114, 3, 640x360 
0x12CB3460, 36963312421680672, 231653151, 231653154, 3, 640x360 
0x12CB3460, 36963312422001416, 231653180, 231653183, 3, 640x360 
0x12CB3460, 36963312422481936, 231653224, 231653239, 15, 640x360 
0x12CB3460, 36963312422799888, 231653261, 231653263, 2, 640x360 
0x12CB3460, 36963312423120232, 231653291, 231653294, 3, 640x360 
0x12CB3460, 36963312423441952, 231653320, 231653323, 3, 640x360 
0x12CB3460, 36963312423760240, 231653375, 231653378, 3, 640x360 
0x12CB3460, 36963312424081112, 231653381, 231653385, 4, 640x360 
0x12CB3460, 36963312424400256, 231653420, 231653423, 3, 640x360 
0x12CB3460, 36963312424720400, 231653451, 231653455, 4, 640x360 
0x12CB3460, 36963312425040208, 231653481, 231653490, 9, 640x360 
0x12CB3460, 36963312425361008, 231653510, 231653513, 3, 640x360 
0x12CB3460, 36963312425681280, 231653551, 231653555, 4, 640x360 
0x12CB3460, 36963312426002832, 231653581, 231653586, 5, 640x360 
0x12CB3460, 36963312426481488, 231653621, 231653625, 4, 640x360 
0x12CB3460, 36963312426801760, 231653661, 231653663, 2, 640x360 
0x12CB3460, 36963312427120760, 231653691, 231653694, 3, 640x360 
0x12CB3460, 36963312427442024, 231653722, 231653725, 3, 640x360 
0x12CB3460, 36963312427761960, 231653751, 231653754, 3, 640x360 
0x12CB3460, 36963312428081576, 231653791, 231653794, 3, 640x360 
0x12CB3460, 36963312428400808, 231653821, 231653836, 15, 640x360 
0x12CB3460, 36963312428722344, 231653873, 231653876, 3, 640x360 
0x12CB3460, 36963312429041888, 231653881, 231653884, 3, 640x360 
0x12CB3460, 36963312429360176, 231653911, 231653913, 2, 640x360 
0x12CB3460, 36963312429680960, 231653941, 231653945, 4, 640x360 
0x12CB3460, 36963312430160024, 231653990, 231653994, 4, 640x360 
0x12CB3460, 36963312430480984, 231654021, 231654025, 4, 640x360 
0x12CB3460, 36963312430800560, 231654061, 231654064, 3, 640x360 
0x12CB3460, 36963312431121504, 231654090, 231654095, 5, 640x360 
0x12CB3460, 36963312431442856, 231654121, 231654124, 3, 640x360 
0x12CB3460, 36963312431761448, 231654151, 231654153, 2, 640x360 
0x12CB3460, 36963312432081152, 231654183, 231654187, 4, 640x360 
0x12CB3460, 36963312432400480, 231654221, 231654224, 3, 640x360 
0x12CB3460, 36963312432721064, 231654251, 231654256, 5, 640x360 
0x12CB3460, 36963312433040200, 231654280, 231654283, 3, 640x360 
0x12CB3460, 36963312433360128, 231654311, 231654314, 3, 640x360 
0x12CB3460, 36963312433681040, 231654376, 231654379, 3, 640x360 
0x12CB3460, 36963312434159624, 231654392, 231654394, 2, 640x360 
0x12CB3460, 36963312434479968, 231654431, 231654433, 2, 640x360 
0x12CB3460, 36963312434800456, 231654460, 231654462, 2, 640x360 
0x12CB3460, 36963312435122176, 231654491, 231654494, 3, 640x360 
0x12CB3460, 36963312435442336, 231654521, 231654523, 2, 640x360 
0x12CB3460, 36963312435763264, 231654551, 231654554, 3, 640x360 
0x12CB3460, 36963312436082416, 231654585, 231654588, 3, 640x360 
0x12CB3460, 36963312436400880, 231654621, 231654623, 2, 640x360 
0x12CB3460, 36963312436722176, 231654650, 231654653, 3, 640x360 
0x12CB3460, 36963312437041776, 231654681, 231654684, 3, 640x360 
0x12CB3460, 36963312437360344, 231654711, 231654714, 3, 640x360 
0x12CB3460, 36963312437680408, 231654742, 231654745, 3, 640x360 
0x12CB3460, 36963312438160272, 231654791, 231654794, 3, 640x360 
0x12CB3460, 36963312438481608, 231654831, 231654834, 3, 640x360 
0x12CB3460, 36963312438801456, 231654874, 231654877, 3, 640x360 
0x12CB3460, 36963312439120784, 231654891, 231654893, 2, 640x360 
0x12CB3460, 36963312439442008, 231654921, 231654923, 2, 640x360 
0x12CB3460, 36963312439760024, 231654951, 231654954, 3, 640x360 
0x12CB3460, 36963312440081488, 231654991, 231654994, 3, 640x360 
0x12CB3460, 36963312440400032, 231655021, 231655024, 3, 640x360 
0x12CB3460, 36963312440721688, 231655051, 231655053, 2, 640x360 
0x12CB3460, 36963312441041896, 231655081, 231655085, 4, 640x360 
0x12CB3460, 36963312441360200, 231655111, 231655114, 3, 640x360 
0x12CB3460, 36963312441840256, 231655161, 231655164, 3, 640x360 
0x12CB3460, 36963312442163344, 231655191, 231655195, 4, 640x360 
0x12CB3460, 36963312442482536, 231655222, 231655226, 4, 640x360 
0x12CB3460, 36963312442800000, 231655261, 231655265, 4, 640x360 
0x12CB3460, 36963312443121512, 231655291, 231655293, 2, 640x360 
0x12CB3460, 36963312443442312, 231655321, 231655324, 3, 640x360 
0x12CB3460, 36963312443762248, 231655384, 231655387, 3, 640x360 
0x12CB3460, 36963312444404928, 231655420, 231655423, 3, 640x360 
0x12CB3460, 36963312444720296, 231655451, 231655454, 3, 640x360 
0x12CB3460, 36963312445041464, 231655480, 231655483, 3, 640x360 
0x12CB3460, 36963312445361664, 231655511, 231655514, 3, 640x360 
0x12CB3460, 36963312445843432, 231655560, 231655563, 3, 640x360 
0x12CB3460, 36963312446161032, 231655590, 231655595, 5, 640x360 
0x12CB3460, 36963312446481912, 231655630, 231655632, 2, 640x360 
0x12CB3460, 36963312446803112, 231655661, 231655664, 3, 640x360 
0x12CB3460, 36963312447123920, 231655692, 231655695, 3, 640x360 
0x12CB3460, 36963312447441312, 231655721, 231655723, 2, 640x360 
0x12CB3460, 36963312447762000, 231655751, 231655756, 5, 640x360 
0x12CB3460, 36963312448080968, 231655791, 231655793, 2, 640x360 
0x12CB3460, 36963312448400880, 231655820, 231655823, 3, 640x360 
0x12CB3460, 36963312448722976, 231655873, 231655880, 7, 640x360 
0x12CB3460, 36963312449042384, 231655881, 231655884, 3, 640x360 
0x12CB3460, 36963312449521352, 231655931, 231655933, 2, 640x360 
0x12CB3460, 36963312449842384, 231655961, 231655963, 2, 640x360 
0x12CB3460, 36963312450162728, 231655990, 231655994, 4, 640x360 
0x12CB3460, 36963312450483912, 231656031, 231656034, 3, 640x360 
0x12CB3460, 36963312450804112, 231656060, 231656063, 3, 640x360 
0x12CB3460, 36963312451121224, 231656091, 231656096, 5, 640x360 
0x12CB3460, 36963312451441976, 231656120, 231656123, 3, 640x360 
0x12CB3460, 36963312451761744, 231656151, 231656154, 3, 640x360 
0x12CB3460, 36963312452081872, 231656192, 231656195, 3, 640x360 
0x12CB3460, 36963312452402176, 231656222, 231656225, 3, 640x360 
0x12CB3460, 36963312452719856, 231656251, 231656254, 3, 640x360 
0x12CB3460, 36963312453042392, 231656281, 231656286, 5, 640x360 
0x12CB3460, 36963312453521560, 231656330, 231656332, 2, 640x360 
0x12CB3460, 36963312453841432, 231656381, 231656383, 2, 640x360 
0x12CB3460, 36963312454159696, 231656392, 231656395, 3, 640x360 
0x12CB3460, 36963312454482120, 231656421, 231656426, 5, 640x360 
0x12CB3460, 36963312454801456, 231656460, 231656463, 3, 640x360 
0x12CB3460, 36963312455121184, 231656491, 231656493, 2, 640x360 
0x12CB3460, 36963312455440728, 231656521, 231656523, 2, 640x360 
0x12CB3460, 36963312455761264, 231656551, 231656554, 3, 640x360 
0x12CB3460, 36963312456080656, 231656581, 231656585, 4, 640x360 
0x12CB3460, 36963312456401304, 231656620, 231656623, 3, 640x360 
0x12CB3460, 36963312456720336, 231656651, 231656654, 3, 640x360 
0x12CB3460, 36963312457042232, 231656680, 231656683, 3, 640x360 
0x12CB3460, 36963312457522632, 231656732, 231656735, 3, 640x360 
0x12CB3460, 36963312457840784, 231656761, 231656763, 2, 640x360 
0x12CB3460, 36963312458159832, 231656792, 231656795, 3, 640x360 
0x12CB3460, 36963312458481344, 231656830, 231656832, 2, 640x360 
0x12CB3460, 36963312458801696, 231656878, 231656882, 4, 640x360 
0x12CB3460, 36963312459120960, 231656890, 231656893, 3, 640x360 
0x12CB3460, 36963312459441816, 231656921, 231656924, 3, 640x360 
0x12CB3460, 36963312459760080, 231656950, 231656954, 4, 640x360 
0x12CB3460, 36963312460081176, 231656981, 231656984, 3, 640x360 
0x12CB3460, 36963312460401752, 231657021, 231657024, 3, 640x360 
0x12CB3460, 36963312460722104, 231657051, 231657054, 3, 640x360 
0x12CB3460, 36963312461201184, 231657101, 231657104, 3, 640x360 
0x12CB3460, 36963312461520528, 231657130, 231657133, 3, 640x360 
0x12CB3460, 36963312461841120, 231657160, 231657163, 3, 640x360 
0x12CB3460, 36963312462160744, 231657190, 231657193, 3, 640x360 
0x12CB3460, 36963312462481576, 231657221, 231657224, 3, 640x360 
0x12CB3460, 36963312462800960, 231657261, 231657264, 3, 640x360 
0x12CB3460, 36963312463122880, 231657291, 231657293, 2, 640x360 
0x12CB3460, 36963312463442880, 231657321, 231657324, 3, 640x360 
0x12CB3460, 36963312463760072, 231657352, 231657355, 3, 640x360 
0x12CB3460, 36963312464079880, 231657382, 231657385, 3, 640x360 
0x12CB3460, 36963312464401480, 231657421, 231657439, 18, 640x360 
0x12CB3460, 36963312464720784, 231657450, 231657457, 7, 640x360 
0x12CB3460, 36963312465200368, 231657500, 231657503, 3, 640x360 
0x12CB3460, 36963312465523896, 231657531, 231657534, 3, 640x360 
0x12CB3460, 36963312465845080, 231657561, 231657565, 4, 640x360 
0x12CB3460, 36963312466162464, 231657591, 231657594, 3, 640x360 
0x12CB3460, 36963312466480736, 231657621, 231657625, 4, 640x360 
0x12CB3460, 36963312466801624, 231657661, 231657663, 2, 640x360 
0x12CB3460, 36963312467122000, 231657691, 231657694, 3, 640x360 
0x12CB3460, 36963312467440312, 231657721, 231657724, 3, 640x360 
0x12CB3460, 36963312467760416, 231657751, 231657754, 3, 640x360 
0x12CB3460, 36963312468080272, 231657781, 231657785, 4, 640x360 
0x12CB3460, 36963312468402664, 231657821, 231657836, 15, 640x360 
0x12CB3460, 36963312468723280, 231657851, 231657854, 3, 640x360 
0x12CB3460, 36963312469199632, 231657900, 231657903, 3, 640x360 
0x12CB3460, 36963312469521304, 231657930, 231657933, 3, 640x360 
0x12CB3460, 36963312469839920, 231657961, 231657964, 3, 640x360 
0x12CB3460, 36963312470160352, 231657990, 231657994, 4, 640x360 
0x12CB3460, 36963312470482968, 231658032, 231658035, 3, 640x360 
0x12CB3460, 36963312470801608, 231658061, 231658064, 3, 640x360 
0x12CB3460, 36963312471120368, 231658090, 231658096, 6, 640x360 
0x12CB3460, 36963312471440152, 231658121, 231658123, 2, 640x360 
0x12CB3460, 36963312471760248, 231658150, 231658153, 3, 640x360 
0x12CB3460, 36963312472082040, 231658182, 231658185, 3, 640x360 
0x12CB3460, 36963312472402320, 231658220, 231658223, 3, 640x360 
0x12CB3460, 36963312472880784, 231658271, 231658273, 2, 640x360 
0x12CB3460, 36963312473199608, 231658301, 231658304, 3, 640x360 
0x12CB3460, 36963312473520104, 231658331, 231658334, 3, 640x360 
0x12CB3460, 36963312473843480, 231658374, 231658377, 3, 640x360 
0x12CB3460, 36963312474161000, 231658391, 231658394, 3, 640x360 
0x12CB3460, 36963312474481296, 231658431, 231658434, 3, 640x360 
0x12CB3460, 36963312474801224, 231658460, 231658463, 3, 640x360 
0x12CB3460, 36963312475119648, 231658491, 231658494, 3, 640x360 
0x12CB3460, 36963312475441288, 231658521, 231658525, 4, 640x360 
0x12CB3460, 36963312475761080, 231658551, 231658554, 3, 640x360 
0x12CB3460, 36963312476080704, 231658591, 231658594, 3, 640x360 
0x12CB3460, 36963312476401368, 231658615, 231658619, 4, 640x360 
0x12CB3460, 36963312476881448, 231658670, 231658673, 3, 640x360 
0x12CB3460, 36963312477201520, 231658701, 231658705, 4, 640x360 
0x12CB3460, 36963312477521616, 231658731, 231658734, 3, 640x360 
0x12CB3460, 36963312477839904, 231658761, 231658764, 3, 640x360 
0x12CB3460, 36963312478161784, 231658790, 231658794, 4, 640x360 
0x12CB3460, 36963312478481448, 231658821, 231658824, 3, 640x360 
0x12CB3460, 36963312478802520, 231658881, 231658884, 3, 640x360 
0x12CB3460, 36963312479121328, 231658891, 231658894, 3, 640x360 
0x12CB3460, 36963312479440888, 231658920, 231658923, 3, 640x360 
0x12CB3460, 36963312479761944, 231658951, 231658954, 3, 640x360 
0x12CB3460, 36963312480079816, 231658981, 231658985, 4, 640x360 
0x12CB3460, 36963312480401328, 231659021, 231659024, 3, 640x360 
0x12CB3460, 36963312480880376, 231659061, 231659065, 4, 640x360 
0x12CB3460, 36963312481201672, 231659101, 231659104, 3, 640x360 
0x12CB3460, 36963312481521808, 231659130, 231659133, 3, 640x360 
0x12CB3460, 36963312481840840, 231659161, 231659163, 2, 640x360 
0x12CB3460, 36963312482160872, 231659192, 231659195, 3, 640x360 
0x12CB3460, 36963312482480168, 231659221, 231659225, 4, 640x360 
0x12CB3460, 36963312482799872, 231659260, 231659263, 3, 640x360 
0x12CB3460, 36963312483120936, 231659291, 231659293, 2, 640x360 
0x12CB3460, 36963312483442096, 231659321, 231659323, 2, 640x360 
0x12CB3460, 36963312483760272, 231659350, 231659353, 3, 640x360 
0x12CB3460, 36963312484080592, 231659381, 231659386, 5, 640x360 
0x12CB3460, 36963312484559440, 231659430, 231659433, 3, 640x360 
0x12CB3460, 36963312484880112, 231659462, 231659466, 4, 640x360 
0x12CB3460, 36963312485200600, 231659501, 231659504, 3, 640x360 
0x12CB3460, 36963312485523024, 231659531, 231659534, 3, 640x360 
0x12CB3460, 36963312485844744, 231659561, 231659564, 3, 640x360 
0x12CB3460, 36963312486162952, 231659591, 231659595, 4, 640x360 
0x12CB3460, 36963312486480360, 231659621, 231659626, 5, 640x360 
0x12CB3460, 36963312486800808, 231659661, 231659664, 3, 640x360 
0x12CB3460, 36963312487121456, 231659691, 231659694, 3, 640x360 
0x12CB3460, 36963312487441328, 231659721, 231659739, 18, 640x360 
0x12CB3460, 36963312487760856, 231659751, 231659754, 3, 640x360 
0x12CB3460, 36963312488080408, 231659781, 231659785, 4, 640x360 
0x12CB3460, 36963312488560432, 231659830, 231659834, 4, 640x360 
0x12CB3460, 36963312488881080, 231659878, 231659881, 3, 640x360 
0x12CB3460, 36963312489199552, 231659900, 231659903, 3, 640x360 
0x12CB3460, 36963312489521168, 231659931, 231659934, 3, 640x360 
0x12CB3460, 36963312489842152, 231659960, 231659963, 3, 640x360 
0x12CB3460, 36963312490161552, 231659990, 231659994, 4, 640x360 
0x12CB3460, 36963312490481912, 231660030, 231660033, 3, 640x360 
0x12CB3460, 36963312490801816, 231660061, 231660064, 3, 640x360 
0x12CB3460, 36963312491119576, 231660090, 231660093, 3, 640x360 
0x12CB3460, 36963312491441320, 231660121, 231660124, 3, 640x360 
0x12CB3460, 36963312491761424, 231660150, 231660153, 3, 640x360 
0x12CB3460, 36963312492242624, 231660201, 231660205, 4, 640x360 
0x12CB3460, 36963312492561768, 231660231, 231660234, 3, 640x360 
0x12CB3460, 36963312492881216, 231660271, 231660274, 3, 640x360 
0x12CB3460, 36963312493202024, 231660301, 231660304, 3, 640x360 
0x12CB3460, 36963312493522480, 231660330, 231660333, 3, 640x360 
0x12CB3460, 36963312493842400, 231660372, 231660375, 3, 640x360 
0x12CB3460, 36963312494160616, 231660391, 231660394, 3, 640x360 
0x12CB3460, 36963312494481992, 231660430, 231660433, 3, 640x360 
0x12CB3460, 36963312494800096, 231660460, 231660463, 3, 640x360 
0x12CB3460, 36963312495121296, 231660491, 231660494, 3, 640x360 
0x12CB3460, 36963312495442368, 231660521, 231660523, 2, 640x360 
0x12CB3460, 36963312495762880, 231660551, 231660554, 3, 640x360 
0x12CB3460, 36963312496245256, 231660603, 231660606, 3, 640x360 
0x12CB3460, 36963312496563728, 231660631, 231660635, 4, 640x360 
0x12CB3460, 36963312496880008, 231660662, 231660666, 4, 640x360 
0x12CB3460, 36963312497201832, 231660701, 231660704, 3, 640x360 
0x12CB3460, 36963312497521384, 231660730, 231660733, 3, 640x360 
0x12CB3460, 36963312497841920, 231660761, 231660764, 3, 640x360 
0x12CB3460, 36963312498161208, 231660790, 231660794, 4, 640x360 
0x12CB3460, 36963312498481432, 231660830, 231660833, 3, 640x360 
0x12CB3460, 36963312498802464, 231660868, 231660871, 3, 640x360 
0x12CB3460, 36963312499120216, 231660891, 231660894, 3, 640x360 
0x12CB3460, 36963312499442720, 231660920, 231660923, 3, 640x360 
0x12CB3460, 36963312499760728, 231660950, 231660953, 3, 640x360 
0x12CB3460, 36963312500240280, 231661000, 231661003, 3, 640x360 
0x12CB3460, 36963312500562600, 231661031, 231661034, 3, 640x360 
0x12CB3460, 36963312500881424, 231661061, 231661065, 4, 640x360 
0x12CB3460, 36963312501201560, 231661100, 231661106, 6, 640x360 
0x12CB3460, 36963312501521712, 231661131, 231661134, 3, 640x360 
0x12CB3460, 36963312501841936, 231661160, 231661163, 3, 640x360 
0x12CB3460, 36963312502160408, 231661191, 231661194, 3, 640x360 
0x12CB3460, 36963312502481560, 231661221, 231661224, 3, 640x360 
0x12CB3460, 36963312502800088, 231661260, 231661263, 3, 640x360 
0x12CB3460, 36963312503120808, 231661290, 231661293, 3, 640x360 
0x12CB3460, 36963312503442704, 231661321, 231661324, 3, 640x360 
0x12CB3460, 36963312503921400, 231661381, 231661385, 4, 640x360 
0x12CB3460, 36963312504240456, 231661401, 231661403, 2, 640x360 
0x12CB3460, 36963312504560960, 231661430, 231661433, 3, 640x360 
0x12CB3460, 36963312504881160, 231661462, 231661465, 3, 640x360 
0x12CB3460, 36963312505203712, 231661502, 231661504, 2, 640x360 
0x12CB3460, 36963312505522424, 231661531, 231661534, 3, 640x360 
0x12CB3460, 36963312505843512, 231661561, 231661564, 3, 640x360 
0x12CB3460, 36963312506161328, 231661592, 231661595, 3, 640x360 
0x12CB3460, 36963312506479752, 231661631, 231661633, 2, 640x360 
0x12CB3460, 36963312506800696, 231661660, 231661663, 3, 640x360 
0x12CB3460, 36963312507122344, 231661691, 231661694, 3, 640x360 
0x12CB3460, 36963312507450976, 231661721, 231661725, 4, 640x360 
0x12CB3460, 36963312507920976, 231661770, 231661773, 3, 640x360 
0x12CB3460, 36963312508240480, 231661801, 231661803, 2, 640x360 
0x12CB3460, 36963312508561056, 231661830, 231661833, 3, 640x360 
0x12CB3460, 36963312508882848, 231661884, 231661888, 4, 640x360 
0x12CB3460, 36963312509201208, 231661901, 231661904, 3, 640x360 
0x12CB3460, 36963312509520768, 231661930, 231661933, 3, 640x360 
0x12CB3460, 36963312509841376, 231661961, 231661963, 2, 640x360 
0x12CB3460, 36963312510161536, 231661990, 231661994, 4, 640x360 
0x12CB3460, 36963312510482744, 231662022, 231662026, 4, 640x360 
0x12CB3460, 36963312510802240, 231662060, 231662063, 3, 640x360 
0x12CB3460, 36963312511123336, 231662091, 231662093, 2, 640x360 
0x12CB3460, 36963312511441168, 231662120, 231662123, 3, 640x360 
0x12CB3460, 36963312511921872, 231662171, 231662174, 3, 640x360 
0x12CB3460, 36963312512241136, 231662200, 231662203, 3, 640x360 
0x12CB3460, 36963312512560184, 231662231, 231662234, 3, 640x360 
0x12CB3460, 36963312512880584, 231662271, 231662274, 3, 640x360 
0x12CB3460, 36963312513201032, 231662300, 231662303, 3, 640x360 
0x12CB3460, 36963312513521144, 231662331, 231662333, 2, 640x360 
0x12CB3460, 36963312513842208, 231662381, 231662384, 3, 640x360 
0x12CB3460, 36963312514160664, 231662392, 231662395, 3, 640x360 
0x12CB3460, 36963312514480280, 231662421, 231662425, 4, 640x360 
0x12CB3460, 36963312514800352, 231662460, 231662463, 3, 640x360 
0x12CB3460, 36963312515120120, 231662490, 231662493, 3, 640x360 
0x12CB3460, 36963312515602168, 231662541, 231662544, 3, 640x360 
0x12CB3460, 36963312515923000, 231662571, 231662575, 4, 640x360 
0x12CB3460, 36963312516240968, 231662601, 231662604, 3, 640x360 
0x12CB3460, 36963312516562184, 231662631, 231662634, 3, 640x360 
0x12CB3460, 36963312516882680, 231662672, 231662675, 3, 640x360 
0x12CB3460, 36963312517201632, 231662701, 231662703, 2, 640x360 
0x12CB3460, 36963312517520552, 231662730, 231662733, 3, 640x360 
0x12CB3460, 36963312517840544, 231662761, 231662763, 2, 640x360 
0x12CB3460, 36963312518160096, 231662792, 231662795, 3, 640x360 
0x12CB3460, 36963312518479800, 231662820, 231662823, 3, 640x360 
0x12CB3460, 36963312518801768, 231662881, 231662884, 3, 640x360 
0x12CB3460, 36963312519120360, 231662891, 231662895, 4, 640x360 
0x12CB3460, 36963312519600784, 231662940, 231662958, 18, 640x360 
0x12CB3460, 36963312519919760, 231662970, 231662974, 4, 640x360 
0x12CB3460, 36963312520240944, 231663000, 231663003, 3, 640x360 
0x12CB3460, 36963312520559808, 231663031, 231663034, 3, 640x360 
0x12CB3460, 36963312520880320, 231663061, 231663065, 4, 640x360 
0x12CB3460, 36963312521202792, 231663100, 231663103, 3, 640x360 
0x12CB3460, 36963312521519528, 231663131, 231663134, 3, 640x360 
0x12CB3460, 36963312521840032, 231663160, 231663162, 2, 640x360 
0x12CB3460, 36963312522160832, 231663191, 231663194, 3, 640x360 
0x12CB3460, 36963312522481304, 231663222, 231663226, 4, 640x360 
0x12CB3460, 36963312522800664, 231663260, 231663263, 3, 640x360 
0x12CB3460, 36963312523121552, 231663291, 231663293, 2, 640x360 
0x12CB3460, 36963312523599696, 231663340, 231663343, 3, 640x360 
0x12CB3460, 36963312523919592, 231663373, 231663377, 4, 640x360 
0x12CB3460, 36963312524240280, 231663400, 231663403, 3, 640x360 
0x12CB3460, 36963312524560928, 231663431, 231663434, 3, 640x360 
0x12CB3460, 36963312524880320, 231663471, 231663474, 3, 640x360 
0x12CB3460, 36963312525200128, 231663501, 231663504, 3, 640x360 
0x12CB3460, 36963312525519936, 231663530, 231663533, 3, 640x360 
0x12CB3460, 36963312525840304, 231663561, 231663564, 3, 640x360 
0x12CB3460, 36963312526160992, 231663591, 231663594, 3, 640x360 
0x12CB3460, 36963312526481528, 231663621, 231663625, 4, 640x360 
0x12CB3460, 36963312526801176, 231663660, 231663662, 2, 640x360 
0x12CB3460, 36963312527281792, 231663711, 231663714, 3, 640x360 
0x12CB3460, 36963312527599544, 231663741, 231663743, 2, 640x360 
0x12CB3460, 36963312527920672, 231663772, 231663777, 5, 640x360 
0x12CB3460, 36963312528240968, 231663801, 231663803, 2, 640x360 
0x12CB3460, 36963312528560440, 231663831, 231663834, 3, 640x360 
0x12CB3460, 36963312528882368, 231663882, 231663885, 3, 640x360 
0x12CB3460, 36963312529199768, 231663900, 231663903, 3, 640x360 
0x12CB3460, 36963312529519296, 231663931, 231663933, 2, 640x360 
0x12CB3460, 36963312529840952, 231663960, 231663964, 4, 640x360 
0x12CB3460, 36963312530162408, 231663991, 231663995, 4, 640x360 
0x12CB3460, 36963312530481168, 231664031, 231664034, 3, 640x360 
0x12CB3460, 36963312530801592, 231664061, 231664064, 3, 640x360 
0x12CB3460, 36963312531280256, 231664112, 231664116, 4, 640x360 
0x12CB3460, 36963312531600624, 231664140, 231664146, 6, 640x360 
0x12CB3460, 36963312531919096, 231664170, 231664173, 3, 640x360 
0x12CB3460, 36963312532241304, 231664200, 231664205, 5, 640x360 
0x12CB3460, 36963312532560840, 231664231, 231664234, 3, 640x360 
0x12CB3460, 36963312532882336, 231664262, 231664266, 4, 640x360 
0x12CB3460, 36963312533202056, 231664299, 231664302, 3, 640x360 
0x12CB3460, 36963312533520064, 231664331, 231664334, 3, 640x360 
0x12CB3460, 36963312533842936, 231664366, 231664369, 3, 640x360 
0x12CB3460, 36963312534160080, 231664392, 231664396, 4, 640x360 
0x12CB3460, 36963312534480320, 231664421, 231664425, 4, 640x360 
0x12CB3460, 36963312534958736, 231664470, 231664473, 3, 640x360 
0x12CB3460, 36963312535281016, 231664501, 231664505, 4, 640x360 
0x12CB3460, 36963312535600392, 231664541, 231664544, 3, 640x360 
0x12CB3460, 36963312535920256, 231664571, 231664575, 4, 640x360 
0x12CB3460, 36963312536239848, 231664600, 231664603, 3, 640x360 
0x12CB3460, 36963312536559648, 231664631, 231664633, 2, 640x360 
0x12CB3460, 36963312536881136, 231664671, 231664673, 2, 640x360 
0x12CB3460, 36963312537201928, 231664701, 231664704, 3, 640x360 
0x12CB3460, 36963312537523080, 231664730, 231664734, 4, 640x360 
0x12CB3460, 36963312537841200, 231664761, 231664764, 3, 640x360 
0x12CB3460, 36963312538161344, 231664790, 231664794, 4, 640x360 
0x12CB3460, 36963312538480856, 231664830, 231664833, 3, 640x360 
0x12CB3460, 36963312538960624, 231664872, 231664876, 4, 640x360 
0x12CB3460, 36963312539279312, 231664901, 231664905, 4, 640x360 
0x12CB3460, 36963312539600944, 231664941, 231664944, 3, 640x360 
0x12CB3460, 36963312539919696, 231664970, 231664973, 3, 640x360 
0x12CB3460, 36963312540240568, 231665002, 231665005, 3, 640x360 
0x12CB3460, 36963312540559840, 231665032, 231665035, 3, 640x360 
0x12CB3460, 36963312540880824, 231665061, 231665064, 3, 640x360 
0x12CB3460, 36963312541199664, 231665100, 231665103, 3, 640x360 
0x12CB3460, 36963312541520520, 231665131, 231665133, 2, 640x360 
0x12CB3460, 36963312541841320, 231665160, 231665163, 3, 640x360 
0x12CB3460, 36963312542161976, 231665191, 231665195, 4, 640x360 
0x12CB3460, 36963312542481360, 231665222, 231665226, 4, 640x360 
0x12CB3460, 36963312542959152, 231665271, 231665274, 3, 640x360 
0x12CB3460, 36963312543281968, 231665311, 231665314, 3, 640x360 
0x12CB3460, 36963312543600888, 231665341, 231665344, 3, 640x360 
0x12CB3460, 36963312543920648, 231665384, 231665387, 3, 640x360 
0x12CB3460, 36963312544239168, 231665401, 231665403, 2, 640x360 
0x12CB3460, 36963312544560808, 231665430, 231665441, 11, 640x360 
0x12CB3460, 36963312544880280, 231665462, 231665466, 4, 640x360 
0x12CB3460, 36963312545203256, 231665501, 231665504, 3, 640x360 
0x12CB3460, 36963312545522016, 231665530, 231665534, 4, 640x360 
0x12CB3460, 36963312545841384, 231665561, 231665564, 3, 640x360 
0x12CB3460, 36963312546160632, 231665591, 231665594, 3, 640x360 
0x12CB3460, 36963312546640248, 231665640, 231665643, 3, 640x360 
0x12CB3460, 36963312546960336, 231665671, 231665673, 2, 640x360 
0x12CB3460, 36963312547281192, 231665710, 231665714, 4, 640x360 
0x12CB3460, 36963312547602488, 231665734, 231665738, 4, 640x360 
0x12CB3460, 36963312547920752, 231665771, 231665774, 3, 640x360 
0x12CB3460, 36963312548241224, 231665800, 231665803, 3, 640x360 
0x12CB3460, 36963312548562232, 231665831, 231665834, 3, 640x360 
0x12CB3460, 36963312548884080, 231665873, 231665877, 4, 640x360 
0x12CB3460, 36963312549199600, 231665901, 231665903, 2, 640x360 
0x12CB3460, 36963312549519920, 231665930, 231665932, 2, 640x360 
0x12CB3460, 36963312549841408, 231665960, 231665963, 3, 640x360 
0x12CB3460, 36963312550160368, 231665990, 231665993, 3, 640x360 
0x12CB3460, 36963312550642600, 231666041, 231666045, 4, 640x360 
0x12CB3460, 36963312550959656, 231666071, 231666075, 4, 640x360 
0x12CB3460, 36963312551279416, 231666101, 231666104, 3, 640x360 
0x12CB3460, 36963312551599520, 231666140, 231666143, 3, 640x360 
0x12CB3460, 36963312551919776, 231666171, 231666189, 18, 640x360 
0x12CB3460, 36963312552240488, 231666200, 231666204, 4, 640x360 
0x12CB3460, 36963312552559528, 231666232, 231666235, 3, 640x360 
0x12CB3460, 36963312552879816, 231666261, 231666265, 4, 640x360 
0x12CB3460, 36963312553200968, 231666301, 231666303, 2, 640x360 
0x12CB3460, 36963312553519096, 231666330, 231666333, 3, 640x360 
0x12CB3460, 36963312553841408, 231666367, 231666371, 4, 640x360 
0x12CB3460, 36963312554161728, 231666390, 231666394, 4, 640x360 
0x12CB3460, 36963312554641488, 231666441, 231666444, 3, 640x360 
0x12CB3460, 36963312554958904, 231666471, 231666474, 3, 640x360 
0x12CB3460, 36963312555280824, 231666501, 231666505, 4, 640x360 
0x12CB3460, 36963312555600184, 231666541, 231666543, 2, 640x360 
0x12CB3460, 36963312555921160, 231666571, 231666574, 3, 640x360 
0x12CB3460, 36963312556242208, 231666601, 231666604, 3, 640x360 
0x12CB3460, 36963312556560264, 231666631, 231666634, 3, 640x360 
0x12CB3460, 36963312556881000, 231666671, 231666674, 3, 640x360 
0x12CB3460, 36963312557201408, 231666701, 231666703, 2, 640x360 
0x12CB3460, 36963312557520752, 231666731, 231666734, 3, 640x360 
0x12CB3460, 36963312557840504, 231666760, 231666762, 2, 640x360 
0x12CB3460, 36963312558320400, 231666811, 231666813, 2, 640x360 
0x12CB3460, 36963312558640152, 231666840, 231666843, 3, 640x360 
0x12CB3460, 36963312558960504, 231666880, 231666884, 4, 640x360 
0x12CB3460, 36963312559279960, 231666901, 231666905, 4, 640x360 
0x12CB3460, 36963312559599624, 231666941, 231666944, 3, 640x360 
0x12CB3460, 36963312559920272, 231666970, 231666973, 3, 640x360 
0x12CB3460, 36963312560241384, 231667001, 231667004, 3, 640x360 
0x12CB3460, 36963312560559784, 231667031, 231667034, 3, 640x360 
0x12CB3460, 36963312560880856, 231667071, 231667074, 3, 640x360 
0x12CB3460, 36963312561200952, 231667100, 231667103, 3, 640x360 
0x12CB3460, 36963312561521128, 231667131, 231667133, 2, 640x360 
0x12CB3460, 36963312561840848, 231667160, 231667163, 3, 640x360 
0x12CB3460, 36963312562320160, 231667210, 231667214, 4, 640x360 
0x12CB3460, 36963312562641904, 231667241, 231667244, 3, 640x360 
0x12CB3460, 36963312562959272, 231667271, 231667274, 3, 640x360 
0x12CB3460, 36963312563281176, 231667302, 231667306, 4, 640x360 
0x12CB3460, 36963312563599472, 231667340, 231667343, 3, 640x360 
0x12CB3460, 36963312563921712, 231667374, 231667377, 3, 640x360 
0x12CB3460, 36963312564239104, 231667401, 231667404, 3, 640x360 
0x12CB3460, 36963312564560440, 231667431, 231667434, 3, 640x360 
0x12CB3460, 36963312564880304, 231667462, 231667466, 4, 640x360 
0x12CB3460, 36963312565201424, 231667501, 231667503, 2, 640x360 
0x12CB3460, 36963312565521072, 231667530, 231667533, 3, 640x360 
0x12CB3460, 36963312565999864, 231667582, 231667586, 4, 640x360 
0x12CB3460, 36963312566320960, 231667611, 231667614, 3, 640x360 
0x12CB3460, 36963312566640256, 231667640, 231667643, 3, 640x360 
0x12CB3460, 36963312566961608, 231667672, 231667690, 18, 640x360 
0x12CB3460, 36963312567280176, 231667710, 231667713, 3, 640x360 
0x12CB3460, 36963312567601736, 231667741, 231667744, 3, 640x360 
0x12CB3460, 36963312567920552, 231667770, 231667774, 4, 640x360 
0x12CB3460, 36963312568240728, 231667801, 231667804, 3, 640x360 
0x12CB3460, 36963312568560520, 231667830, 231667834, 4, 640x360 
0x12CB3460, 36963312568880456, 231667867, 231667871, 4, 640x360 
0x12CB3460, 36963312569199408, 231667900, 231667903, 3, 640x360 
0x12CB3460, 36963312569521104, 231667931, 231667935, 4, 640x360 
0x12CB3460, 36963312570000896, 231667980, 231667982, 2, 640x360 
0x12CB3460, 36963312570320056, 231668011, 231668014, 3, 640x360 
0x12CB3460, 36963312570642416, 231668041, 231668045, 4, 640x360 
0x12CB3460, 36963312570961080, 231668072, 231668075, 3, 640x360 
0x12CB3460, 36963312571279888, 231668101, 231668105, 4, 640x360 
0x12CB3460, 36963312571599448, 231668141, 231668143, 2, 640x360 
0x12CB3460, 36963312571920736, 231668170, 231668172, 2, 640x360 
0x12CB3460, 36963312572240968, 231668202, 231668205, 3, 640x360 
0x12CB3460, 36963312572560640, 231668232, 231668235, 3, 640x360 
0x12CB3460, 36963312572879616, 231668261, 231668265, 4, 640x360 
0x12CB3460, 36963312573201648, 231668300, 231668303, 3, 640x360 
0x12CB3460, 36963312573519744, 231668331, 231668333, 2, 640x360 
0x12CB3460, 36963312573999368, 231668382, 231668385, 3, 640x360 
0x12CB3460, 36963312574320480, 231668411, 231668414, 3, 640x360 
0x12CB3460, 36963312574640680, 231668441, 231668443, 2, 640x360 
0x12CB3460, 36963312574959288, 231668471, 231668474, 3, 640x360 
0x12CB3460, 36963312575280616, 231668511, 231668513, 2, 640x360 
0x12CB3460, 36963312575601616, 231668540, 231668543, 3, 640x360 
0x12CB3460, 36963312575921304, 231668572, 231668575, 3, 640x360 
0x12CB3460, 36963312576240360, 231668601, 231668603, 2, 640x360 
0x12CB3460, 36963312576560352, 231668630, 231668633, 3, 640x360 
0x12CB3460, 36963312576881464, 231668670, 231668673, 3, 640x360 
0x12CB3460, 36963312577203216, 231668701, 231668704, 3, 640x360 
0x12CB3460, 36963312577684848, 231668750, 231668753, 3, 640x360 
0x12CB3460, 36963312578000552, 231668781, 231668784, 3, 640x360 
0x12CB3460, 36963312578320888, 231668810, 231668813, 3, 640x360 
0x12CB3460, 36963312578641072, 231668840, 231668844, 4, 640x360 
0x12CB3460, 36963312578960624, 231668891, 231668894, 3, 640x360 
0x12CB3460, 36963312579279088, 231668901, 231668904, 3, 640x360 
0x12CB3460, 36963312579600192, 231668941, 231668944, 3, 640x360 
0x12CB3460, 36963312579919216, 231668971, 231668974, 3, 640x360 
0x12CB3460, 36963312580240600, 231669001, 231669003, 2, 640x360 
0x12CB3460, 36963312580561768, 231669030, 231669034, 4, 640x360 
0x12CB3460, 36963312580879840, 231669061, 231669065, 4, 640x360 
0x12CB3460, 36963312581200552, 231669101, 231669103, 2, 640x360 
0x12CB3460, 36963312581681816, 231669151, 231669154, 3, 640x360 
0x12CB3460, 36963312582000136, 231669182, 231669185, 3, 640x360 
0x12CB3460, 36963312582323048, 231669211, 231669214, 3, 640x360 
0x12CB3460, 36963312582639432, 231669241, 231669243, 2, 640x360 
0x12CB3460, 36963312582960736, 231669271, 231669274, 3, 640x360 
0x12CB3460, 36963312583279952, 231669311, 231669314, 3, 640x360 
0x12CB3460, 36963312583602496, 231669341, 231669344, 3, 640x360 
0x12CB3460, 36963312583924456, 231669394, 231669397, 3, 640x360 
0x12CB3460, 36963312584241448, 231669401, 231669404, 3, 640x360 
0x12CB3460, 36963312584559376, 231669431, 231669434, 3, 640x360 
0x12CB3460, 36963312584879928, 231669461, 231669465, 4, 640x360 
0x12CB3460, 36963312585200816, 231669500, 231669503, 3, 640x360 
0x12CB3460, 36963312585682704, 231669550, 231669554, 4, 640x360 
0x12CB3460, 36963312586003520, 231669582, 231669586, 4, 640x360 
0x12CB3460, 36963312586319720, 231669611, 231669614, 3, 640x360 
0x12CB3460, 36963312586643128, 231669641, 231669649, 8, 640x360 
0x12CB3460, 36963312586961576, 231669670, 231669675, 5, 640x360 
0x12CB3460, 36963312587280696, 231669710, 231669713, 3, 640x360 
0x12CB3460, 36963312587601520, 231669741, 231669744, 3, 640x360 
0x12CB3460, 36963312587919384, 231669771, 231669787, 16, 640x360 
0x12CB3460, 36963312588241280, 231669801, 231669804, 3, 640x360 
0x12CB3460, 36963312588559368, 231669830, 231669833, 3, 640x360 
0x12CB3460, 36963312588883784, 231669884, 231669887, 3, 640x360 
0x12CB3460, 36963312589360432, 231669911, 231669914, 3, 640x360 
0x12CB3460, 36963312589681728, 231669951, 231669954, 3, 640x360 
0x12CB3460, 36963312589999496, 231669981, 231669984, 3, 640x360 
0x12CB3460, 36963312590320320, 231670011, 231670014, 3, 640x360 
0x12CB3460, 36963312590640176, 231670042, 231670045, 3, 640x360 
0x12CB3460, 36963312590959800, 231670071, 231670074, 3, 640x360 
0x12CB3460, 36963312591279368, 231670110, 231670113, 3, 640x360 
0x12CB3460, 36963312591600904, 231670140, 231670144, 4, 640x360 
0x12CB3460, 36963312591921608, 231670171, 231670174, 3, 640x360 
0x12CB3460, 36963312592239992, 231670200, 231670203, 3, 640x360 
0x12CB3460, 36963312592560040, 231670230, 231670234, 4, 640x360 
0x12CB3460, 36963312592879240, 231670261, 231670265, 4, 640x360 
0x12CB3460, 36963312593360824, 231670311, 231670314, 3, 640x360 
0x12CB3460, 36963312593681936, 231670377, 231670380, 3, 640x360 
0x12CB3460, 36963312594319792, 231670410, 231670413, 3, 640x360 
0x12CB3460, 36963312594641072, 231670440, 231670444, 4, 640x360 
0x12CB3460, 36963312594960000, 231670470, 231670473, 3, 640x360 
0x12CB3460, 36963312595279656, 231670510, 231670513, 3, 640x360 
0x12CB3460, 36963312595600496, 231670541, 231670544, 3, 640x360 
0x12CB3460, 36963312595919672, 231670570, 231670573, 3, 640x360 
0x12CB3460, 36963312596240456, 231670600, 231670603, 3, 640x360 
0x12CB3460, 36963312596559664, 231670631, 231670635, 4, 640x360 
0x12CB3460, 36963312596879872, 231670661, 231670664, 3, 640x360 
0x12CB3460, 36963312597359400, 231670712, 231670715, 3, 640x360 
0x12CB3460, 36963312597682024, 231670742, 231670746, 4, 640x360 
0x12CB3460, 36963312598001680, 231670782, 231670785, 3, 640x360 
0x12CB3460, 36963312598319320, 231670811, 231670813, 2, 640x360 
0x12CB3460, 36963312598641704, 231670842, 231670845, 3, 640x360 
0x12CB3460, 36963312598959224, 231670880, 231670883, 3, 640x360 
0x12CB3460, 36963312599279896, 231670910, 231670913, 3, 640x360 
0x12CB3460, 36963312599599464, 231670940, 231670943, 3, 640x360 
0x12CB3460, 36963312599919344, 231670971, 231670974, 3, 640x360 
0x12CB3460, 36963312600240200, 231671000, 231671003, 3, 640x360 
0x12CB3460, 36963312600561312, 231671031, 231671041, 10, 640x360 
0x12CB3460, 36963312601039760, 231671080, 231671083, 3, 640x360 
0x12CB3460, 36963312601360224, 231671111, 231671114, 3, 640x360 
0x12CB3460, 36963312601679176, 231671151, 231671154, 3, 640x360 
0x12CB3460, 36963312602001568, 231671181, 231671184, 3, 640x360 
0x12CB3460, 36963312602322792, 231671210, 231671213, 3, 640x360 
0x12CB3460, 36963312602640344, 231671241, 231671244, 3, 640x360 
0x12CB3460, 36963312602960024, 231671271, 231671274, 3, 640x360 
0x12CB3460, 36963312603278864, 231671301, 231671305, 4, 640x360 
0x12CB3460, 36963312603598960, 231671341, 231671343, 2, 640x360 
0x12CB3460, 36963312603922056, 231671375, 231671378, 3, 640x360 
0x12CB3460, 36963312604240568, 231671400, 231671403, 3, 640x360 
0x12CB3460, 36963312604560128, 231671431, 231671434, 3, 640x360 
0x12CB3460, 36963312605039368, 231671480, 231671491, 11, 640x360 
0x12CB3460, 36963312605360320, 231671511, 231671514, 3, 640x360 
0x12CB3460, 36963312605682008, 231671551, 231671555, 4, 640x360 
0x12CB3460, 36963312605999504, 231671581, 231671584, 3, 640x360 
0x12CB3460, 36963312606318672, 231671611, 231671613, 2, 640x360 
0x12CB3460, 36963312606639720, 231671640, 231671644, 4, 640x360 
0x12CB3460, 36963312606960952, 231671670, 231671673, 3, 640x360 
0x12CB3460, 36963312607280000, 231671711, 231671714, 3, 640x360 
0x12CB3460, 36963312607602632, 231671737, 231671740, 3, 640x360 
0x12CB3460, 36963312607919432, 231671771, 231671774, 3, 640x360 
0x12CB3460, 36963312608240376, 231671801, 231671803, 2, 640x360 
0x12CB3460, 36963312608719032, 231671874, 231671877, 3, 640x360 
0x12CB3460, 36963312609039760, 231671880, 231671883, 3, 640x360 
0x12CB3460, 36963312609358824, 231671912, 231671914, 2, 640x360 
0x12CB3460, 36963312609680136, 231671951, 231671954, 3, 640x360 
0x12CB3460, 36963312609999072, 231671980, 231671982, 2, 640x360 
0x12CB3460, 36963312610320424, 231672011, 231672013, 2, 640x360 
0x12CB3460, 36963312610641608, 231672041, 231672044, 3, 640x360 
0x12CB3460, 36963312610959392, 231672070, 231672073, 3, 640x360 
0x12CB3460, 36963312611279144, 231672101, 231672106, 5, 640x360 
0x12CB3460, 36963312611600248, 231672141, 231672144, 3, 640x360 
0x12CB3460, 36963312611919512, 231672170, 231672174, 4, 640x360 
0x12CB3460, 36963312612240720, 231672200, 231672203, 3, 640x360 
0x12CB3460, 36963312612718440, 231672251, 231672254, 3, 640x360 
0x12CB3460, 36963312613038360, 231672280, 231672283, 3, 640x360 
0x12CB3460, 36963312613360048, 231672311, 231672314, 3, 640x360 
0x12CB3460, 36963312613680864, 231672342, 231672359, 17, 640x360 
0x12CB3460, 36963312614000160, 231672381, 231672384, 3, 640x360 
0x12CB3460, 36963312614320280, 231672411, 231672413, 2, 640x360 
0x12CB3460, 36963312614640568, 231672441, 231672444, 3, 640x360 
0x12CB3460, 36963312614960072, 231672471, 231672474, 3, 640x360 
0x12CB3460, 36963312615279752, 231672511, 231672513, 2, 640x360 
0x12CB3460, 36963312615600432, 231672541, 231672544, 3, 640x360 
0x12CB3460, 36963312615919664, 231672571, 231672574, 3, 640x360 
0x12CB3460, 36963312616240032, 231672601, 231672604, 3, 640x360 
0x12CB3460, 36963312616719720, 231672651, 231672653, 2, 640x360 
0x12CB3460, 36963312617041568, 231672680, 231672684, 4, 640x360 
0x12CB3460, 36963312617359616, 231672711, 231672714, 3, 640x360 
0x12CB3460, 36963312617680552, 231672751, 231672753, 2, 640x360 
0x12CB3460, 36963312617999072, 231672781, 231672784, 3, 640x360 
0x12CB3460, 36963312618319848, 231672810, 231672813, 3, 640x360 
0x12CB3460, 36963312618641648, 231672841, 231672844, 3, 640x360 
0x12CB3460, 36963312618962808, 231672885, 231672888, 3, 640x360 
0x12CB3460, 36963312619279568, 231672910, 231672913, 3, 640x360 
0x12CB3460, 36963312619600632, 231672941, 231672944, 3, 640x360 
0x12CB3460, 36963312619921488, 231672970, 231672973, 3, 640x360 
0x12CB3460, 36963312620399584, 231673022, 231673025, 3, 640x360 
0x12CB3460, 36963312620722496, 231673051, 231673055, 4, 640x360 
0x12CB3460, 36963312621038392, 231673081, 231673084, 3, 640x360 
0x12CB3460, 36963312621359472, 231673111, 231673116, 5, 640x360 
0x12CB3460, 36963312621678984, 231673141, 231673145, 4, 640x360 
0x12CB3460, 36963312622000400, 231673181, 231673184, 3, 640x360 
0x12CB3460, 36963312622320360, 231673211, 231673213, 2, 640x360 
0x12CB3460, 36963312622642080, 231673242, 231673246, 4, 640x360 
0x12CB3460, 36963312622959536, 231673271, 231673274, 3, 640x360 
0x12CB3460, 36963312623279176, 231673310, 231673313, 3, 640x360 
0x12CB3460, 36963312623600056, 231673340, 231673343, 3, 640x360 
0x12CB3460, 36963312623920432, 231673370, 231673373, 3, 640x360 
0x12CB3460, 36963312624400336, 231673420, 231673423, 3, 640x360 
0x12CB3460, 36963312624718640, 231673450, 231673453, 3, 640x360 
0x12CB3460, 36963312625039624, 231673480, 231673483, 3, 640x360 
0x12CB3460, 36963312625360480, 231673510, 231673513, 3, 640x360 
0x12CB3460, 36963312625681856, 231673551, 231673554, 3, 640x360 
0x12CB3460, 36963312626000776, 231673581, 231673583, 2, 640x360 
0x12CB3460, 36963312626319528, 231673611, 231673614, 3, 640x360 
0x12CB3460, 36963312626639992, 231673641, 231673644, 3, 640x360 
0x12CB3460, 36963312626960824, 231673672, 231673675, 3, 640x360 
0x12CB3460, 36963312627281032, 231673710, 231673713, 3, 640x360 
0x12CB3460, 36963312627601944, 231673740, 231673743, 3, 640x360 
0x12CB3460, 36963312627920896, 231673771, 231673774, 3, 640x360 
0x12CB3460, 36963312628400968, 231673820, 231673823, 3, 640x360 
0x12CB3460, 36963312628718912, 231673873, 231673878, 5, 640x360 
0x12CB3460, 36963312629039488, 231673880, 231673883, 3, 640x360 
0x12CB3460, 36963312629358792, 231673910, 231673913, 3, 640x360 
0x12CB3460, 36963312629679264, 231673941, 231673944, 3, 640x360 
0x12CB3460, 36963312629999432, 231673981, 231673983, 2, 640x360 
0x12CB3460, 36963312630319320, 231674011, 231674013, 2, 640x360 
0x12CB3460, 36963312630640720, 231674040, 231674043, 3, 640x360 
0x12CB3460, 36963312630959600, 231674071, 231674074, 3, 640x360 
0x12CB3460, 36963312631279080, 231674101, 231674105, 4, 640x360 
0x12CB3460, 36963312631600792, 231674140, 231674143, 3, 640x360 
0x12CB3460, 36963312632081000, 231674191, 231674195, 4, 640x360 
0x12CB3460, 36963312632399776, 231674220, 231674223, 3, 640x360 
0x12CB3460, 36963312632720344, 231674251, 231674254, 3, 640x360 
0x12CB3460, 36963312633039960, 231674280, 231674285, 5, 640x360 
0x12CB3460, 36963312633360048, 231674311, 231674314, 3, 640x360 
0x12CB3460, 36963312633679344, 231674342, 231674346, 4, 640x360 
0x12CB3460, 36963312633999592, 231674383, 231674386, 3, 640x360 
0x12CB3460, 36963312634319120, 231674411, 231674414, 3, 640x360 
0x12CB3460, 36963312634640064, 231674440, 231674443, 3, 640x360 
0x12CB3460, 36963312634961176, 231674471, 231674474, 3, 640x360 
0x12CB3460, 36963312635280648, 231674511, 231674514, 3, 640x360 
0x12CB3460, 36963312635599664, 231674541, 231674544, 3, 640x360 
0x12CB3460, 36963312636079992, 231674581, 231674585, 4, 640x360 
0x12CB3460, 36963312636401384, 231674621, 231674624, 3, 640x360 
0x12CB3460, 36963312636719728, 231674650, 231674653, 3, 640x360 
0x12CB3460, 36963312637040424, 231674680, 231674683, 3, 640x360 
0x12CB3460, 36963312637360976, 231674710, 231674713, 3, 640x360 
0x12CB3460, 36963312637683944, 231674750, 231674753, 3, 640x360 
0x12CB3460, 36963312637999648, 231674780, 231674783, 3, 640x360 
0x12CB3460, 36963312638320104, 231674811, 231674815, 4, 640x360 
0x12CB3460, 36963312638638568, 231674840, 231674843, 3, 640x360 
0x12CB3460, 36963312638959984, 231674875, 231674878, 3, 640x360 
0x12CB3460, 36963312639278656, 231674901, 231674904, 3, 640x360 
0x12CB3460, 36963312639601152, 231674940, 231674944, 4, 640x360 
0x12CB3460, 36963312640080144, 231674991, 231674994, 3, 640x360 
0x12CB3460, 36963312640400864, 231675020, 231675023, 3, 640x360 
0x12CB3460, 36963312640721968, 231675051, 231675054, 3, 640x360 
0x12CB3460, 36963312641039744, 231675080, 231675083, 3, 640x360 
0x12CB3460, 36963312641360064, 231675111, 231675114, 3, 640x360 
0x12CB3460, 36963312641680400, 231675151, 231675154, 3, 640x360 
0x12CB3460, 36963312642001008, 231675180, 231675183, 3, 640x360 
0x12CB3460, 36963312642321000, 231675210, 231675213, 3, 640x360 
0x12CB3460, 36963312642640424, 231675241, 231675244, 3, 640x360 
0x12CB3460, 36963312642958480, 231675271, 231675273, 2, 640x360 
0x12CB3460, 36963312643279296, 231675301, 231675307, 6, 640x360 
0x12CB3460, 36963312643762096, 231675363, 231675367, 4, 640x360 
0x12CB3460, 36963312644080520, 231675391, 231675393, 2, 640x360 
0x12CB3460, 36963312644398640, 231675421, 231675438, 17, 640x360 
0x12CB3460, 36963312644720176, 231675452, 231675455, 3, 640x360 
0x12CB3460, 36963312645038536, 231675480, 231675482, 2, 640x360 
0x12CB3460, 36963312645360520, 231675511, 231675514, 3, 640x360 
0x12CB3460, 36963312645679720, 231675551, 231675553, 2, 640x360 
0x12CB3460, 36963312646001048, 231675585, 231675588, 3, 640x360 
0x12CB3460, 36963312646319984, 231675611, 231675614, 3, 640x360 
0x12CB3460, 36963312646639600, 231675641, 231675644, 3, 640x360 
0x12CB3460, 36963312646960264, 231675671, 231675674, 3, 640x360 
0x12CB3460, 36963312647280176, 231675710, 231675713, 3, 640x360 
0x12CB3460, 36963312647760296, 231675750, 231675753, 3, 640x360 
0x12CB3460, 36963312648078736, 231675782, 231675786, 4, 640x360 
0x12CB3460, 36963312648400376, 231675820, 231675823, 3, 640x360 
0x12CB3460, 36963312648719976, 231675850, 231675854, 4, 640x360 
0x12CB3460, 36963312649038856, 231675880, 231675883, 3, 640x360 
0x12CB3460, 36963312649360000, 231675911, 231675914, 3, 640x360 
0x12CB3460, 36963312649679864, 231675942, 231675946, 4, 640x360 
0x12CB3460, 36963312649999992, 231675981, 231675983, 2, 640x360 
0x12CB3460, 36963312650319408, 231676010, 231676013, 3, 640x360 
0x12CB3460, 36963312650641616, 231676040, 231676044, 4, 640x360 
0x12CB3460, 36963312650959640, 231676071, 231676075, 4, 640x360 
0x12CB3460, 36963312651438360, 231676121, 231676123, 2, 640x360 
0x12CB3460, 36963312651759656, 231676150, 231676153, 3, 640x360 
0x12CB3460, 36963312652080104, 231676191, 231676194, 3, 640x360 
0x12CB3460, 36963312652399368, 231676221, 231676225, 4, 640x360 
0x12CB3460, 36963312652719664, 231676251, 231676254, 3, 640x360 
0x12CB3460, 36963312653040304, 231676281, 231676284, 3, 640x360 
0x12CB3460, 36963312653358800, 231676311, 231676314, 3, 640x360 
0x12CB3460, 36963312653678824, 231676342, 231676366, 24, 640x360 
0x12CB3460, 36963312653998736, 231676374, 231676378, 4, 640x360 
0x12CB3460, 36963312654319744, 231676412, 231676414, 2, 640x360 
0x12CB3460, 36963312654641360, 231676441, 231676444, 3, 640x360 
0x12CB3460, 36963312654959512, 231676470, 231676473, 3, 640x360 
0x12CB3460, 36963312655437984, 231676521, 231676523, 2, 640x360 
0x12CB3460, 36963312655760144, 231676550, 231676553, 3, 640x360 
0x12CB3460, 36963312656079592, 231676581, 231676585, 4, 640x360 
0x12CB3460, 36963312656400224, 231676621, 231676623, 2, 640x360 
0x12CB3460, 36963312656720280, 231676650, 231676653, 3, 640x360 
0x12CB3460, 36963312657039400, 231676680, 231676691, 11, 640x360 
0x12CB3460, 36963312657360408, 231676711, 231676714, 3, 640x360 
0x12CB3460, 36963312657679200, 231676742, 231676745, 3, 640x360 
0x12CB3460, 36963312657999904, 231676780, 231676783, 3, 640x360 
0x12CB3460, 36963312658320752, 231676810, 231676815, 5, 640x360 
0x12CB3460, 36963312658640312, 231676842, 231676845, 3, 640x360 
0x12CB3460, 36963312658961792, 231676877, 231676891, 14, 640x360 
0x12CB3460, 36963312659438352, 231676920, 231676923, 3, 640x360 
0x12CB3460, 36963312659758728, 231676951, 231676955, 4, 640x360 
0x12CB3460, 36963312660078768, 231676991, 231676995, 4, 640x360 
0x12CB3460, 36963312660400392, 231677021, 231677024, 3, 640x360 
0x12CB3460, 36963312660721384, 231677052, 231677055, 3, 640x360 
0x12CB3460, 36963312661040464, 231677080, 231677083, 3, 640x360 
0x12CB3460, 36963312661358728, 231677111, 231677113, 2, 640x360 
0x12CB3460, 36963312661679832, 231677151, 231677153, 2, 640x360 
0x12CB3460, 36963312661999456, 231677181, 231677184, 3, 640x360 
0x12CB3460, 36963312662319712, 231677210, 231677213, 3, 640x360 
0x12CB3460, 36963312662639232, 231677241, 231677244, 3, 640x360 
0x12CB3460, 36963312663119520, 231677290, 231677296, 6, 640x360 
0x12CB3460, 36963312663438104, 231677321, 231677324, 3, 640x360 
0x12CB3460, 36963312663760184, 231677351, 231677354, 3, 640x360 
0x12CB3460, 36963312664078720, 231677383, 231677386, 3, 640x360 
0x12CB3460, 36963312664398632, 231677421, 231677424, 3, 640x360 
0x12CB3460, 36963312664718328, 231677451, 231677453, 2, 640x360 
0x12CB3460, 36963312665039824, 231677480, 231677483, 3, 640x360 
0x12CB3460, 36963312665360720, 231677510, 231677513, 3, 640x360 
0x12CB3460, 36963312665680528, 231677542, 231677545, 3, 640x360 
0x12CB3460, 36963312666001512, 231677581, 231677584, 3, 640x360 
0x12CB3460, 36963312666320416, 231677610, 231677614, 4, 640x360 
0x12CB3460, 36963312666640136, 231677641, 231677644, 3, 640x360 
0x12CB3460, 36963312667120592, 231677690, 231677692, 2, 640x360 
0x12CB3460, 36963312667440984, 231677721, 231677724, 3, 640x360 
0x12CB3460, 36963312667758120, 231677750, 231677754, 4, 640x360 
0x12CB3460, 36963312668079936, 231677782, 231677785, 3, 640x360 
0x12CB3460, 36963312668400904, 231677820, 231677823, 3, 640x360 
0x12CB3460, 36963312668722032, 231677881, 231677884, 3, 640x360 
0x12CB3460, 36963312669358216, 231677912, 231677914, 2, 640x360 
0x12CB3460, 36963312669679224, 231677942, 231677945, 3, 640x360 
0x12CB3460, 36963312670000184, 231677981, 231677984, 3, 640x360 
0x12CB3460, 36963312670319720, 231678010, 231678013, 3, 640x360 
0x12CB3460, 36963312670640800, 231678041, 231678044, 3, 640x360 
0x12CB3460, 36963312671119408, 231678090, 231678093, 3, 640x360 
0x12CB3460, 36963312671438616, 231678120, 231678123, 3, 640x360 
0x12CB3460, 36963312671758664, 231678152, 231678166, 14, 640x360 
0x12CB3460, 36963312672078288, 231678180, 231678185, 5, 640x360 
0x12CB3460, 36963312672399808, 231678220, 231678223, 3, 640x360 
0x12CB3460, 36963312672719552, 231678251, 231678253, 2, 640x360 
0x12CB3460, 36963312673039336, 231678281, 231678283, 2, 640x360 
0x12CB3460, 36963312673360200, 231678310, 231678313, 3, 640x360 
0x12CB3460, 36963312673680944, 231678342, 231678363, 21, 640x360 
0x12CB3460, 36963312673999448, 231678375, 231678379, 4, 640x360 
0x12CB3460, 36963312674318568, 231678410, 231678413, 3, 640x360 
0x12CB3460, 36963312674801048, 231678462, 231678464, 2, 640x360 
0x12CB3460, 36963312675121296, 231678491, 231678494, 3, 640x360 
0x12CB3460, 36963312675439160, 231678520, 231678538, 18, 640x360 
0x12CB3460, 36963312675761048, 231678551, 231678555, 4, 640x360 
0x12CB3460, 36963312676081848, 231678582, 231678586, 4, 640x360 
0x12CB3460, 36963312676399512, 231678622, 231678624, 2, 640x360 
0x12CB3460, 36963312676718312, 231678650, 231678653, 3, 640x360 
0x12CB3460, 36963312677039840, 231678681, 231678684, 3, 640x360 
0x12CB3460, 36963312677359296, 231678711, 231678714, 3, 640x360 
0x12CB3460, 36963312677679360, 231678750, 231678753, 3, 640x360 
0x12CB3460, 36963312677999880, 231678781, 231678784, 3, 640x360 
0x12CB3460, 36963312678320600, 231678810, 231678813, 3, 640x360 
0x12CB3460, 36963312678800224, 231678884, 231678887, 3, 640x360 
0x12CB3460, 36963312679118224, 231678890, 231678895, 5, 640x360 
0x12CB3460, 36963312679438744, 231678921, 231678923, 2, 640x360 
0x12CB3460, 36963312679760752, 231678951, 231678954, 3, 640x360 
0x12CB3460, 36963312680080672, 231678982, 231678986, 4, 640x360 
0x12CB3460, 36963312680399624, 231679021, 231679023, 2, 640x360 
0x12CB3460, 36963312680720392, 231679050, 231679053, 3, 640x360 
0x12CB3460, 36963312681038080, 231679081, 231679083, 2, 640x360 
0x12CB3460, 36963312681359744, 231679111, 231679114, 3, 640x360 
0x12CB3460, 36963312681679696, 231679142, 231679146, 4, 640x360 
0x12CB3460, 36963312681999984, 231679180, 231679182, 2, 640x360 
0x12CB3460, 36963312682478440, 231679231, 231679235, 4, 640x360 
0x12CB3460, 36963312682799744, 231679261, 231679264, 3, 640x360 
0x12CB3460, 36963312683119192, 231679290, 231679293, 3, 640x360 
0x12CB3460, 36963312683438536, 231679320, 231679323, 3, 640x360 
0x12CB3460, 36963312683760848, 231679378, 231679382, 4, 640x360 
0x12CB3460, 36963312684081840, 231679390, 231679393, 3, 640x360 
0x12CB3460, 36963312684399352, 231679421, 231679424, 3, 640x360 
0x12CB3460, 36963312684719464, 231679451, 231679453, 2, 640x360 
0x12CB3460, 36963312685040352, 231679481, 231679484, 3, 640x360 
0x12CB3460, 36963312685360848, 231679510, 231679514, 4, 640x360 
0x12CB3460, 36963312685682744, 231679551, 231679554, 3, 640x360 
0x12CB3460, 36963312686002632, 231679580, 231679583, 3, 640x360 
0x12CB3460, 36963312686478448, 231679631, 231679634, 3, 640x360 
0x12CB3460, 36963312686798736, 231679660, 231679663, 3, 640x360 
0x12CB3460, 36963312687120136, 231679690, 231679694, 4, 640x360 
0x12CB3460, 36963312687439192, 231679721, 231679724, 3, 640x360 
0x12CB3460, 36963312687760928, 231679751, 231679754, 3, 640x360 
0x12CB3460, 36963312688081080, 231679791, 231679794, 3, 640x360 
0x12CB3460, 36963312688399232, 231679820, 231679823, 3, 640x360 
0x12CB3460, 36963312688718728, 231679873, 231679877, 4, 640x360 
0x12CB3460, 36963312689039656, 231679880, 231679883, 3, 640x360 
0x12CB3460, 36963312689360168, 231679912, 231679915, 3, 640x360 
0x12CB3460, 36963312689680376, 231679941, 231679946, 5, 640x360 
0x12CB3460, 36963312689999640, 231679981, 231679984, 3, 640x360 
0x12CB3460, 36963312690481576, 231680031, 231680042, 11, 640x360 
0x12CB3460, 36963312690799920, 231680060, 231680063, 3, 640x360 
0x12CB3460, 36963312691118032, 231680091, 231680093, 2, 640x360 
0x12CB3460, 36963312691439064, 231680121, 231680125, 4, 640x360 
0x12CB3460, 36963312691759576, 231680150, 231680154, 4, 640x360 
0x12CB3460, 36963312692080488, 231680181, 231680185, 4, 640x360 
0x12CB3460, 36963312692399520, 231680221, 231680224, 3, 640x360 
0x12CB3460, 36963312692718208, 231680251, 231680253, 2, 640x360 
0x12CB3460, 36963312693038376, 231680281, 231680284, 3, 640x360 
0x12CB3460, 36963312693359608, 231680311, 231680314, 3, 640x360 
0x12CB3460, 36963312693679864, 231680342, 231680346, 4, 640x360 
0x12CB3460, 36963312694159320, 231680391, 231680393, 2, 640x360 
0x12CB3460, 36963312694478176, 231680431, 231680433, 2, 640x360 
0x12CB3460, 36963312694798744, 231680460, 231680463, 3, 640x360 
0x12CB3460, 36963312695118832, 231680492, 231680495, 3, 640x360 
0x12CB3460, 36963312695438560, 231680520, 231680523, 3, 640x360 
0x12CB3460, 36963312695759296, 231680552, 231680554, 2, 640x360 
0x12CB3460, 36963312696079456, 231680581, 231680585, 4, 640x360 
0x12CB3460, 36963312696398296, 231680613, 231680617, 4, 640x360 
0x12CB3460, 36963312696720576, 231680650, 231680653, 3, 640x360 
0x12CB3460, 36963312697039648, 231680681, 231680683, 2, 640x360 
0x12CB3460, 36963312697359816, 231680710, 231680713, 3, 640x360 
0x12CB3460, 36963312697680376, 231680741, 231680744, 3, 640x360 
0x12CB3460, 36963312698159992, 231680790, 231680794, 4, 640x360 
0x12CB3460, 36963312698482584, 231680830, 231680832, 2, 640x360 
0x12CB3460, 36963312698799296, 231680875, 231680878, 3, 640x360 
0x12CB3460, 36963312699118192, 231680890, 231680893, 3, 640x360 
0x12CB3460, 36963312699438400, 231680921, 231680924, 3, 640x360 
0x12CB3460, 36963312699760184, 231680951, 231680968, 17, 640x360 
0x12CB3460, 36963312700080408, 231680991, 231680993, 2, 640x360 
0x12CB3460, 36963312700400480, 231681020, 231681023, 3, 640x360 
0x12CB3460, 36963312700720472, 231681050, 231681053, 3, 640x360 
0x12CB3460, 36963312701039320, 231681080, 231681083, 3, 640x360 
0x12CB3460, 36963312701358824, 231681110, 231681113, 3, 640x360 
0x12CB3460, 36963312701679128, 231681141, 231681145, 4, 640x360 
0x12CB3460, 36963312702158488, 231681190, 231681193, 3, 640x360 
0x12CB3460, 36963312702479384, 231681221, 231681225, 4, 640x360 
0x12CB3460, 36963312702798288, 231681261, 231681263, 2, 640x360 
0x12CB3460, 36963312703119632, 231681290, 231681294, 4, 640x360 
0x12CB3460, 36963312703438136, 231681321, 231681323, 2, 640x360 
0x12CB3460, 36963312703759176, 231681374, 231681378, 4, 640x360 
0x12CB3460, 36963312704079160, 231681382, 231681385, 3, 640x360 
0x12CB3460, 36963312704398744, 231681421, 231681424, 3, 640x360 
0x12CB3460, 36963312704719648, 231681450, 231681455, 5, 640x360 
0x12CB3460, 36963312705039688, 231681481, 231681484, 3, 640x360 
0x12CB3460, 36963312705360736, 231681510, 231681517, 7, 640x360 
0x12CB3460, 36963312705841616, 231681563, 231681566, 3, 640x360 
0x12CB3460, 36963312706160968, 231681591, 231681594, 3, 640x360 
0x12CB3460, 36963312706477648, 231681620, 231681623, 3, 640x360 
0x12CB3460, 36963312706798624, 231681660, 231681662, 2, 640x360 
0x12CB3460, 36963312707118640, 231681691, 231681694, 3, 640x360 
0x12CB3460, 36963312707439608, 231681721, 231681724, 3, 640x360 
0x12CB3460, 36963312707759232, 231681752, 231681755, 3, 640x360 
0x12CB3460, 36963312708078616, 231681780, 231681784, 4, 640x360 
0x12CB3460, 36963312708399848, 231681820, 231681823, 3, 640x360 
0x12CB3460, 36963312708718312, 231681851, 231681853, 2, 640x360 
0x12CB3460, 36963312709039200, 231681885, 231681888, 3, 640x360 
0x12CB3460, 36963312709359232, 231681909, 231681913, 4, 640x360 
0x12CB3460, 36963312709840320, 231681960, 231681963, 3, 640x360 
0x12CB3460, 36963312710162232, 231681991, 231681994, 3, 640x360 
0x12CB3460, 36963312710478400, 231682030, 231682032, 2, 640x360 
0x12CB3460, 36963312710799048, 231682061, 231682064, 3, 640x360 
0x12CB3460, 36963312711120832, 231682090, 231682093, 3, 640x360 
0x12CB3460, 36963312711438120, 231682120, 231682123, 3, 640x360 
0x12CB3460, 36963312711759048, 231682150, 231682153, 3, 640x360 
0x12CB3460, 36963312712079344, 231682181, 231682184, 3, 640x360 
0x12CB3460, 36963312712400976, 231682221, 231682224, 3, 640x360 
0x12CB3460, 36963312712721032, 231682251, 231682255, 4, 640x360 
0x12CB3460, 36963312713039680, 231682280, 231682283, 3, 640x360 
0x12CB3460, 36963312713359712, 231682311, 231682313, 2, 640x360 
0x12CB3460, 36963312713840888, 231682379, 231682382, 3, 640x360 
0x12CB3460, 36963312714159712, 231682391, 231682395, 4, 640x360 
0x12CB3460, 36963312714478992, 231682421, 231682424, 3, 640x360 
0x12CB3460, 36963312714798536, 231682461, 231682463, 2, 640x360 
0x12CB3460, 36963312715118336, 231682490, 231682493, 3, 640x360 
0x12CB3460, 36963312715439976, 231682520, 231682523, 3, 640x360 
0x12CB3460, 36963312715759792, 231682551, 231682553, 2, 640x360 
0x12CB3460, 36963312716080616, 231682581, 231682585, 4, 640x360 
0x12CB3460, 36963312716402016, 231682623, 231682626, 3, 640x360 
0x12CB3460, 36963312716720432, 231682650, 231682654, 4, 640x360 
0x12CB3460, 36963312717038936, 231682680, 231682682, 2, 640x360 
0x12CB3460, 36963312717518160, 231682730, 231682734, 4, 640x360 
0x12CB3460, 36963312717837952, 231682760, 231682763, 3, 640x360 
0x12CB3460, 36963312718159680, 231682791, 231682794, 3, 640x360 
0x12CB3460, 36963312718479928, 231682821, 231682825, 4, 640x360 
0x12CB3460, 36963312718800048, 231682877, 231682880, 3, 640x360 
0x12CB3460, 36963312719118416, 231682891, 231682894, 3, 640x360 
0x12CB3460, 36963312719440976, 231682920, 231682923, 3, 640x360 
0x12CB3460, 36963312719758448, 231682952, 231682954, 2, 640x360 
0x12CB3460, 36963312720078736, 231682981, 231682984, 3, 640x360 
0x12CB3460, 36963312720400672, 231683020, 231683023, 3, 640x360 
0x12CB3460, 36963312720719080, 231683050, 231683053, 3, 640x360 
0x12CB3460, 36963312721039240, 231683080, 231683092, 12, 640x360 
0x12CB3460, 36963312721518088, 231683131, 231683134, 3, 640x360 
0x12CB3460, 36963312721838152, 231683160, 231683163, 3, 640x360 
0x12CB3460, 36963312722160272, 231683191, 231683194, 3, 640x360 
0x12CB3460, 36963312722481032, 231683230, 231683234, 4, 640x360 
0x12CB3460, 36963312722798080, 231683261, 231683264, 3, 640x360 
0x12CB3460, 36963312723124592, 231683291, 231683294, 3, 640x360 
0x12CB3460, 36963312723440568, 231683320, 231683323, 3, 640x360 
0x12CB3460, 36963312723759960, 231683351, 231683354, 3, 640x360 
0x12CB3460, 36963312724080112, 231683389, 231683393, 4, 640x360 
0x12CB3460, 36963312724399392, 231683420, 231683422, 2, 640x360 
0x12CB3460, 36963312724718616, 231683451, 231683454, 3, 640x360 
0x12CB3460, 36963312725199064, 231683495, 231683499, 4, 640x360 
0x12CB3460, 36963312725519608, 231683531, 231683533, 2, 640x360 
0x12CB3460, 36963312725840000, 231683560, 231683567, 7, 640x360 
0x12CB3460, 36963312726160696, 231683590, 231683594, 4, 640x360 
0x12CB3460, 36963312726479904, 231683622, 231683625, 3, 640x360 
0x12CB3460, 36963312726799616, 231683661, 231683664, 3, 640x360 
0x12CB3460, 36963312727119512, 231683691, 231683694, 3, 640x360 
0x12CB3460, 36963312727439216, 231683721, 231683724, 3, 640x360 
0x12CB3460, 36963312727758688, 231683752, 231683756, 4, 640x360 
0x12CB3460, 36963312728079264, 231683781, 231683783, 2, 640x360 
0x12CB3460, 36963312728399768, 231683820, 231683823, 3, 640x360 
0x12CB3460, 36963312728719032, 231683874, 231683877, 3, 640x360 
0x12CB3460, 36963312729197992, 231683900, 231683903, 3, 640x360 
0x12CB3460, 36963312729519800, 231683931, 231683934, 3, 640x360 
0x12CB3460, 36963312729841224, 231683962, 231683964, 2, 640x360 
0x12CB3460, 36963312730161288, 231683990, 231683995, 5, 640x360 
0x12CB3460, 36963312730479744, 231684030, 231684032, 2, 640x360 
0x12CB3460, 36963312730799248, 231684060, 231684063, 3, 640x360 
0x12CB3460, 36963312731117992, 231684089, 231684093, 4, 640x360 
0x12CB3460, 36963312731438384, 231684120, 231684123, 3, 640x360 
0x12CB3460, 36963312731759528, 231684150, 231684154, 4, 640x360 
0x12CB3460, 36963312732078480, 231684190, 231684194, 4, 640x360 
0x12CB3460, 36963312732400296, 231684221, 231684224, 3, 640x360 
0x12CB3460, 36963312732718880, 231684250, 231684253, 3, 640x360 
0x12CB3460, 36963312733201672, 231684299, 231684302, 3, 640x360 
0x12CB3460, 36963312733518968, 231684330, 231684333, 3, 640x360 
0x12CB3460, 36963312733839472, 231684374, 231684377, 3, 640x360 
0x12CB3460, 36963312734159336, 231684391, 231684395, 4, 640x360 
0x12CB3460, 36963312734478448, 231684430, 231684433, 3, 640x360 
0x12CB3460, 36963312734798672, 231684462, 231684465, 3, 640x360 
0x12CB3460, 36963312735119928, 231684491, 231684494, 3, 640x360 
0x12CB3460, 36963312735439400, 231684520, 231684523, 3, 640x360 
0x12CB3460, 36963312735759720, 231684551, 231684554, 3, 640x360 
0x12CB3460, 36963312736080544, 231684591, 231684594, 3, 640x360 
0x12CB3460, 36963312736401576, 231684621, 231684625, 4, 640x360 
0x12CB3460, 36963312736879496, 231684670, 231684672, 2, 640x360 
0x12CB3460, 36963312737198816, 231684700, 231684703, 3, 640x360 
0x12CB3460, 36963312737522376, 231684730, 231684734, 4, 640x360 
0x12CB3460, 36963312737839112, 231684760, 231684766, 6, 640x360 
0x12CB3460, 36963312738158800, 231684791, 231684795, 4, 640x360 
0x12CB3460, 36963312738479360, 231684821, 231684825, 4, 640x360 
0x12CB3460, 36963312738798448, 231684883, 231684886, 3, 640x360 
0x12CB3460, 36963312739119560, 231684891, 231684893, 2, 640x360 
0x12CB3460, 36963312739438872, 231684920, 231684923, 3, 640x360 
0x12CB3460, 36963312739759344, 231684951, 231684954, 3, 640x360 
0x12CB3460, 36963312740080168, 231684991, 231684995, 4, 640x360 
0x12CB3460, 36963312740399080, 231685020, 231685023, 3, 640x360 
0x12CB3460, 36963312740878936, 231685061, 231685064, 3, 640x360 
0x12CB3460, 36963312741197928, 231685100, 231685103, 3, 640x360 
0x12CB3460, 36963312741519504, 231685131, 231685134, 3, 640x360 
0x12CB3460, 36963312741838704, 231685161, 231685164, 3, 640x360 
0x12CB3460, 36963312742160536, 231685190, 231685194, 4, 640x360 
0x12CB3460, 36963312742479992, 231685222, 231685225, 3, 640x360 
0x12CB3460, 36963312742798480, 231685260, 231685263, 3, 640x360 
0x12CB3460, 36963312743118304, 231685291, 231685293, 2, 640x360 
0x12CB3460, 36963312743437888, 231685320, 231685323, 3, 640x360 
0x12CB3460, 36963312743759568, 231685350, 231685354, 4, 640x360 
0x12CB3460, 36963312744079200, 231685382, 231685386, 4, 640x360 
0x12CB3460, 36963312744398608, 231685420, 231685423, 3, 640x360 
0x12CB3460, 36963312744881104, 231685461, 231685464, 3, 640x360 
0x12CB3460, 36963312745199872, 231685500, 231685518, 18, 640x360 
0x12CB3460, 36963312745520712, 231685531, 231685533, 2, 640x360 
0x12CB3460, 36963312745840616, 231685560, 231685563, 3, 640x360 
0x12CB3460, 36963312746160192, 231685592, 231685595, 3, 640x360 
0x12CB3460, 36963312746479136, 231685622, 231685625, 3, 640x360 
0x12CB3460, 36963312746802696, 231685661, 231685665, 4, 640x360 
0x12CB3460, 36963312747119336, 231685690, 231685694, 4, 640x360 
0x12CB3460, 36963312747441240, 231685721, 231685724, 3, 640x360 
0x12CB3460, 36963312747758696, 231685750, 231685753, 3, 640x360 
0x12CB3460, 36963312748081960, 231685790, 231685793, 3, 640x360 
0x12CB3460, 36963312748558928, 231685831, 231685834, 3, 640x360 
0x12CB3460, 36963312748879896, 231685872, 231685875, 3, 640x360 
0x12CB3460, 36963312749198208, 231685901, 231685904, 3, 640x360 
0x12CB3460, 36963312749519808, 231685930, 231685933, 3, 640x360 
0x12CB3460, 36963312749841064, 231685961, 231685964, 3, 640x360 
0x12CB3460, 36963312750162152, 231685991, 231685997, 6, 640x360 
0x12CB3460, 36963312750478632, 231686021, 231686025, 4, 640x360 
0x12CB3460, 36963312750799408, 231686059, 231686062, 3, 640x360 
0x12CB3460, 36963312751117720, 231686091, 231686093, 2, 640x360 
0x12CB3460, 36963312751440600, 231686120, 231686123, 3, 640x360 
0x12CB3460, 36963312751758840, 231686151, 231686153, 2, 640x360 
0x12CB3460, 36963312752081224, 231686191, 231686195, 4, 640x360 
0x12CB3460, 36963312752561936, 231686231, 231686235, 4, 640x360 
0x12CB3460, 36963312752877616, 231686261, 231686265, 4, 640x360 
0x12CB3460, 36963312753199512, 231686300, 231686303, 3, 640x360 
0x12CB3460, 36963312753519640, 231686330, 231686333, 3, 640x360 
0x12CB3460, 36963312753839048, 231686381, 231686384, 3, 640x360 
0x12CB3460, 36963312754158192, 231686391, 231686394, 3, 640x360 
0x12CB3460, 36963312754479360, 231686422, 231686425, 3, 640x360 
0x12CB3460, 36963312754798424, 231686462, 231686465, 3, 640x360 
0x12CB3460, 36963312755118416, 231686490, 231686494, 4, 640x360 
0x12CB3460, 36963312755440168, 231686521, 231686523, 2, 640x360 
0x12CB3460, 36963312755758952, 231686550, 231686554, 4, 640x360 
0x12CB3460, 36963312756081008, 231686582, 231686585, 3, 640x360 
0x12CB3460, 36963312756557912, 231686631, 231686634, 3, 640x360 
0x12CB3460, 36963312756877424, 231686670, 231686673, 3, 640x360 
0x12CB3460, 36963312757199536, 231686700, 231686713, 13, 640x360 
0x12CB3460, 36963312757518616, 231686730, 231686733, 3, 640x360 
0x12CB3460, 36963312757837760, 231686760, 231686763, 3, 640x360 
0x12CB3460, 36963312758159520, 231686792, 231686794, 2, 640x360 
0x12CB3460, 36963312758479896, 231686830, 231686836, 6, 640x360 
0x12CB3460, 36963312758799592, 231686873, 231686876, 3, 640x360 
0x12CB3460, 36963312759118408, 231686890, 231686893, 3, 640x360 
0x12CB3460, 36963312759440624, 231686920, 231686923, 3, 640x360 
0x12CB3460, 36963312759758688, 231686950, 231686953, 3, 640x360 
0x12CB3460, 36963312760238696, 231687001, 231687003, 2, 640x360 
0x12CB3460, 36963312760559728, 231687030, 231687033, 3, 640x360 
0x12CB3460, 36963312760878528, 231687061, 231687065, 4, 640x360 
0x12CB3460, 36963312761197960, 231687100, 231687103, 3, 640x360 
0x12CB3460, 36963312761519072, 231687131, 231687133, 2, 640x360 
0x12CB3460, 36963312761839432, 231687160, 231687163, 3, 640x360 
0x12CB3460, 36963312762160072, 231687190, 231687194, 4, 640x360 
0x12CB3460, 36963312762480256, 231687222, 231687226, 4, 640x360 
0x12CB3460, 36963312762798464, 231687260, 231687263, 3, 640x360 
0x12CB3460, 36963312763119880, 231687290, 231687294, 4, 640x360 
0x12CB3460, 36963312763440472, 231687321, 231687323, 2, 640x360 
0x12CB3460, 36963312763759760, 231687375, 231687378, 3, 640x360 
0x12CB3460, 36963312764238512, 231687401, 231687404, 3, 640x360 
0x12CB3460, 36963312764559584, 231687430, 231687433, 3, 640x360 
0x12CB3460, 36963312764878416, 231687462, 231687465, 3, 640x360 
0x12CB3460, 36963312765198280, 231687500, 231687504, 4, 640x360 
0x12CB3460, 36963312765518448, 231687530, 231687533, 3, 640x360 
0x12CB3460, 36963312765838192, 231687560, 231687562, 2, 640x360 
0x12CB3460, 36963312766159744, 231687591, 231687595, 4, 640x360 
0x12CB3460, 36963312766480256, 231687621, 231687624, 3, 640x360 
0x12CB3460, 36963312766798416, 231687661, 231687663, 2, 640x360 
0x12CB3460, 36963312767120088, 231687690, 231687694, 4, 640x360 
0x12CB3460, 36963312767439504, 231687721, 231687724, 3, 640x360 
0x12CB3460, 36963312767919728, 231687770, 231687773, 3, 640x360 
0x12CB3460, 36963312768239856, 231687800, 231687804, 4, 640x360 
0x12CB3460, 36963312768559232, 231687830, 231687833, 3, 640x360 
0x12CB3460, 36963312768878664, 231687875, 231687878, 3, 640x360 
0x12CB3460, 36963312769198240, 231687900, 231687903, 3, 640x360 
0x12CB3460, 36963312769519456, 231687931, 231687934, 3, 640x360 
0x12CB3460, 36963312769838528, 231687961, 231687964, 3, 640x360 
0x12CB3460, 36963312770157408, 231687990, 231687994, 4, 640x360 
0x12CB3460, 36963312770478160, 231688021, 231688024, 3, 640x360 
0x12CB3460, 36963312770799232, 231688060, 231688063, 3, 640x360 
0x12CB3460, 36963312771118808, 231688091, 231688094, 3, 640x360 
0x12CB3460, 36963312771440496, 231688120, 231688123, 3, 640x360 
0x12CB3460, 36963312771918080, 231688171, 231688175, 4, 640x360 
0x12CB3460, 36963312772237936, 231688201, 231688205, 4, 640x360 
0x12CB3460, 36963312772558528, 231688232, 231688235, 3, 640x360 
0x12CB3460, 36963312772877672, 231688261, 231688264, 3, 640x360 
0x12CB3460, 36963312773198160, 231688301, 231688303, 2, 640x360 
0x12CB3460, 36963312773517944, 231688330, 231688333, 3, 640x360 
0x12CB3460, 36963312773840152, 231688375, 231688378, 3, 640x360 
0x12CB3460, 36963312774157512, 231688390, 231688393, 3, 640x360 
0x12CB3460, 36963312774478024, 231688421, 231688440, 19, 640x360 
0x12CB3460, 36963312774798896, 231688461, 231688463, 2, 640x360 
0x12CB3460, 36963312775117888, 231688490, 231688493, 3, 640x360 
0x12CB3460, 36963312775438976, 231688520, 231688523, 3, 640x360 
0x12CB3460, 36963312775917792, 231688570, 231688573, 3, 640x360 
0x12CB3460, 36963312776239624, 231688601, 231688616, 15, 640x360 
0x12CB3460, 36963312776559880, 231688631, 231688634, 3, 640x360 
0x12CB3460, 36963312776879304, 231688670, 231688673, 3, 640x360 
0x12CB3460, 36963312777198752, 231688700, 231688703, 3, 640x360 
0x12CB3460, 36963312777520000, 231688731, 231688734, 3, 640x360 
0x12CB3460, 36963312777841336, 231688762, 231688765, 3, 640x360 
0x12CB3460, 36963312778161496, 231688791, 231688795, 4, 640x360 
0x12CB3460, 36963312778478856, 231688830, 231688836, 6, 640x360 
0x12CB3460, 36963312778799000, 231688882, 231688885, 3, 640x360 
0x12CB3460, 36963312779120376, 231688892, 231688895, 3, 640x360 
0x12CB3460, 36963312779599712, 231688940, 231688943, 3, 640x360 
0x12CB3460, 36963312779923760, 231688970, 231688973, 3, 640x360 
0x12CB3460, 36963312780239496, 231689000, 231689002, 2, 640x360 
0x12CB3460, 36963312780559704, 231689031, 231689034, 3, 640x360 
0x12CB3460, 36963312780877840, 231689060, 231689064, 4, 640x360 
0x12CB3460, 36963312781199856, 231689101, 231689104, 3, 640x360 
0x12CB3460, 36963312781519760, 231689132, 231689134, 2, 640x360 
0x12CB3460, 36963312781837376, 231689160, 231689163, 3, 640x360 
0x12CB3460, 36963312782157688, 231689191, 231689194, 3, 640x360 
0x12CB3460, 36963312782477744, 231689221, 231689225, 4, 640x360 
0x12CB3460, 36963312782798240, 231689260, 231689263, 3, 640x360 
0x12CB3460, 36963312783118936, 231689291, 231689294, 3, 640x360 
0x12CB3460, 36963312783599088, 231689341, 231689344, 3, 640x360 
0x12CB3460, 36963312783921552, 231689383, 231689386, 3, 640x360 
0x12CB3460, 36963312784238640, 231689400, 231689403, 3, 640x360 
0x12CB3460, 36963312784558568, 231689431, 231689434, 3, 640x360 
0x12CB3460, 36963312784878088, 231689472, 231689475, 3, 640x360 
0x12CB3460, 36963312785198840, 231689501, 231689517, 16, 640x360 
0x12CB3460, 36963312785520264, 231689530, 231689533, 3, 640x360 
0x12CB3460, 36963312785839544, 231689561, 231689564, 3, 640x360 
0x12CB3460, 36963312786157696, 231689591, 231689594, 3, 640x360 
0x12CB3460, 36963312786479104, 231689630, 231689634, 4, 640x360 
0x12CB3460, 36963312786799376, 231689660, 231689662, 2, 640x360 
0x12CB3460, 36963312787118928, 231689691, 231689694, 3, 640x360 
0x12CB3460, 36963312787601552, 231689740, 231689744, 4, 640x360 
0x12CB3460, 36963312787919512, 231689771, 231689774, 3, 640x360 
0x12CB3460, 36963312788239632, 231689800, 231689803, 3, 640x360 
0x12CB3460, 36963312788559160, 231689831, 231689834, 3, 640x360 
0x12CB3460, 36963312788880688, 231689873, 231689877, 4, 640x360 
0x12CB3460, 36963312789198264, 231689900, 231689917, 17, 640x360 
0x12CB3460, 36963312789518872, 231689932, 231689934, 2, 640x360 
0x12CB3460, 36963312789840056, 231689961, 231689967, 6, 640x360 
0x12CB3460, 36963312790159808, 231689990, 231689994, 4, 640x360 
0x12CB3460, 36963312790481192, 231690030, 231690033, 3, 640x360 
0x12CB3460, 36963312790799592, 231690060, 231690063, 3, 640x360 
0x12CB3460, 36963312791278536, 231690111, 231690114, 3, 640x360 
0x12CB3460, 36963312791597784, 231690141, 231690144, 3, 640x360 
0x12CB3460, 36963312791919136, 231690170, 231690173, 3, 640x360 
0x12CB3460, 36963312792240600, 231690201, 231690205, 4, 640x360 
0x12CB3460, 36963312792560488, 231690230, 231690235, 5, 640x360 
0x12CB3460, 36963312792879104, 231690261, 231690265, 4, 640x360 
0x12CB3460, 36963312793198400, 231690300, 231690303, 3, 640x360 
0x12CB3460, 36963312793517872, 231690330, 231690334, 4, 640x360 
0x12CB3460, 36963312793844416, 231690372, 231690375, 3, 640x360 
0x12CB3460, 36963312794159200, 231690390, 231690393, 3, 640x360 
0x12CB3460, 36963312794478112, 231690421, 231690425, 4, 640x360 
0x12CB3460, 36963312794799336, 231690460, 231690463, 3, 640x360 
0x12CB3460, 36963312795278600, 231690501, 231690505, 4, 640x360 
0x12CB3460, 36963312795597664, 231690541, 231690544, 3, 640x360 
0x12CB3460, 36963312795919824, 231690570, 231690573, 3, 640x360 
0x12CB3460, 36963312796238584, 231690600, 231690602, 2, 640x360 
0x12CB3460, 36963312796558912, 231690630, 231690633, 3, 640x360 
0x12CB3460, 36963312796879184, 231690660, 231690666, 6, 640x360 
0x12CB3460, 36963312797200456, 231690701, 231690704, 3, 640x360 
0x12CB3460, 36963312797518856, 231690730, 231690733, 3, 640x360 
0x12CB3460, 36963312797838776, 231690761, 231690767, 6, 640x360 
0x12CB3460, 36963312798159352, 231690791, 231690794, 3, 640x360 
0x12CB3460, 36963312798478792, 231690820, 231690823, 3, 640x360 
0x12CB3460, 36963312798958240, 231690878, 231690881, 3, 640x360 
0x12CB3460, 36963312799278456, 231690910, 231690913, 3, 640x360 
0x12CB3460, 36963312799600032, 231690940, 231690943, 3, 640x360 
0x12CB3460, 36963312799920376, 231690970, 231690973, 3, 640x360 
0x12CB3460, 36963312800239200, 231691000, 231691003, 3, 640x360 
0x12CB3460, 36963312800559504, 231691031, 231691042, 11, 640x360 
0x12CB3460, 36963312800878712, 231691061, 231691065, 4, 640x360 
0x12CB3460, 36963312801198936, 231691101, 231691103, 2, 640x360 
0x12CB3460, 36963312801517888, 231691131, 231691133, 2, 640x360 
0x12CB3460, 36963312801839472, 231691160, 231691163, 3, 640x360 
0x12CB3460, 36963312802157632, 231691191, 231691195, 4, 640x360 
0x12CB3460, 36963312802478688, 231691221, 231691225, 4, 640x360 
0x12CB3460, 36963312802958696, 231691270, 231691273, 3, 640x360 
0x12CB3460, 36963312803278344, 231691301, 231691304, 3, 640x360 
0x12CB3460, 36963312803598816, 231691340, 231691344, 4, 640x360 
0x12CB3460, 36963312803920480, 231691374, 231691377, 3, 640x360 
0x12CB3460, 36963312804237864, 231691400, 231691403, 3, 640x360 
0x12CB3460, 36963312804559272, 231691430, 231691434, 4, 640x360 
0x12CB3460, 36963312804878496, 231691461, 231691463, 2, 640x360 
0x12CB3460, 36963312805199776, 231691501, 231691503, 2, 640x360 
0x12CB3460, 36963312805518208, 231691530, 231691533, 3, 640x360 
0x12CB3460, 36963312805839056, 231691561, 231691564, 3, 640x360 
0x12CB3460, 36963312806159400, 231691592, 231691595, 3, 640x360 
0x12CB3460, 36963312806481024, 231691631, 231691636, 5, 640x360 
0x12CB3460, 36963312806965136, 231691670, 231691674, 4, 640x360 
0x12CB3460, 36963312807281256, 231691711, 231691714, 3, 640x360 
0x12CB3460, 36963312807601848, 231691742, 231691746, 4, 640x360 
0x12CB3460, 36963312807919360, 231691770, 231691773, 3, 640x360 
0x12CB3460, 36963312808241112, 231691801, 231691804, 3, 640x360 
0x12CB3460, 36963312808562960, 231691831, 231691834, 3, 640x360 
0x12CB3460, 36963312808880264, 231691874, 231691877, 3, 640x360 
0x12CB3460, 36963312809198288, 231691900, 231691903, 3, 640x360 
0x12CB3460, 36963312809519120, 231691931, 231691934, 3, 640x360 
0x12CB3460, 36963312809839632, 231691961, 231691964, 3, 640x360 
0x12CB3460, 36963312810160544, 231691991, 231691994, 3, 640x360 
0x12CB3460, 36963312810639064, 231692040, 231692045, 5, 640x360 
0x12CB3460, 36963312810957208, 231692070, 231692073, 3, 640x360 
0x12CB3460, 36963312811277440, 231692101, 231692105, 4, 640x360 
0x12CB3460, 36963312811598920, 231692141, 231692144, 3, 640x360 
0x12CB3460, 36963312811918136, 231692170, 231692172, 2, 640x360 
0x12CB3460, 36963312812238672, 231692201, 231692204, 3, 640x360 
0x12CB3460, 36963312812559344, 231692230, 231692233, 3, 640x360 
0x12CB3460, 36963312812878240, 231692261, 231692265, 4, 640x360 
0x12CB3460, 36963312813197960, 231692300, 231692302, 2, 640x360 
0x12CB3460, 36963312813518856, 231692330, 231692333, 3, 640x360 
0x12CB3460, 36963312813837880, 231692381, 231692383, 2, 640x360 
0x12CB3460, 36963312814158696, 231692391, 231692394, 3, 640x360 
0x12CB3460, 36963312814639472, 231692441, 231692444, 3, 640x360 
0x12CB3460, 36963312814958032, 231692471, 231692474, 3, 640x360 
0x12CB3460, 36963312815277768, 231692501, 231692505, 4, 640x360 
0x12CB3460, 36963312815597376, 231692541, 231692544, 3, 640x360 
0x12CB3460, 36963312815917728, 231692570, 231692573, 3, 640x360 
0x12CB3460, 36963312816238224, 231692600, 231692602, 2, 640x360 
0x12CB3460, 36963312816558776, 231692630, 231692633, 3, 640x360 
0x12CB3460, 36963312816878432, 231692661, 231692664, 3, 640x360 
0x12CB3460, 36963312817197824, 231692700, 231692713, 13, 640x360 
0x12CB3460, 36963312817519920, 231692730, 231692733, 3, 640x360 
0x12CB3460, 36963312817837472, 231692761, 231692767, 6, 640x360 
0x12CB3460, 36963312818159936, 231692790, 231692794, 4, 640x360 
0x12CB3460, 36963312818638952, 231692840, 231692860, 20, 640x360 
0x12CB3460, 36963312818960480, 231692873, 231692876, 3, 640x360 
0x12CB3460, 36963312819278944, 231692902, 231692905, 3, 640x360 
0x12CB3460, 36963312819598040, 231692940, 231692944, 4, 640x360 
0x12CB3460, 36963312819918472, 231692971, 231692974, 3, 640x360 
0x12CB3460, 36963312820238832, 231693000, 231693003, 3, 640x360 
0x12CB3460, 36963312820559632, 231693031, 231693034, 3, 640x360 
0x12CB3460, 36963312820878040, 231693061, 231693065, 4, 640x360 
0x12CB3460, 36963312821199816, 231693093, 231693096, 3, 640x360 
0x12CB3460, 36963312821518896, 231693130, 231693133, 3, 640x360 
0x12CB3460, 36963312821838568, 231693161, 231693167, 6, 640x360 
0x12CB3460, 36963312822318360, 231693210, 231693213, 3, 640x360 
0x12CB3460, 36963312822639448, 231693241, 231693244, 3, 640x360 
0x12CB3460, 36963312822958704, 231693271, 231693274, 3, 640x360 
0x12CB3460, 36963312823279088, 231693310, 231693314, 4, 640x360 
0x12CB3460, 36963312823597768, 231693339, 231693342, 3, 640x360 
0x12CB3460, 36963312823918056, 231693373, 231693376, 3, 640x360 
0x12CB3460, 36963312824238760, 231693400, 231693403, 3, 640x360 
0x12CB3460, 36963312824558928, 231693431, 231693434, 3, 640x360 
0x12CB3460, 36963312824879152, 231693461, 231693464, 3, 640x360 
0x12CB3460, 36963312825199528, 231693500, 231693505, 5, 640x360 
0x12CB3460, 36963312825518552, 231693531, 231693542, 11, 640x360 
0x12CB3460, 36963312825838976, 231693560, 231693562, 2, 640x360 
0x12CB3460, 36963312826318192, 231693610, 231693614, 4, 640x360 
0x12CB3460, 36963312826640528, 231693642, 231693645, 3, 640x360 
0x12CB3460, 36963312826959144, 231693672, 231693674, 2, 640x360 
0x12CB3460, 36963312827280760, 231693710, 231693712, 2, 640x360 
0x12CB3460, 36963312827598728, 231693739, 231693742, 3, 640x360 
0x12CB3460, 36963312827917928, 231693770, 231693773, 3, 640x360 
0x12CB3460, 36963312828240176, 231693801, 231693804, 3, 640x360 
0x12CB3460, 36963312828557776, 231693832, 231693835, 3, 640x360 
0x12CB3460, 36963312828878208, 231693883, 231693886, 3, 640x360 
0x12CB3460, 36963312829198880, 231693900, 231693903, 3, 640x360 
0x12CB3460, 36963312829518672, 231693930, 231693933, 3, 640x360 
0x12CB3460, 36963312829839344, 231693961, 231693963, 2, 640x360 
0x12CB3460, 36963312830318184, 231694010, 231694014, 4, 640x360 
0x12CB3460, 36963312830636976, 231694041, 231694045, 4, 640x360 
0x12CB3460, 36963312830958128, 231694070, 231694073, 3, 640x360 
0x12CB3460, 36963312831278888, 231694102, 231694105, 3, 640x360 
0x12CB3460, 36963312831598408, 231694141, 231694144, 3, 640x360 
0x12CB3460, 36963312831918240, 231694171, 231694173, 2, 640x360 
0x12CB3460, 36963312832240320, 231694200, 231694203, 3, 640x360 
0x12CB3460, 36963312832558536, 231694231, 231694234, 3, 640x360 
0x12CB3460, 36963312832877432, 231694261, 231694264, 3, 640x360 
0x12CB3460, 36963312833199384, 231694301, 231694305, 4, 640x360 
0x12CB3460, 36963312833517896, 231694331, 231694333, 2, 640x360 
0x12CB3460, 36963312833997232, 231694373, 231694377, 4, 640x360 
0x12CB3460, 36963312834318144, 231694411, 231694414, 3, 640x360 
0x12CB3460, 36963312834639184, 231694440, 231694443, 3, 640x360 
0x12CB3460, 36963312834957904, 231694471, 231694473, 2, 640x360 
0x12CB3460, 36963312835278712, 231694501, 231694506, 5, 640x360 
0x12CB3460, 36963312835600432, 231694541, 231694545, 4, 640x360 
0x12CB3460, 36963312835917720, 231694570, 231694574, 4, 640x360 
0x12CB3460, 36963312836237944, 231694600, 231694602, 2, 640x360 
0x12CB3460, 36963312836558096, 231694631, 231694634, 3, 640x360 
0x12CB3460, 36963312836878024, 231694670, 231694673, 3, 640x360 
0x12CB3460, 36963312837199200, 231694700, 231694713, 13, 640x360 
0x12CB3460, 36963312837519560, 231694730, 231694742, 12, 640x360 
0x12CB3460, 36963312837997136, 231694780, 231694782, 2, 640x360 
0x12CB3460, 36963312838318752, 231694810, 231694813, 3, 640x360 
0x12CB3460, 36963312838638864, 231694840, 231694843, 3, 640x360 
0x12CB3460, 36963312838957680, 231694872, 231694875, 3, 640x360 
0x12CB3460, 36963312839277008, 231694911, 231694913, 2, 640x360 
0x12CB3460, 36963312839598776, 231694941, 231694944, 3, 640x360 
0x12CB3460, 36963312839917520, 231694971, 231694973, 2, 640x360 
0x12CB3460, 36963312840237024, 231695000, 231695005, 5, 640x360 
0x12CB3460, 36963312840557432, 231695031, 231695042, 11, 640x360 
0x12CB3460, 36963312840877848, 231695061, 231695065, 4, 640x360 
0x12CB3460, 36963312841199328, 231695100, 231695103, 3, 640x360 
0x12CB3460, 36963312841678792, 231695141, 231695155, 14, 640x360 
0x12CB3460, 36963312841996928, 231695180, 231695183, 3, 640x360 
0x12CB3460, 36963312842317312, 231695210, 231695213, 3, 640x360 
0x12CB3460, 36963312842637480, 231695241, 231695244, 3, 640x360 
0x12CB3460, 36963312842957624, 231695271, 231695274, 3, 640x360 
0x12CB3460, 36963312843277104, 231695302, 231695305, 3, 640x360 
0x12CB3460, 36963312843598552, 231695341, 231695344, 3, 640x360 
0x12CB3460, 36963312843954864, 231695373, 231695376, 3, 640x360 
0x12CB3460, 36963312844238040, 231695400, 231695403, 3, 640x360 
0x12CB3460, 36963312844557264, 231695431, 231695434, 3, 640x360 
0x12CB3460, 36963312844877744, 231695460, 231695464, 4, 640x360 
0x12CB3460, 36963312845198760, 231695500, 231695517, 17, 640x360 
0x12CB3460, 36963312845676848, 231695551, 231695554, 3, 640x360 
0x12CB3460, 36963312845998208, 231695580, 231695583, 3, 640x360 
0x12CB3460, 36963312846316984, 231695611, 231695614, 3, 640x360 
0x12CB3460, 36963312846637088, 231695640, 231695643, 3, 640x360 
0x12CB3460, 36963312846961632, 231695670, 231695673, 3, 640x360 
0x12CB3460, 36963312847277984, 231695710, 231695713, 3, 640x360 
0x12CB3460, 36963312847599856, 231695739, 231695742, 3, 640x360 
0x12CB3460, 36963312847918200, 231695770, 231695773, 3, 640x360 
0x12CB3460, 36963312848237256, 231695801, 231695804, 3, 640x360 
0x12CB3460, 36963312848558144, 231695830, 231695833, 3, 640x360 
0x12CB3460, 36963312848880392, 231695875, 231695878, 3, 640x360 
0x12CB3460, 36963312849200264, 231695900, 231695902, 2, 640x360 
0x12CB3460, 36963312849678344, 231695951, 231695953, 2, 640x360 
0x12CB3460, 36963312850000272, 231695980, 231695982, 2, 640x360 
0x12CB3460, 36963312850318328, 231696010, 231696013, 3, 640x360 
0x12CB3460, 36963312850637672, 231696040, 231696044, 4, 640x360 
0x12CB3460, 36963312850958472, 231696071, 231696073, 2, 640x360 
0x12CB3460, 36963312851278464, 231696101, 231696105, 4, 640x360 
0x12CB3460, 36963312851599464, 231696140, 231696146, 6, 640x360 
0x12CB3460, 36963312851917336, 231696169, 231696172, 3, 640x360 
0x12CB3460, 36963312852238992, 231696201, 231696203, 2, 640x360 
0x12CB3460, 36963312852558448, 231696230, 231696233, 3, 640x360 
0x12CB3460, 36963312852878544, 231696261, 231696265, 4, 640x360 
0x12CB3460, 36963312853359992, 231696311, 231696314, 3, 640x360 
0x12CB3460, 36963312853676568, 231696341, 231696345, 4, 640x360 
0x12CB3460, 36963312853997544, 231696375, 231696379, 4, 640x360 
0x12CB3460, 36963312854317112, 231696410, 231696413, 3, 640x360 
0x12CB3460, 36963312854637760, 231696442, 231696444, 2, 640x360 
0x12CB3460, 36963312854958032, 231696471, 231696474, 3, 640x360 
0x12CB3460, 36963312855278480, 231696502, 231696505, 3, 640x360 
0x12CB3460, 36963312855598168, 231696540, 231696544, 4, 640x360 
0x12CB3460, 36963312855917000, 231696570, 231696573, 3, 640x360 
0x12CB3460, 36963312856237088, 231696601, 231696603, 2, 640x360 
0x12CB3460, 36963312856558856, 231696630, 231696633, 3, 640x360 
0x12CB3460, 36963312856878480, 231696662, 231696666, 4, 640x360 
0x12CB3460, 36963312857360056, 231696711, 231696714, 3, 640x360 
0x12CB3460, 36963312857678664, 231696742, 231696745, 3, 640x360 
0x12CB3460, 36963312857998320, 231696780, 231696783, 3, 640x360 
0x12CB3460, 36963312858319640, 231696811, 231696814, 3, 640x360 
0x12CB3460, 36963312858638200, 231696841, 231696845, 4, 640x360 
0x12CB3460, 36963312858962072, 231696883, 231696886, 3, 640x360 
0x12CB3460, 36963312859278064, 231696910, 231696913, 3, 640x360 
0x12CB3460, 36963312859597544, 231696940, 231696943, 3, 640x360 
0x12CB3460, 36963312859919072, 231696971, 231696974, 3, 640x360 
0x12CB3460, 36963312860238664, 231697001, 231697003, 2, 640x360 
0x12CB3460, 36963312860558848, 231697031, 231697034, 3, 640x360 
0x12CB3460, 36963312860879480, 231697071, 231697074, 3, 640x360 
0x12CB3460, 36963312861358552, 231697111, 231697114, 3, 640x360 
0x12CB3460, 36963312861677264, 231697151, 231697153, 2, 640x360 
0x12CB3460, 36963312861997480, 231697180, 231697183, 3, 640x360 
0x12CB3460, 36963312862317896, 231697210, 231697213, 3, 640x360 
0x12CB3460, 36963312862637640, 231697240, 231697243, 3, 640x360 
0x12CB3460, 36963312862958464, 231697271, 231697274, 3, 640x360 
0x12CB3460, 36963312863277816, 231697301, 231697304, 3, 640x360 
0x12CB3460, 36963312863599360, 231697340, 231697344, 4, 640x360 
0x12CB3460, 36963312863918096, 231697381, 231697383, 2, 640x360 
0x12CB3460, 36963312864238208, 231697400, 231697403, 3, 640x360 
0x12CB3460, 36963312864559056, 231697431, 231697434, 3, 640x360 
0x12CB3460, 36963312865039768, 231697482, 231697485, 3, 640x360 
0x12CB3460, 36963312865360352, 231697512, 231697514, 2, 640x360 
0x12CB3460, 36963312865678712, 231697550, 231697553, 3, 640x360 
0x12CB3460, 36963312866001088, 231697580, 231697584, 4, 640x360 
0x12CB3460, 36963312866320576, 231697611, 231697614, 3, 640x360 
0x12CB3460, 36963312866641208, 231697642, 231697645, 3, 640x360 
0x12CB3460, 36963312866960440, 231697672, 231697675, 3, 640x360 
0x12CB3460, 36963312867277128, 231697700, 231697704, 4, 640x360 
0x12CB3460, 36963312867598752, 231697740, 231697743, 3, 640x360 
0x12CB3460, 36963312867917408, 231697771, 231697773, 2, 640x360 
0x12CB3460, 36963312868240144, 231697801, 231697803, 2, 640x360 
0x12CB3460, 36963312868560280, 231697830, 231697833, 3, 640x360 
0x12CB3460, 36963312869038560, 231697881, 231697883, 2, 640x360 
0x12CB3460, 36963312869358888, 231697911, 231697913, 2, 640x360 
0x12CB3460, 36963312869679384, 231697943, 231697946, 3, 640x360 
0x12CB3460, 36963312869998408, 231697980, 231697983, 3, 640x360 
0x12CB3460, 36963312870318720, 231698010, 231698014, 4, 640x360 
0x12CB3460, 36963312870637376, 231698040, 231698044, 4, 640x360 
0x12CB3460, 36963312870957208, 231698071, 231698074, 3, 640x360 
0x12CB3460, 36963312871276760, 231698101, 231698105, 4, 640x360 
0x12CB3460, 36963312871599648, 231698140, 231698143, 3, 640x360 
0x12CB3460, 36963312871919632, 231698171, 231698174, 3, 640x360 
0x12CB3460, 36963312872238520, 231698200, 231698203, 3, 640x360 
0x12CB3460, 36963312872560336, 231698231, 231698234, 3, 640x360 
0x12CB3460, 36963312873039152, 231698280, 231698283, 3, 640x360 
0x12CB3460, 36963312873358400, 231698311, 231698314, 3, 640x360 
0x12CB3460, 36963312873677232, 231698341, 231698345, 4, 640x360 
0x12CB3460, 36963312873997536, 231698383, 231698387, 4, 640x360 
0x12CB3460, 36963312874317952, 231698410, 231698413, 3, 640x360 
0x12CB3460, 36963312874637624, 231698441, 231698444, 3, 640x360 
0x12CB3460, 36963312874957640, 231698471, 231698474, 3, 640x360 
0x12CB3460, 36963312875278448, 231698501, 231698505, 4, 640x360 
0x12CB3460, 36963312875599144, 231698541, 231698544, 3, 640x360 
0x12CB3460, 36963312875918768, 231698570, 231698574, 4, 640x360 
0x12CB3460, 36963312876240120, 231698601, 231698605, 4, 640x360 
0x12CB3460, 36963312876721680, 231698652, 231698655, 3, 640x360 
0x12CB3460, 36963312877036760, 231698681, 231698683, 2, 640x360 
0x12CB3460, 36963312877358408, 231698710, 231698714, 4, 640x360 
0x12CB3460, 36963312877677072, 231698741, 231698745, 4, 640x360 
0x12CB3460, 36963312877999312, 231698780, 231698783, 3, 640x360 
0x12CB3460, 36963312878317312, 231698811, 231698813, 2, 640x360 
0x12CB3460, 36963312878637736, 231698840, 231698843, 3, 640x360 
0x12CB3460, 36963312878958504, 231698872, 231698875, 3, 640x360 
0x12CB3460, 36963312879277768, 231698901, 231698904, 3, 640x360 
0x12CB3460, 36963312879598736, 231698940, 231698958, 18, 640x360 
0x12CB3460, 36963312879919104, 231698971, 231698974, 3, 640x360 
0x12CB3460, 36963312880237240, 231699001, 231699003, 2, 640x360 
0x12CB3460, 36963312880717728, 231699050, 231699053, 3, 640x360 
0x12CB3460, 36963312881038488, 231699081, 231699083, 2, 640x360 
0x12CB3460, 36963312881358688, 231699110, 231699113, 3, 640x360 
0x12CB3460, 36963312881678944, 231699141, 231699145, 4, 640x360 
0x12CB3460, 36963312881998264, 231699181, 231699184, 3, 640x360 
0x12CB3460, 36963312882318880, 231699210, 231699213, 3, 640x360 
0x12CB3460, 36963312882638560, 231699240, 231699244, 4, 640x360 
0x12CB3460, 36963312882958120, 231699271, 231699273, 2, 640x360 
0x12CB3460, 36963312883277448, 231699310, 231699313, 3, 640x360 
0x12CB3460, 36963312883598920, 231699341, 231699344, 3, 640x360 
0x12CB3460, 36963312883917664, 231699373, 231699377, 4, 640x360 
0x12CB3460, 36963312884398432, 231699420, 231699423, 3, 640x360 
0x12CB3460, 36963312884717160, 231699451, 231699454, 3, 640x360 
0x12CB3460, 36963312885037000, 231699480, 231699484, 4, 640x360 
0x12CB3460, 36963312885357232, 231699510, 231699513, 3, 640x360 
0x12CB3460, 36963312885680128, 231699551, 231699554, 3, 640x360 
0x12CB3460, 36963312885999896, 231699581, 231699585, 4, 640x360 
0x12CB3460, 36963312886319288, 231699610, 231699613, 3, 640x360 
0x12CB3460, 36963312886637528, 231699640, 231699644, 4, 640x360 
0x12CB3460, 36963312886957416, 231699671, 231699674, 3, 640x360 
0x12CB3460, 36963312887277632, 231699710, 231699713, 3, 640x360 
0x12CB3460, 36963312887597664, 231699740, 231699742, 2, 640x360 
0x12CB3460, 36963312887917080, 231699771, 231699773, 2, 640x360 
0x12CB3460, 36963312888398864, 231699820, 231699823, 3, 640x360 
0x12CB3460, 36963312888718824, 231699851, 231699854, 3, 640x360 
0x12CB3460, 36963312889038568, 231699878, 231699882, 4, 640x360 
0x12CB3460, 36963312889357952, 231699910, 231699913, 3, 640x360 
0x12CB3460, 36963312889678608, 231699942, 231699945, 3, 640x360 
0x12CB3460, 36963312889999024, 231699980, 231699983, 3, 640x360 
0x12CB3460, 36963312890317944, 231700011, 231700014, 3, 640x360 
0x12CB3460, 36963312890636664, 231700041, 231700044, 3, 640x360 
0x12CB3460, 36963312890958136, 231700071, 231700074, 3, 640x360 
0x12CB3460, 36963312891277168, 231700101, 231700105, 4, 640x360 
0x12CB3460, 36963312891598520, 231700140, 231700143, 3, 640x360 
0x12CB3460, 36963312891918488, 231700171, 231700174, 3, 640x360 
0x12CB3460, 36963312892397496, 231700221, 231700224, 3, 640x360 
0x12CB3460, 36963312892720544, 231700250, 231700253, 3, 640x360 
0x12CB3460, 36963312893036648, 231700280, 231700283, 3, 640x360 
0x12CB3460, 36963312893357048, 231700311, 231700314, 3, 640x360 
0x12CB3460, 36963312893678056, 231700370, 231700374, 4, 640x360 
0x12CB3460, 36963312893999496, 231700381, 231700387, 6, 640x360 
0x12CB3460, 36963312894318152, 231700410, 231700413, 3, 640x360 
0x12CB3460, 36963312894637672, 231700441, 231700459, 18, 640x360 
0x12CB3460, 36963312894956888, 231700471, 231700473, 2, 640x360 
0x12CB3460, 36963312895276920, 231700501, 231700504, 3, 640x360 
0x12CB3460, 36963312895599032, 231700540, 231700544, 4, 640x360 
0x12CB3460, 36963312896079208, 231700581, 231700585, 4, 640x360 
0x12CB3460, 36963312896397792, 231700621, 231700624, 3, 640x360 
0x12CB3460, 36963312896721400, 231700651, 231700654, 3, 640x360 
0x12CB3460, 36963312897036656, 231700680, 231700693, 13, 640x360 
0x12CB3460, 36963312897358384, 231700710, 231700713, 3, 640x360 
0x12CB3460, 36963312897677480, 231700741, 231700745, 4, 640x360 
0x12CB3460, 36963312897998632, 231700781, 231700783, 2, 640x360 
0x12CB3460, 36963312898318856, 231700810, 231700813, 3, 640x360 
0x12CB3460, 36963312898638152, 231700841, 231700845, 4, 640x360 
0x12CB3460, 36963312898957896, 231700880, 231700883, 3, 640x360 
0x12CB3460, 36963312899278600, 231700911, 231700913, 2, 640x360 
0x12CB3460, 36963312899598616, 231700941, 231700944, 3, 640x360 
0x12CB3460, 36963312900077336, 231700991, 231700995, 4, 640x360 
0x12CB3460, 36963312900397672, 231701020, 231701023, 3, 640x360 
0x12CB3460, 36963312900719168, 231701050, 231701053, 3, 640x360 
0x12CB3460, 36963312901039424, 231701080, 231701083, 3, 640x360 
0x12CB3460, 36963312901356616, 231701110, 231701113, 3, 640x360 
0x12CB3460, 36963312901678288, 231701141, 231701145, 4, 640x360 
0x12CB3460, 36963312901998072, 231701181, 231701184, 3, 640x360 
0x12CB3460, 36963312902317032, 231701210, 231701213, 3, 640x360 
0x12CB3460, 36963312902637232, 231701240, 231701244, 4, 640x360 
0x12CB3460, 36963312902958304, 231701270, 231701273, 3, 640x360 
0x12CB3460, 36963312903279224, 231701311, 231701314, 3, 640x360 
0x12CB3460, 36963312903599464, 231701341, 231701345, 4, 640x360 
0x12CB3460, 36963312904076640, 231701382, 231701385, 3, 640x360 
0x12CB3460, 36963312904398504, 231701420, 231701423, 3, 640x360 
0x12CB3460, 36963312904719264, 231701450, 231701453, 3, 640x360 
0x12CB3460, 36963312905037600, 231701481, 231701484, 3, 640x360 
0x12CB3460, 36963312905360072, 231701510, 231701514, 4, 640x360 
0x12CB3460, 36963312905679032, 231701551, 231701554, 3, 640x360 
0x12CB3460, 36963312905999776, 231701581, 231701585, 4, 640x360 
0x12CB3460, 36963312906320624, 231701611, 231701618, 7, 640x360 
0x12CB3460, 36963312906638488, 231701641, 231701644, 3, 640x360 
0x12CB3460, 36963312906959320, 231701670, 231701674, 4, 640x360 
0x12CB3460, 36963312907277520, 231701701, 231701705, 4, 640x360 
0x12CB3460, 36963312907758032, 231701750, 231701752, 2, 640x360 
0x12CB3460, 36963312908078528, 231701781, 231701785, 4, 640x360 
0x12CB3460, 36963312908397744, 231701821, 231701831, 10, 640x360 
0x12CB3460, 36963312908719344, 231701875, 231701878, 3, 640x360 
0x12CB3460, 36963312909038312, 231701880, 231701893, 13, 640x360 
0x12CB3460, 36963312909356648, 231701911, 231701914, 3, 640x360 
0x12CB3460, 36963312909677392, 231701941, 231701945, 4, 640x360 
0x12CB3460, 36963312909999664, 231701980, 231701983, 3, 640x360 
0x12CB3460, 36963312910318944, 231702011, 231702014, 3, 640x360 
0x12CB3460, 36963312910638120, 231702040, 231702044, 4, 640x360 
0x12CB3460, 36963312910957600, 231702070, 231702073, 3, 640x360 
0x12CB3460, 36963312911278336, 231702111, 231702114, 3, 640x360 
0x12CB3460, 36963312911759496, 231702152, 231702154, 2, 640x360 
0x12CB3460, 36963312912078672, 231702191, 231702195, 4, 640x360 
0x12CB3460, 36963312912397424, 231702221, 231702224, 3, 640x360 
0x12CB3460, 36963312912716904, 231702250, 231702253, 3, 640x360 
0x12CB3460, 36963312913037864, 231702281, 231702284, 3, 640x360 
0x12CB3460, 36963312913357784, 231702310, 231702313, 3, 640x360 
0x12CB3460, 36963312913677064, 231702341, 231702346, 5, 640x360 
0x12CB3460, 36963312913998208, 231702380, 231702383, 3, 640x360 
0x12CB3460, 36963312914317520, 231702410, 231702413, 3, 640x360 
0x12CB3460, 36963312914637264, 231702440, 231702443, 3, 640x360 
0x12CB3460, 36963312914959400, 231702471, 231702474, 3, 640x360 
0x12CB3460, 36963312915437896, 231702520, 231702523, 3, 640x360 
0x12CB3460, 36963312915758552, 231702550, 231702553, 3, 640x360 
0x12CB3460, 36963312916079184, 231702591, 231702595, 4, 640x360 
0x12CB3460, 36963312916400136, 231702623, 231702627, 4, 640x360 
0x12CB3460, 36963312916719800, 231702652, 231702656, 4, 640x360 
0x12CB3460, 36963312917038176, 231702680, 231702683, 3, 640x360 
0x12CB3460, 36963312917359800, 231702711, 231702714, 3, 640x360 
0x12CB3460, 36963312917677776, 231702741, 231702744, 3, 640x360 
0x12CB3460, 36963312917998192, 231702781, 231702784, 3, 640x360 
0x12CB3460, 36963312918317648, 231702811, 231702814, 3, 640x360 
0x12CB3460, 36963312918637568, 231702841, 231702845, 4, 640x360 
0x12CB3460, 36963312918958368, 231702878, 231702881, 3, 640x360 
0x12CB3460, 36963312919439024, 231702920, 231702923, 3, 640x360 
0x12CB3460, 36963312919757456, 231702951, 231702955, 4, 640x360 
0x12CB3460, 36963312920077608, 231702991, 231702995, 4, 640x360 
0x12CB3460, 36963312920399464, 231703020, 231703024, 4, 640x360 
0x12CB3460, 36963312920722952, 231703051, 231703054, 3, 640x360 
0x12CB3460, 36963312921037080, 231703080, 231703083, 3, 640x360 
0x12CB3460, 36963312921356832, 231703111, 231703114, 3, 640x360 
0x12CB3460, 36963312921677616, 231703141, 231703145, 4, 640x360 
0x12CB3460, 36963312921997328, 231703180, 231703183, 3, 640x360 
0x12CB3460, 36963312922318440, 231703210, 231703213, 3, 640x360 
0x12CB3460, 36963312922638704, 231703240, 231703244, 4, 640x360 
0x12CB3460, 36963312922959392, 231703272, 231703275, 3, 640x360 
0x12CB3460, 36963312923437488, 231703320, 231703322, 2, 640x360 
0x12CB3460, 36963312923758048, 231703375, 231703377, 2, 640x360 
0x12CB3460, 36963312924076984, 231703381, 231703384, 3, 640x360 
0x12CB3460, 36963312924398368, 231703420, 231703423, 3, 640x360 
0x12CB3460, 36963312924718784, 231703449, 231703453, 4, 640x360 
0x12CB3460, 36963312925038200, 231703481, 231703485, 4, 640x360 
0x12CB3460, 36963312925358376, 231703510, 231703513, 3, 640x360 
0x12CB3460, 36963312925678544, 231703550, 231703553, 3, 640x360 
0x12CB3460, 36963312925998680, 231703581, 231703584, 3, 640x360 
0x12CB3460, 36963312926319464, 231703611, 231703614, 3, 640x360 
0x12CB3460, 36963312926640072, 231703641, 231703644, 3, 640x360 
0x12CB3460, 36963312927118656, 231703691, 231703694, 3, 640x360 
0x12CB3460, 36963312927437392, 231703721, 231703724, 3, 640x360 
0x12CB3460, 36963312927757480, 231703751, 231703754, 3, 640x360 
0x12CB3460, 36963312928078296, 231703791, 231703794, 3, 640x360 
0x12CB3460, 36963312928399416, 231703821, 231703824, 3, 640x360 
0x12CB3460, 36963312928719544, 231703883, 231703886, 3, 640x360 
0x12CB3460, 36963312929357656, 231703910, 231703913, 3, 640x360 
0x12CB3460, 36963312929680792, 231703950, 231703953, 3, 640x360 
0x12CB3460, 36963312929997344, 231703980, 231703983, 3, 640x360 
0x12CB3460, 36963312930317640, 231704011, 231704014, 3, 640x360 
0x12CB3460, 36963312930639120, 231704041, 231704045, 4, 640x360 
0x12CB3460, 36963312931117408, 231704091, 231704094, 3, 640x360 
0x12CB3460, 36963312931436752, 231704121, 231704124, 3, 640x360 
0x12CB3460, 36963312931759200, 231704150, 231704153, 3, 640x360 
0x12CB3460, 36963312932077208, 231704182, 231704186, 4, 640x360 
0x12CB3460, 36963312932397272, 231704221, 231704224, 3, 640x360 
0x12CB3460, 36963312932717888, 231704250, 231704252, 2, 640x360 
0x12CB3460, 36963312933037816, 231704281, 231704283, 2, 640x360 
0x12CB3460, 36963312933356640, 231704310, 231704313, 3, 640x360 
0x12CB3460, 36963312933678144, 231704350, 231704353, 3, 640x360 
0x12CB3460, 36963312933997480, 231704383, 231704387, 4, 640x360 
0x12CB3460, 36963312934316744, 231704411, 231704414, 3, 640x360 
0x12CB3460, 36963312934636880, 231704440, 231704443, 3, 640x360 
0x12CB3460, 36963312935118416, 231704491, 231704494, 3, 640x360 
0x12CB3460, 36963312935439088, 231704520, 231704523, 3, 640x360 
0x12CB3460, 36963312935757296, 231704551, 231704554, 3, 640x360 
0x12CB3460, 36963312936077928, 231704590, 231704594, 4, 640x360 
0x12CB3460, 36963312936399424, 231704620, 231704623, 3, 640x360 
0x12CB3460, 36963312936718360, 231704650, 231704654, 4, 640x360 
0x12CB3460, 36963312937038016, 231704680, 231704683, 3, 640x360 
0x12CB3460, 36963312937357888, 231704710, 231704713, 3, 640x360 
0x12CB3460, 36963312937677624, 231704742, 231704746, 4, 640x360 
0x12CB3460, 36963312937997976, 231704780, 231704783, 3, 640x360 
0x12CB3460, 36963312938317664, 231704810, 231704813, 3, 640x360 
0x12CB3460, 36963312938796656, 231704876, 231704879, 3, 640x360 
0x12CB3460, 36963312939116536, 231704890, 231704893, 3, 640x360 
0x12CB3460, 36963312939438104, 231704920, 231704938, 18, 640x360 
0x12CB3460, 36963312939759064, 231704950, 231704953, 3, 640x360 
0x12CB3460, 36963312940078328, 231704981, 231704985, 4, 640x360 
0x12CB3460, 36963312940398440, 231705020, 231705023, 3, 640x360 
0x12CB3460, 36963312940717712, 231705050, 231705053, 3, 640x360 
0x12CB3460, 36963312941037568, 231705080, 231705083, 3, 640x360 
0x12CB3460, 36963312941356456, 231705110, 231705113, 3, 640x360 
0x12CB3460, 36963312941677472, 231705141, 231705145, 4, 640x360 
0x12CB3460, 36963312941998296, 231705180, 231705182, 2, 640x360 
0x12CB3460, 36963312942318128, 231705210, 231705214, 4, 640x360 
0x12CB3460, 36963312942797112, 231705260, 231705263, 3, 640x360 
0x12CB3460, 36963312943117120, 231705289, 231705293, 4, 640x360 
0x12CB3460, 36963312943440416, 231705322, 231705326, 4, 640x360 
0x12CB3460, 36963312943757960, 231705374, 231705377, 3, 640x360 
0x12CB3460, 36963312944078104, 231705390, 231705394, 4, 640x360 
0x12CB3460, 36963312944397432, 231705421, 231705423, 2, 640x360 
0x12CB3460, 36963312944718344, 231705450, 231705455, 5, 640x360 
0x12CB3460, 36963312945039752, 231705481, 231705484, 3, 640x360 
0x12CB3460, 36963312945356952, 231705510, 231705513, 3, 640x360 
0x12CB3460, 36963312945676872, 231705551, 231705553, 2, 640x360 
0x12CB3460, 36963312945997744, 231705580, 231705583, 3, 640x360 
0x12CB3460, 36963312946320352, 231705610, 231705613, 3, 640x360 
0x12CB3460, 36963312946800576, 231705663, 231705666, 3, 640x360 
0x12CB3460, 36963312947118120, 231705690, 231705693, 3, 640x360 
0x12CB3460, 36963312947436960, 231705720, 231705723, 3, 640x360 
0x12CB3460, 36963312947757536, 231705751, 231705754, 3, 640x360 
0x12CB3460, 36963312948078032, 231705790, 231705793, 3, 640x360 
0x12CB3460, 36963312948399872, 231705822, 231705825, 3, 640x360 
0x12CB3460, 36963312948719296, 231705850, 231705853, 3, 640x360 
0x12CB3460, 36963312949038040, 231705886, 231705889, 3, 640x360 
0x12CB3460, 36963312949357112, 231705911, 231705914, 3, 640x360 
0x12CB3460, 36963312949678072, 231705951, 231705954, 3, 640x360 
0x12CB3460, 36963312949998920, 231705973, 231705977, 4, 640x360 
0x12CB3460, 36963312950479392, 231706030, 231706033, 3, 640x360 
0x12CB3460, 36963312950797384, 231706061, 231706064, 3, 640x360 
0x12CB3460, 36963312951117856, 231706090, 231706093, 3, 640x360 
0x12CB3460, 36963312951436872, 231706120, 231706122, 2, 640x360 
0x12CB3460, 36963312951758840, 231706151, 231706155, 4, 640x360 
0x12CB3460, 36963312952077928, 231706191, 231706195, 4, 640x360 
0x12CB3460, 36963312952397256, 231706220, 231706223, 3, 640x360 
0x12CB3460, 36963312952717480, 231706249, 231706252, 3, 640x360 
0x12CB3460, 36963312953036488, 231706280, 231706283, 3, 640x360 
0x12CB3460, 36963312953357816, 231706311, 231706314, 3, 640x360 
0x12CB3460, 36963312953678392, 231706341, 231706345, 4, 640x360 
0x12CB3460, 36963312953997752, 231706380, 231706383, 3, 640x360 
0x12CB3460, 36963312954477480, 231706420, 231706424, 4, 640x360 
0x12CB3460, 36963312954798120, 231706460, 231706463, 3, 640x360 
0x12CB3460, 36963312955117752, 231706490, 231706493, 3, 640x360 
0x12CB3460, 36963312955436672, 231706520, 231706523, 3, 640x360 
0x12CB3460, 36963312955758584, 231706551, 231706554, 3, 640x360 
0x12CB3460, 36963312956079328, 231706589, 231706593, 4, 640x360 
0x12CB3460, 36963312956399176, 231706621, 231706624, 3, 640x360 
0x12CB3460, 36963312956720552, 231706651, 231706654, 3, 640x360 
0x12CB3460, 36963312957037576, 231706680, 231706683, 3, 640x360 
0x12CB3460, 36963312957357616, 231706711, 231706714, 3, 640x360 
0x12CB3460, 36963312957679680, 231706749, 231706752, 3, 640x360 
0x12CB3460, 36963312958156464, 231706791, 231706795, 4, 640x360 
0x12CB3460, 36963312958478472, 231706831, 231706836, 5, 640x360 
0x12CB3460, 36963312958797376, 231706875, 231706878, 3, 640x360 
0x12CB3460, 36963312959117224, 231706891, 231706894, 3, 640x360 
0x12CB3460, 36963312959436640, 231706920, 231706922, 2, 640x360 
0x12CB3460, 36963312959758824, 231706951, 231706955, 4, 640x360 
0x12CB3460, 36963312960077336, 231706990, 231706994, 4, 640x360 
0x12CB3460, 36963312960397184, 231707020, 231707023, 3, 640x360 
0x12CB3460, 36963312960716936, 231707051, 231707054, 3, 640x360 
0x12CB3460, 36963312961036280, 231707080, 231707083, 3, 640x360 
0x12CB3460, 36963312961357784, 231707112, 231707114, 2, 640x360 
0x12CB3460, 36963312961678400, 231707141, 231707145, 4, 640x360 
0x12CB3460, 36963312962159008, 231707191, 231707194, 3, 640x360 
0x12CB3460, 36963312962477816, 231707223, 231707227, 4, 640x360 
0x12CB3460, 36963312962798272, 231707260, 231707263, 3, 640x360 
0x12CB3460, 36963312963118616, 231707290, 231707294, 4, 640x360 
0x12CB3460, 36963312963439472, 231707322, 231707325, 3, 640x360 
0x12CB3460, 36963312963758576, 231707351, 231707354, 3, 640x360 
0x12CB3460, 36963312964078832, 231707390, 231707394, 4, 640x360 
0x12CB3460, 36963312964397008, 231707420, 231707422, 2, 640x360 
0x12CB3460, 36963312964717736, 231707451, 231707455, 4, 640x360 
0x12CB3460, 36963312965038408, 231707480, 231707483, 3, 640x360 
0x12CB3460, 36963312965359168, 231707511, 231707514, 3, 640x360 
0x12CB3460, 36963312965678520, 231707550, 231707553, 3, 640x360 
0x12CB3460, 36963312966159136, 231707590, 231707594, 4, 640x360 
0x12CB3460, 36963312966477584, 231707622, 231707626, 4, 640x360 
0x12CB3460, 36963312966800232, 231707660, 231707663, 3, 640x360 
0x12CB3460, 36963312967118016, 231707691, 231707695, 4, 640x360 
0x12CB3460, 36963312967436552, 231707721, 231707724, 3, 640x360 
0x12CB3460, 36963312967756616, 231707751, 231707768, 17, 640x360 
0x12CB3460, 36963312968078392, 231707781, 231707785, 4, 640x360 
0x12CB3460, 36963312968397624, 231707820, 231707823, 3, 640x360 
0x12CB3460, 36963312968718504, 231707850, 231707854, 4, 640x360 
0x12CB3460, 36963312969037392, 231707881, 231707884, 3, 640x360 
0x12CB3460, 36963312969356544, 231707910, 231707913, 3, 640x360 
0x12CB3460, 36963312969839328, 231707961, 231707964, 3, 640x360 
0x12CB3460, 36963312970156088, 231707991, 231707994, 3, 640x360 
0x12CB3460, 36963312970478448, 231708030, 231708033, 3, 640x360 
0x12CB3460, 36963312970798856, 231708060, 231708063, 3, 640x360 
0x12CB3460, 36963312971117352, 231708090, 231708093, 3, 640x360 
0x12CB3460, 36963312971436760, 231708120, 231708123, 3, 640x360 
0x12CB3460, 36963312971758224, 231708150, 231708153, 3, 640x360 
0x12CB3460, 36963312972077256, 231708190, 231708194, 4, 640x360 
0x12CB3460, 36963312972398608, 231708220, 231708222, 2, 640x360 
0x12CB3460, 36963312972716768, 231708250, 231708253, 3, 640x360 
0x12CB3460, 36963312973039928, 231708280, 231708283, 3, 640x360 
0x12CB3460, 36963312973357344, 231708310, 231708313, 3, 640x360 
0x12CB3460, 36963312973835880, 231708377, 231708381, 4, 640x360 
0x12CB3460, 36963312974158344, 231708390, 231708393, 3, 640x360 
0x12CB3460, 36963312974477696, 231708421, 231708424, 3, 640x360 
0x12CB3460, 36963312974798064, 231708461, 231708463, 2, 640x360 
0x12CB3460, 36963312975118136, 231708491, 231708494, 3, 640x360 
0x12CB3460, 36963312975437264, 231708520, 231708523, 3, 640x360 
0x12CB3460, 36963312975759520, 231708552, 231708555, 3, 640x360 
0x12CB3460, 36963312976080336, 231708589, 231708592, 3, 640x360 
0x12CB3460, 36963312976396888, 231708620, 231708623, 3, 640x360 
0x12CB3460, 36963312976717288, 231708649, 231708654, 5, 640x360 
0x12CB3460, 36963312977040176, 231708681, 231708684, 3, 640x360 
0x12CB3460, 36963312977356480, 231708711, 231708713, 2, 640x360 
0x12CB3460, 36963312977837872, 231708760, 231708763, 3, 640x360 
0x12CB3460, 36963312978158480, 231708791, 231708794, 3, 640x360 
0x12CB3460, 36963312978480296, 231708830, 231708833, 3, 640x360 
0x12CB3460, 36963312978797344, 231708889, 231708893, 4, 640x360 
0x12CB3460, 36963312979436256, 231708920, 231708922, 2, 640x360 
0x12CB3460, 36963312979761008, 231708952, 231708955, 3, 640x360 
0x12CB3460, 36963312980076984, 231708990, 231708994, 4, 640x360 
0x12CB3460, 36963312980399688, 231709020, 231709025, 5, 640x360 
0x12CB3460, 36963312980720984, 231709050, 231709053, 3, 640x360 
0x12CB3460, 36963312981037104, 231709080, 231709082, 2, 640x360 
0x12CB3460, 36963312981516048, 231709131, 231709134, 3, 640x360 
0x12CB3460, 36963312981836504, 231709160, 231709163, 3, 640x360 
0x12CB3460, 36963312982159496, 231709190, 231709194, 4, 640x360 
0x12CB3460, 36963312982478144, 231709230, 231709234, 4, 640x360 
0x12CB3460, 36963312982797968, 231709260, 231709263, 3, 640x360 
0x12CB3460, 36963312983117688, 231709290, 231709293, 3, 640x360 
0x12CB3460, 36963312983437544, 231709321, 231709324, 3, 640x360 
0x12CB3460, 36963312983757440, 231709350, 231709354, 4, 640x360 
0x12CB3460, 36963312984076896, 231709381, 231709384, 3, 640x360 
0x12CB3460, 36963312984397776, 231709420, 231709423, 3, 640x360 
0x12CB3460, 36963312984718200, 231709450, 231709455, 5, 640x360 
0x12CB3460, 36963312985039144, 231709481, 231709484, 3, 640x360 
0x12CB3460, 36963312985519552, 231709531, 231709534, 3, 640x360 
0x12CB3460, 36963312985838664, 231709561, 231709565, 4, 640x360 
0x12CB3460, 36963312986157904, 231709591, 231709596, 5, 640x360 
0x12CB3460, 36963312986479152, 231709630, 231709635, 5, 640x360 
0x12CB3460, 36963312986799064, 231709661, 231709664, 3, 640x360 
0x12CB3460, 36963312987120656, 231709690, 231709695, 5, 640x360 
0x12CB3460, 36963312987437784, 231709720, 231709723, 3, 640x360 
0x12CB3460, 36963312987756712, 231709750, 231709753, 3, 640x360 
0x12CB3460, 36963312988077648, 231709781, 231709785, 4, 640x360 
0x12CB3460, 36963312988397296, 231709820, 231709823, 3, 640x360 
0x12CB3460, 36963312988717224, 231709865, 231709868, 3, 640x360 
0x12CB3460, 36963312989040008, 231709880, 231709883, 3, 640x360 
0x12CB3460, 36963312989517688, 231709931, 231709933, 2, 640x360 
0x12CB3460, 36963312989838928, 231709961, 231709964, 3, 640x360 
0x12CB3460, 36963312990158960, 231709991, 231709994, 3, 640x360 
0x12CB3460, 36963312990477568, 231710022, 231710026, 4, 640x360 
0x12CB3460, 36963312990796824, 231710060, 231710063, 3, 640x360 
0x12CB3460, 36963312991116120, 231710090, 231710093, 3, 640x360 
0x12CB3460, 36963312991436408, 231710120, 231710123, 3, 640x360 
0x12CB3460, 36963312991756560, 231710150, 231710153, 3, 640x360 
0x12CB3460, 36963312992078824, 231710182, 231710186, 4, 640x360 
0x12CB3460, 36963312992397656, 231710221, 231710224, 3, 640x360 
0x12CB3460, 36963312992719656, 231710250, 231710253, 3, 640x360 
0x12CB3460, 36963312993197712, 231710300, 231710303, 3, 640x360 
0x12CB3460, 36963312993516504, 231710330, 231710334, 4, 640x360 
0x12CB3460, 36963312993835848, 231710378, 231710380, 2, 640x360 
0x12CB3460, 36963312994157240, 231710390, 231710409, 19, 640x360 
0x12CB3460, 36963312994476360, 231710420, 231710424, 4, 640x360 
0x12CB3460, 36963312994798056, 231710460, 231710463, 3, 640x360 
0x12CB3460, 36963312995117680, 231710490, 231710493, 3, 640x360 
0x12CB3460, 36963312995436752, 231710520, 231710523, 3, 640x360 
0x12CB3460, 36963312995757128, 231710551, 231710554, 3, 640x360 
0x12CB3460, 36963312996077488, 231710580, 231710584, 4, 640x360 
0x12CB3460, 36963312996398672, 231710620, 231710622, 2, 640x360 
0x12CB3460, 36963312996718584, 231710650, 231710653, 3, 640x360 
0x12CB3460, 36963312997201032, 231710701, 231710704, 3, 640x360 
0x12CB3460, 36963312997518504, 231710730, 231710733, 3, 640x360 
0x12CB3460, 36963312997836280, 231710760, 231710762, 2, 640x360 
0x12CB3460, 36963312998158464, 231710791, 231710794, 3, 640x360 
0x12CB3460, 36963312998479624, 231710822, 231710825, 3, 640x360 
0x12CB3460, 36963312998799944, 231710877, 231710880, 3, 640x360 
0x12CB3460, 36963312999116824, 231710891, 231710894, 3, 640x360 
0x12CB3460, 36963312999437360, 231710920, 231710923, 3, 640x360 
0x12CB3460, 36963312999758152, 231710951, 231710954, 3, 640x360 
0x12CB3460, 36963313000077416, 231710981, 231710993, 12, 640x360 
0x12CB3460, 36963313000397376, 231711019, 231711022, 3, 640x360 
0x12CB3460, 36963313000879312, 231711071, 231711073, 2, 640x360 
0x12CB3460, 36963313001197480, 231711100, 231711103, 3, 640x360 
0x12CB3460, 36963313001515744, 231711131, 231711133, 2, 640x360 
0x12CB3460, 36963313001837696, 231711160, 231711168, 8, 640x360 
0x12CB3460, 36963313002158200, 231711192, 231711195, 3, 640x360 
0x12CB3460, 36963313002476112, 231711230, 231711233, 3, 640x360 
0x12CB3460, 36963313002796608, 231711260, 231711262, 2, 640x360 
0x12CB3460, 36963313003119104, 231711290, 231711293, 3, 640x360 
0x12CB3460, 36963313003436064, 231711320, 231711323, 3, 640x360 
0x12CB3460, 36963313003757552, 231711373, 231711376, 3, 640x360 
0x12CB3460, 36963313004076136, 231711381, 231711384, 3, 640x360 
0x12CB3460, 36963313004398008, 231711420, 231711422, 2, 640x360 
0x12CB3460, 36963313004876744, 231711471, 231711474, 3, 640x360 
0x12CB3460, 36963313005197136, 231711500, 231711503, 3, 640x360 
0x12CB3460, 36963313005519360, 231711530, 231711535, 5, 640x360 
0x12CB3460, 36963313005838760, 231711560, 231711562, 2, 640x360 
0x12CB3460, 36963313006158408, 231711590, 231711594, 4, 640x360 
0x12CB3460, 36963313006477616, 231711632, 231711635, 3, 640x360 
0x12CB3460, 36963313006796984, 231711660, 231711663, 3, 640x360 
0x12CB3460, 36963313007117712, 231711689, 231711693, 4, 640x360 
0x12CB3460, 36963313007435968, 231711720, 231711723, 3, 640x360 
0x12CB3460, 36963313007756744, 231711750, 231711752, 2, 640x360 
0x12CB3460, 36963313008077880, 231711781, 231711784, 3, 640x360 
0x12CB3460, 36963313008397736, 231711821, 231711824, 3, 640x360 
0x12CB3460, 36963313008876960, 231711891, 231711895, 4, 640x360 
0x12CB3460, 36963313009198296, 231711900, 231711903, 3, 640x360 
0x12CB3460, 36963313009517440, 231711930, 231711932, 2, 640x360 
0x12CB3460, 36963313009838464, 231711960, 231711963, 3, 640x360 
0x12CB3460, 36963313010157120, 231711991, 231712010, 19, 640x360 
0x12CB3460, 36963313010477224, 231712021, 231712025, 4, 640x360 
0x12CB3460, 36963313010799336, 231712060, 231712063, 3, 640x360 
0x12CB3460, 36963313011116168, 231712090, 231712093, 3, 640x360 
0x12CB3460, 36963313011437464, 231712120, 231712123, 3, 640x360 
0x12CB3460, 36963313011758344, 231712150, 231712153, 3, 640x360 
0x12CB3460, 36963313012078872, 231712184, 231712187, 3, 640x360 
0x12CB3460, 36963313012557880, 231712231, 231712234, 3, 640x360 
0x12CB3460, 36963313012877304, 231712261, 231712264, 3, 640x360 
0x12CB3460, 36963313013197904, 231712300, 231712303, 3, 640x360 
0x12CB3460, 36963313013518384, 231712330, 231712332, 2, 640x360 
0x12CB3460, 36963313013840832, 231712371, 231712374, 3, 640x360 
0x12CB3460, 36963313014157216, 231712390, 231712393, 3, 640x360 
0x12CB3460, 36963313014477240, 231712421, 231712425, 4, 640x360 
0x12CB3460, 36963313014797832, 231712461, 231712464, 3, 640x360 
0x12CB3460, 36963313015116224, 231712489, 231712492, 3, 640x360 
0x12CB3460, 36963313015437256, 231712520, 231712523, 3, 640x360 
0x12CB3460, 36963313015757624, 231712549, 231712553, 4, 640x360 
0x12CB3460, 36963313016078568, 231712591, 231712594, 3, 640x360 
0x12CB3460, 36963313016557400, 231712630, 231712634, 4, 640x360 
0x12CB3460, 36963313016878144, 231712671, 231712674, 3, 640x360 
0x12CB3460, 36963313017198016, 231712700, 231712703, 3, 640x360 
0x12CB3460, 36963313017517560, 231712730, 231712733, 3, 640x360 
0x12CB3460, 36963313017836952, 231712760, 231712762, 2, 640x360 
0x12CB3460, 36963313018157832, 231712791, 231712794, 3, 640x360 
0x12CB3460, 36963313018478888, 231712822, 231712825, 3, 640x360 
0x12CB3460, 36963313018797640, 231712874, 231712877, 3, 640x360 
0x12CB3460, 36963313019115992, 231712891, 231712894, 3, 640x360 
0x12CB3460, 36963313019436616, 231712919, 231712922, 3, 640x360 
0x12CB3460, 36963313019758168, 231712950, 231712954, 4, 640x360 
0x12CB3460, 36963313020079080, 231712991, 231712995, 4, 640x360 
0x12CB3460, 36963313020558488, 231713030, 231713034, 4, 640x360 
0x12CB3460, 36963313020877224, 231713061, 231713064, 3, 640x360 
0x12CB3460, 36963313021195896, 231713100, 231713103, 3, 640x360 
0x12CB3460, 36963313021516904, 231713130, 231713133, 3, 640x360 
0x12CB3460, 36963313021837016, 231713160, 231713163, 3, 640x360 
0x12CB3460, 36963313022157680, 231713191, 231713194, 3, 640x360 
0x12CB3460, 36963313022475832, 231713221, 231713225, 4, 640x360 
0x12CB3460, 36963313022797144, 231713261, 231713263, 2, 640x360 
0x12CB3460, 36963313023117608, 231713290, 231713293, 3, 640x360 
0x12CB3460, 36963313023442672, 231713321, 231713324, 3, 640x360 
0x12CB3460, 36963313023757656, 231713350, 231713353, 3, 640x360 
0x12CB3460, 36963313024236976, 231713400, 231713403, 3, 640x360 
0x12CB3460, 36963313024557952, 231713429, 231713433, 4, 640x360 
0x12CB3460, 36963313024876520, 231713461, 231713466, 5, 640x360 
0x12CB3460, 36963313025199024, 231713494, 231713498, 4, 640x360 
0x12CB3460, 36963313025517480, 231713531, 231713533, 2, 640x360 
0x12CB3460, 36963313025837712, 231713560, 231713562, 2, 640x360 
0x12CB3460, 36963313026158792, 231713590, 231713594, 4, 640x360 
0x12CB3460, 36963313026478912, 231713623, 231713626, 3, 640x360 
0x12CB3460, 36963313026797560, 231713660, 231713669, 9, 640x360 
0x12CB3460, 36963313027117264, 231713690, 231713694, 4, 640x360 
0x12CB3460, 36963313027436680, 231713720, 231713722, 2, 640x360 
0x12CB3460, 36963313027757384, 231713750, 231713753, 3, 640x360 
0x12CB3460, 36963313028239328, 231713800, 231713803, 3, 640x360 
0x12CB3460, 36963313028558432, 231713829, 231713833, 4, 640x360 
0x12CB3460, 36963313028878608, 231713875, 231713878, 3, 640x360 
0x12CB3460, 36963313029196608, 231713900, 231713903, 3, 640x360 
0x12CB3460, 36963313029516272, 231713930, 231713932, 2, 640x360 
0x12CB3460, 36963313029837240, 231713961, 231713963, 2, 640x360 
0x12CB3460, 36963313030156888, 231713990, 231713993, 3, 640x360 
0x12CB3460, 36963313030478088, 231714022, 231714026, 4, 640x360 
0x12CB3460, 36963313030797888, 231714060, 231714063, 3, 640x360 
0x12CB3460, 36963313031118160, 231714090, 231714093, 3, 640x360 
0x12CB3460, 36963313031437632, 231714121, 231714124, 3, 640x360 
0x12CB3460, 36963313031921504, 231714171, 231714174, 3, 640x360 
0x12CB3460, 36963313032239336, 231714200, 231714203, 3, 640x360 
0x12CB3460, 36963313032556768, 231714231, 231714243, 12, 640x360 
0x12CB3460, 36963313032876840, 231714260, 231714264, 4, 640x360 
0x12CB3460, 36963313033197360, 231714300, 231714303, 3, 640x360 
0x12CB3460, 36963313033517168, 231714330, 231714335, 5, 640x360 
0x12CB3460, 36963313033838480, 231714364, 231714367, 3, 640x360 
0x12CB3460, 36963313034155664, 231714390, 231714394, 4, 640x360 
0x12CB3460, 36963313034475824, 231714420, 231714424, 4, 640x360 
0x12CB3460, 36963313034796496, 231714461, 231714463, 2, 640x360 
0x12CB3460, 36963313035118000, 231714491, 231714494, 3, 640x360 
0x12CB3460, 36963313035438224, 231714520, 231714523, 3, 640x360 
0x12CB3460, 36963313035917056, 231714571, 231714574, 3, 640x360 
0x12CB3460, 36963313036237912, 231714600, 231714603, 3, 640x360 
0x12CB3460, 36963313036558552, 231714630, 231714633, 3, 640x360 
0x12CB3460, 36963313036877704, 231714663, 231714667, 4, 640x360 
0x12CB3460, 36963313037197896, 231714700, 231714703, 3, 640x360 
0x12CB3460, 36963313037516832, 231714731, 231714734, 3, 640x360 
0x12CB3460, 36963313037837344, 231714760, 231714769, 9, 640x360 
0x12CB3460, 36963313038156536, 231714792, 231714795, 3, 640x360 
0x12CB3460, 36963313038477096, 231714822, 231714825, 3, 640x360 
0x12CB3460, 36963313038796752, 231714874, 231714877, 3, 640x360 
0x12CB3460, 36963313039116832, 231714890, 231714893, 3, 640x360 
0x12CB3460, 36963313039436128, 231714920, 231714923, 3, 640x360 
0x12CB3460, 36963313039918240, 231714970, 231714973, 3, 640x360 
0x12CB3460, 36963313040236864, 231715001, 231715003, 2, 640x360 
0x12CB3460, 36963313040559016, 231715030, 231715036, 6, 640x360 
0x12CB3460, 36963313040876184, 231715070, 231715073, 3, 640x360 
0x12CB3460, 36963313041196120, 231715100, 231715102, 2, 640x360 
0x12CB3460, 36963313041517376, 231715130, 231715132, 2, 640x360 
0x12CB3460, 36963313041838176, 231715160, 231715163, 3, 640x360 
0x12CB3460, 36963313042156536, 231715191, 231715194, 3, 640x360 
0x12CB3460, 36963313042478976, 231715221, 231715225, 4, 640x360 
0x12CB3460, 36963313042797344, 231715260, 231715262, 2, 640x360 
0x12CB3460, 36963313043117744, 231715291, 231715293, 2, 640x360 
0x12CB3460, 36963313043597872, 231715340, 231715343, 3, 640x360 
0x12CB3460, 36963313043917680, 231715376, 231715393, 17, 640x360 
0x12CB3460, 36963313044235400, 231715400, 231715403, 3, 640x360 
0x12CB3460, 36963313044557944, 231715430, 231715433, 3, 640x360 
0x12CB3460, 36963313044878424, 231715470, 231715473, 3, 640x360 
0x12CB3460, 36963313045198704, 231715494, 231715498, 4, 640x360 
0x12CB3460, 36963313045520544, 231715531, 231715534, 3, 640x360 
0x12CB3460, 36963313045835960, 231715560, 231715569, 9, 640x360 
0x12CB3460, 36963313046156896, 231715591, 231715595, 4, 640x360 
0x12CB3460, 36963313046476608, 231715621, 231715625, 4, 640x360 
0x12CB3460, 36963313046797768, 231715660, 231715668, 8, 640x360 
0x12CB3460, 36963313047119560, 231715690, 231715693, 3, 640x360 
0x12CB3460, 36963313047598504, 231715740, 231715743, 3, 640x360 
0x12CB3460, 36963313047915696, 231715770, 231715773, 3, 640x360 
0x12CB3460, 36963313048237672, 231715801, 231715804, 3, 640x360 
0x12CB3460, 36963313048556752, 231715831, 231715834, 3, 640x360 
0x12CB3460, 36963313048878440, 231715873, 231715876, 3, 640x360 
0x12CB3460, 36963313049197448, 231715900, 231715903, 3, 640x360 
0x12CB3460, 36963313049517968, 231715929, 231715932, 3, 640x360 
0x12CB3460, 36963313049836192, 231715961, 231715964, 3, 640x360 
0x12CB3460, 36963313050157808, 231715990, 231715993, 3, 640x360 
0x12CB3460, 36963313050477568, 231716022, 231716026, 4, 640x360 
0x12CB3460, 36963313050797192, 231716061, 231716063, 2, 640x360 
0x12CB3460, 36963313051117240, 231716090, 231716092, 2, 640x360 
0x12CB3460, 36963313051595944, 231716142, 231716145, 3, 640x360 
0x12CB3460, 36963313051916992, 231716170, 231716172, 2, 640x360 
0x12CB3460, 36963313052237376, 231716200, 231716204, 4, 640x360 
0x12CB3460, 36963313052558280, 231716231, 231716234, 3, 640x360 
0x12CB3460, 36963313052877288, 231716260, 231716264, 4, 640x360 
0x12CB3460, 36963313053196104, 231716300, 231716303, 3, 640x360 
0x12CB3460, 36963313053516760, 231716331, 231716333, 2, 640x360 
0x12CB3460, 36963313053837712, 231716378, 231716381, 3, 640x360 
0x12CB3460, 36963313054155824, 231716391, 231716395, 4, 640x360 
0x12CB3460, 36963313054475824, 231716420, 231716424, 4, 640x360 
0x12CB3460, 36963313054797632, 231716459, 231716463, 4, 640x360 
0x12CB3460, 36963313055277096, 231716501, 231716504, 3, 640x360 
0x12CB3460, 36963313055596336, 231716541, 231716544, 3, 640x360 
0x12CB3460, 36963313055918408, 231716570, 231716588, 18, 640x360 
0x12CB3460, 36963313056235944, 231716600, 231716604, 4, 640x360 
0x12CB3460, 36963313056558856, 231716630, 231716633, 3, 640x360 
0x12CB3460, 36963313056877824, 231716671, 231716675, 4, 640x360 
0x12CB3460, 36963313057196928, 231716700, 231716702, 2, 640x360 
0x12CB3460, 36963313057516984, 231716730, 231716733, 3, 640x360 
0x12CB3460, 36963313057836344, 231716760, 231716763, 3, 640x360 
0x12CB3460, 36963313058157208, 231716790, 231716794, 4, 640x360 
0x12CB3460, 36963313058476808, 231716831, 231716833, 2, 640x360 
0x12CB3460, 36963313058797720, 231716874, 231716877, 3, 640x360 
0x12CB3460, 36963313059276792, 231716900, 231716904, 4, 640x360 
0x12CB3460, 36963313059596944, 231716940, 231716942, 2, 640x360 
0x12CB3460, 36963313059915880, 231716971, 231716973, 2, 640x360 
0x12CB3460, 36963313060238128, 231717001, 231717004, 3, 640x360 
0x12CB3460, 36963313060557056, 231717030, 231717034, 4, 640x360 
0x12CB3460, 36963313060875936, 231717061, 231717065, 4, 640x360 
0x12CB3460, 36963313061195960, 231717100, 231717103, 3, 640x360 
0x12CB3460, 36963313061516480, 231717130, 231717132, 2, 640x360 
0x12CB3460, 36963313061837424, 231717161, 231717165, 4, 640x360 
0x12CB3460, 36963313062157000, 231717190, 231717193, 3, 640x360 
0x12CB3460, 36963313062476376, 231717221, 231717225, 4, 640x360 
0x12CB3460, 36963313062797056, 231717260, 231717263, 3, 640x360 
0x12CB3460, 36963313063277768, 231717301, 231717305, 4, 640x360 
0x12CB3460, 36963313063599000, 231717340, 231717343, 3, 640x360 
0x12CB3460, 36963313063917752, 231717379, 231717382, 3, 640x360 
0x12CB3460, 36963313064236544, 231717400, 231717403, 3, 640x360 
0x12CB3460, 36963313064557448, 231717430, 231717433, 3, 640x360 
0x12CB3460, 36963313064877648, 231717471, 231717473, 2, 640x360 
0x12CB3460, 36963313065196688, 231717493, 231717497, 4, 640x360 
0x12CB3460, 36963313065517696, 231717530, 231717535, 5, 640x360 
0x12CB3460, 36963313065836016, 231717560, 231717563, 3, 640x360 
0x12CB3460, 36963313066158072, 231717590, 231717594, 4, 640x360 
0x12CB3460, 36963313066478688, 231717630, 231717633, 3, 640x360 
0x12CB3460, 36963313066958552, 231717674, 231717678, 4, 640x360 
0x12CB3460, 36963313067276968, 231717710, 231717713, 3, 640x360 
0x12CB3460, 36963313067596208, 231717733, 231717737, 4, 640x360 
0x12CB3460, 36963313067915712, 231717770, 231717773, 3, 640x360 
0x12CB3460, 36963313068236384, 231717800, 231717804, 4, 640x360 
0x12CB3460, 36963313068556016, 231717831, 231717834, 3, 640x360 
0x12CB3460, 36963313068877264, 231717877, 231717885, 8, 640x360 
0x12CB3460, 36963313069196648, 231717900, 231717902, 2, 640x360 
0x12CB3460, 36963313069517504, 231717930, 231717933, 3, 640x360 
0x12CB3460, 36963313069837440, 231717960, 231717963, 3, 640x360 
0x12CB3460, 36963313070157192, 231717992, 231717995, 3, 640x360 
0x12CB3460, 36963313070478024, 231718023, 231718026, 3, 640x360 
0x12CB3460, 36963313070957056, 231718070, 231718073, 3, 640x360 
0x12CB3460, 36963313071277320, 231718101, 231718104, 3, 640x360 
0x12CB3460, 36963313071596312, 231718141, 231718144, 3, 640x360 
0x12CB3460, 36963313071915848, 231718170, 231718173, 3, 640x360 
0x12CB3460, 36963313072237656, 231718201, 231718204, 3, 640x360 
0x12CB3460, 36963313072556864, 231718231, 231718234, 3, 640x360 
0x12CB3460, 36963313072876312, 231718271, 231718273, 2, 640x360 
0x12CB3460, 36963313073196760, 231718300, 231718303, 3, 640x360 
0x12CB3460, 36963313073517264, 231718330, 231718333, 3, 640x360 
0x12CB3460, 36963313073841536, 231718368, 231718371, 3, 640x360 
0x12CB3460, 36963313074156032, 231718390, 231718393, 3, 640x360 
0x12CB3460, 36963313074636776, 231718441, 231718444, 3, 640x360 
0x12CB3460, 36963313074958576, 231718471, 231718474, 3, 640x360 
0x12CB3460, 36963313075275592, 231718501, 231718505, 4, 640x360 
0x12CB3460, 36963313075596968, 231718540, 231718543, 3, 640x360 
0x12CB3460, 36963313075917552, 231718570, 231718573, 3, 640x360 
0x12CB3460, 36963313076239376, 231718601, 231718604, 3, 640x360 
0x12CB3460, 36963313076559960, 231718630, 231718634, 4, 640x360 
0x12CB3460, 36963313076876960, 231718670, 231718672, 2, 640x360 
0x12CB3460, 36963313077197144, 231718699, 231718702, 3, 640x360 
0x12CB3460, 36963313077518328, 231718731, 231718734, 3, 640x360 
0x12CB3460, 36963313077837400, 231718760, 231718768, 8, 640x360 
0x12CB3460, 36963313078157616, 231718791, 231718795, 4, 640x360 
0x12CB3460, 36963313078638960, 231718840, 231718843, 3, 640x360 
0x12CB3460, 36963313078956664, 231718874, 231718877, 3, 640x360 
0x12CB3460, 36963313079276552, 231718900, 231718904, 4, 640x360 
0x12CB3460, 36963313079597536, 231718940, 231718944, 4, 640x360 
0x12CB3460, 36963313079916360, 231718970, 231718973, 3, 640x360 
0x12CB3460, 36963313080236136, 231719000, 231719003, 3, 640x360 
0x12CB3460, 36963313080557072, 231719030, 231719033, 3, 640x360 
0x12CB3460, 36963313080876384, 231719061, 231719065, 4, 640x360 
0x12CB3460, 36963313081197144, 231719100, 231719102, 2, 640x360 
0x12CB3460, 36963313081517328, 231719130, 231719133, 3, 640x360 
0x12CB3460, 36963313081836584, 231719159, 231719162, 3, 640x360 
0x12CB3460, 36963313082159008, 231719191, 231719195, 4, 640x360 
0x12CB3460, 36963313082638088, 231719240, 231719243, 3, 640x360 
0x12CB3460, 36963313082959448, 231719271, 231719274, 3, 640x360 
0x12CB3460, 36963313083275488, 231719310, 231719313, 3, 640x360 
0x12CB3460, 36963313083596056, 231719340, 231719343, 3, 640x360 
0x12CB3460, 36963313083920536, 231719385, 231719388, 3, 640x360 
0x12CB3460, 36963313084236872, 231719400, 231719403, 3, 640x360 
0x12CB3460, 36963313084555800, 231719431, 231719433, 2, 640x360 
0x12CB3460, 36963313084875976, 231719461, 231719465, 4, 640x360 
0x12CB3460, 36963313085199232, 231719501, 231719519, 18, 640x360 
0x12CB3460, 36963313085516648, 231719530, 231719534, 4, 640x360 
0x12CB3460, 36963313085835912, 231719559, 231719562, 3, 640x360 
0x12CB3460, 36963313086318032, 231719611, 231719613, 2, 640x360 
0x12CB3460, 36963313086638704, 231719642, 231719645, 3, 640x360 
0x12CB3460, 36963313086955680, 231719670, 231719673, 3, 640x360 
0x12CB3460, 36963313087277416, 231719710, 231719714, 4, 640x360 
0x12CB3460, 36963313087599792, 231719744, 231719747, 3, 640x360 
0x12CB3460, 36963313087917552, 231719770, 231719773, 3, 640x360 
0x12CB3460, 36963313088238280, 231719800, 231719803, 3, 640x360 
0x12CB3460, 36963313088559280, 231719831, 231719834, 3, 640x360 
0x12CB3460, 36963313088885304, 231719882, 231719885, 3, 640x360 
0x12CB3460, 36963313089197744, 231719893, 231719897, 4, 640x360 
0x12CB3460, 36963313089516472, 231719930, 231719933, 3, 640x360 
0x12CB3460, 36963313089836784, 231719960, 231719963, 3, 640x360 
0x12CB3460, 36963313090319008, 231720010, 231720013, 3, 640x360 
0x12CB3460, 36963313090640144, 231720041, 231720045, 4, 640x360 
0x12CB3460, 36963313090955880, 231720070, 231720073, 3, 640x360 
0x12CB3460, 36963313091276880, 231720111, 231720114, 3, 640x360 
0x12CB3460, 36963313091597664, 231720140, 231720143, 3, 640x360 
0x12CB3460, 36963313091918016, 231720171, 231720174, 3, 640x360 
0x12CB3460, 36963313092237368, 231720200, 231720203, 3, 640x360 
0x12CB3460, 36963313092557840, 231720230, 231720234, 4, 640x360 
0x12CB3460, 36963313092876528, 231720270, 231720272, 2, 640x360 
0x12CB3460, 36963313093197352, 231720302, 231720305, 3, 640x360 
0x12CB3460, 36963313093518664, 231720331, 231720335, 4, 640x360 
0x12CB3460, 36963313093838928, 231720375, 231720378, 3, 640x360 
0x12CB3460, 36963313094315136, 231720411, 231720414, 3, 640x360 
0x12CB3460, 36963313094635264, 231720440, 231720443, 3, 640x360 
0x12CB3460, 36963313094958176, 231720470, 231720473, 3, 640x360 
0x12CB3460, 36963313095277664, 231720501, 231720505, 4, 640x360 
0x12CB3460, 36963313095598032, 231720540, 231720543, 3, 640x360 
0x12CB3460, 36963313095917896, 231720570, 231720573, 3, 640x360 
0x12CB3460, 36963313096237688, 231720601, 231720604, 3, 640x360 
0x12CB3460, 36963313096557528, 231720630, 231720634, 4, 640x360 
0x12CB3460, 36963313096877064, 231720670, 231720673, 3, 640x360 
0x12CB3460, 36963313097197776, 231720700, 231720702, 2, 640x360 
0x12CB3460, 36963313097519032, 231720730, 231720733, 3, 640x360 
0x12CB3460, 36963313097998536, 231720781, 231720783, 2, 640x360 
0x12CB3460, 36963313098318592, 231720811, 231720813, 2, 640x360 
0x12CB3460, 36963313098637064, 231720842, 231720845, 3, 640x360 
0x12CB3460, 36963313098958328, 231720899, 231720902, 3, 640x360 
0x12CB3460, 36963313099598464, 231720940, 231720942, 2, 640x360 
0x12CB3460, 36963313099917344, 231720971, 231720973, 2, 640x360 
0x12CB3460, 36963313100237416, 231721000, 231721003, 3, 640x360 
0x12CB3460, 36963313100557136, 231721030, 231721036, 6, 640x360 
0x12CB3460, 36963313100877480, 231721061, 231721065, 4, 640x360 
0x12CB3460, 36963313101196744, 231721100, 231721103, 3, 640x360 
0x12CB3460, 36963313101516480, 231721129, 231721132, 3, 640x360 
0x12CB3460, 36963313101995424, 231721181, 231721184, 3, 640x360 
0x12CB3460, 36963313102315456, 231721210, 231721212, 2, 640x360 
0x12CB3460, 36963313102635760, 231721240, 231721244, 4, 640x360 
0x12CB3460, 36963313102957856, 231721270, 231721273, 3, 640x360 
0x12CB3460, 36963313103277184, 231721301, 231721305, 4, 640x360 
0x12CB3460, 36963313103598368, 231721340, 231721343, 3, 640x360 
0x12CB3460, 36963313103916808, 231721379, 231721382, 3, 640x360 
0x12CB3460, 36963313104236448, 231721400, 231721403, 3, 640x360 
0x12CB3460, 36963313104556000, 231721430, 231721433, 3, 640x360 
0x12CB3460, 36963313104877568, 231721471, 231721474, 3, 640x360 
0x12CB3460, 36963313105198824, 231721500, 231721504, 4, 640x360 
0x12CB3460, 36963313105679488, 231721550, 231721553, 3, 640x360 
0x12CB3460, 36963313105996344, 231721581, 231721583, 2, 640x360 
0x12CB3460, 36963313106317256, 231721610, 231721612, 2, 640x360 
0x12CB3460, 36963313106638000, 231721641, 231721644, 3, 640x360 
0x12CB3460, 36963313106957416, 231721670, 231721688, 18, 640x360 
0x12CB3460, 36963313107276968, 231721701, 231721705, 4, 640x360 
0x12CB3460, 36963313107597384, 231721740, 231721744, 4, 640x360 
0x12CB3460, 36963313107916568, 231721770, 231721772, 2, 640x360 
0x12CB3460, 36963313108237192, 231721801, 231721804, 3, 640x360 
0x12CB3460, 36963313108558120, 231721831, 231721834, 3, 640x360 
0x12CB3460, 36963313108881328, 231721871, 231721875, 4, 640x360 
0x12CB3460, 36963313109196696, 231721899, 231721902, 3, 640x360 
0x12CB3460, 36963313109676992, 231721941, 231721945, 4, 640x360 
0x12CB3460, 36963313109998616, 231721980, 231721983, 3, 640x360 
0x12CB3460, 36963313110316600, 231722011, 231722015, 4, 640x360 
0x12CB3460, 36963313110637152, 231722040, 231722044, 4, 640x360 
0x12CB3460, 36963313110956112, 231722070, 231722072, 2, 640x360 
0x12CB3460, 36963313111276248, 231722100, 231722104, 4, 640x360 
0x12CB3460, 36963313111601928, 231722140, 231722143, 3, 640x360 
0x12CB3460, 36963313111916256, 231722170, 231722173, 3, 640x360 
0x12CB3460, 36963313112235520, 231722200, 231722203, 3, 640x360 
0x12CB3460, 36963313112557576, 231722230, 231722233, 3, 640x360 
0x12CB3460, 36963313112877840, 231722270, 231722273, 3, 640x360 
0x12CB3460, 36963313113196800, 231722301, 231722304, 3, 640x360 
0x12CB3460, 36963313113677432, 231722341, 231722345, 4, 640x360 
0x12CB3460, 36963313113996312, 231722381, 231722384, 3, 640x360 
0x12CB3460, 36963313114316672, 231722410, 231722413, 3, 640x360 
0x12CB3460, 36963313114637120, 231722440, 231722444, 4, 640x360 
0x12CB3460, 36963313114957400, 231722471, 231722474, 3, 640x360 
0x12CB3460, 36963313115276824, 231722501, 231722505, 4, 640x360 
0x12CB3460, 36963313115596896, 231722541, 231722543, 2, 640x360 
0x12CB3460, 36963313115917368, 231722570, 231722588, 18, 640x360 
0x12CB3460, 36963313116236744, 231722600, 231722603, 3, 640x360 
0x12CB3460, 36963313116559464, 231722632, 231722636, 4, 640x360 
0x12CB3460, 36963313116876552, 231722661, 231722664, 3, 640x360 
0x12CB3460, 36963313117357344, 231722711, 231722714, 3, 640x360 
0x12CB3460, 36963313117675064, 231722741, 231722744, 3, 640x360 
0x12CB3460, 36963313117995536, 231722780, 231722783, 3, 640x360 
0x12CB3460, 36963313118315792, 231722810, 231722813, 3, 640x360 
0x12CB3460, 36963313118636464, 231722842, 231722845, 3, 640x360 
0x12CB3460, 36963313118957632, 231722890, 231722893, 3, 640x360 
0x12CB3460, 36963313119275632, 231722910, 231722912, 2, 640x360 
0x12CB3460, 36963313119596576, 231722940, 231722943, 3, 640x360 
0x12CB3460, 36963313119917360, 231722970, 231722973, 3, 640x360 
0x12CB3460, 36963313120236984, 231723000, 231723004, 4, 640x360 
0x12CB3460, 36963313120557552, 231723030, 231723033, 3, 640x360 
0x12CB3460, 36963313120877384, 231723061, 231723064, 3, 640x360 
0x12CB3460, 36963313121356632, 231723111, 231723113, 2, 640x360 
0x12CB3460, 36963313121674928, 231723141, 231723145, 4, 640x360 
0x12CB3460, 36963313121996176, 231723180, 231723183, 3, 640x360 
0x12CB3460, 36963313122315200, 231723210, 231723212, 2, 640x360 
0x12CB3460, 36963313122637184, 231723240, 231723243, 3, 640x360 
0x12CB3460, 36963313122957440, 231723270, 231723273, 3, 640x360 
0x12CB3460, 36963313123277184, 231723301, 231723305, 4, 640x360 
0x12CB3460, 36963313123598232, 231723340, 231723343, 3, 640x360 
0x12CB3460, 36963313123917008, 231723369, 231723372, 3, 640x360 
0x12CB3460, 36963313124236288, 231723400, 231723402, 2, 640x360 
0x12CB3460, 36963313124557168, 231723430, 231723433, 3, 640x360 
0x12CB3460, 36963313124877744, 231723470, 231723473, 3, 640x360 
0x12CB3460, 36963313125359648, 231723520, 231723523, 3, 640x360 
0x12CB3460, 36963313125675512, 231723550, 231723553, 3, 640x360 
0x12CB3460, 36963313125996096, 231723581, 231723584, 3, 640x360 
0x12CB3460, 36963313126315816, 231723611, 231723614, 3, 640x360 
0x12CB3460, 36963313126636816, 231723641, 231723644, 3, 640x360 
0x12CB3460, 36963313126958344, 231723670, 231723673, 3, 640x360 
0x12CB3460, 36963313127277232, 231723703, 231723707, 4, 640x360 
0x12CB3460, 36963313127597344, 231723740, 231723743, 3, 640x360 
0x12CB3460, 36963313127916176, 231723770, 231723772, 2, 640x360 
0x12CB3460, 36963313128236744, 231723801, 231723804, 3, 640x360 
0x12CB3460, 36963313128558672, 231723831, 231723834, 3, 640x360 
0x12CB3460, 36963313129036352, 231723893, 231723896, 3, 640x360 
0x12CB3460, 36963313129356064, 231723909, 231723912, 3, 640x360 
0x12CB3460, 36963313129675600, 231723941, 231723943, 2, 640x360 
0x12CB3460, 36963313129997800, 231723981, 231723984, 3, 640x360 
0x12CB3460, 36963313130316152, 231724011, 231724014, 3, 640x360 
0x12CB3460, 36963313130641400, 231724041, 231724044, 3, 640x360 
0x12CB3460, 36963313130956848, 231724070, 231724073, 3, 640x360 
0x12CB3460, 36963313131275760, 231724101, 231724104, 3, 640x360 
0x12CB3460, 36963313131596376, 231724140, 231724143, 3, 640x360 
0x12CB3460, 36963313131916936, 231724170, 231724173, 3, 640x360 
0x12CB3460, 36963313132237480, 231724201, 231724204, 3, 640x360 
0x12CB3460, 36963313132556608, 231724231, 231724234, 3, 640x360 
0x12CB3460, 36963313133036368, 231724280, 231724283, 3, 640x360 
0x12CB3460, 36963313133356120, 231724310, 231724313, 3, 640x360 
0x12CB3460, 36963313133676688, 231724341, 231724345, 4, 640x360 
0x12CB3460, 36963313133996384, 231724381, 231724383, 2, 640x360 
0x12CB3460, 36963313134316992, 231724410, 231724413, 3, 640x360 
0x12CB3460, 36963313134637424, 231724441, 231724444, 3, 640x360 
0x12CB3460, 36963313134955264, 231724471, 231724474, 3, 640x360 
0x12CB3460, 36963313135276216, 231724501, 231724505, 4, 640x360 
0x12CB3460, 36963313135596304, 231724539, 231724542, 3, 640x360 
0x12CB3460, 36963313135917992, 231724571, 231724573, 2, 640x360 
0x12CB3460, 36963313136238704, 231724600, 231724608, 8, 640x360 
0x12CB3460, 36963313136559424, 231724630, 231724634, 4, 640x360 
0x12CB3460, 36963313137037712, 231724680, 231724684, 4, 640x360 
0x12CB3460, 36963313137355096, 231724710, 231724713, 3, 640x360 
0x12CB3460, 36963313137675592, 231724750, 231724753, 3, 640x360 
0x12CB3460, 36963313137996968, 231724779, 231724782, 3, 640x360 
0x12CB3460, 36963313138316520, 231724811, 231724814, 3, 640x360 
0x12CB3460, 36963313138637760, 231724840, 231724843, 3, 640x360 
0x12CB3460, 36963313138956720, 231724877, 231724880, 3, 640x360 
0x12CB3460, 36963313139275736, 231724901, 231724904, 3, 640x360 
0x12CB3460, 36963313139596840, 231724940, 231724943, 3, 640x360 
0x12CB3460, 36963313139917368, 231724971, 231724974, 3, 640x360 
0x12CB3460, 36963313140236680, 231725000, 231725004, 4, 640x360 
0x12CB3460, 36963313140721664, 231725052, 231725056, 4, 640x360 
0x12CB3460, 36963313141037336, 231725080, 231725083, 3, 640x360 
0x12CB3460, 36963313141356232, 231725109, 231725113, 4, 640x360 
0x12CB3460, 36963313141676584, 231725140, 231725143, 3, 640x360 
0x12CB3460, 36963313141995608, 231725181, 231725183, 2, 640x360 
0x12CB3460, 36963313142315800, 231725209, 231725212, 3, 640x360 
0x12CB3460, 36963313142637208, 231725240, 231725243, 3, 640x360 
0x12CB3460, 36963313142957288, 231725270, 231725273, 3, 640x360 
0x12CB3460, 36963313143277176, 231725309, 231725313, 4, 640x360 
0x12CB3460, 36963313143597776, 231725340, 231725343, 3, 640x360 
0x12CB3460, 36963313143918840, 231725384, 231725387, 3, 640x360 
0x12CB3460, 36963313144242760, 231725400, 231725403, 3, 640x360 
0x12CB3460, 36963313144715112, 231725450, 231725453, 3, 640x360 
0x12CB3460, 36963313145035304, 231725481, 231725484, 3, 640x360 
0x12CB3460, 36963313145356688, 231725511, 231725513, 2, 640x360 
0x12CB3460, 36963313145676512, 231725541, 231725544, 3, 640x360 
0x12CB3460, 36963313145998200, 231725581, 231725583, 2, 640x360 
0x12CB3460, 36963313146315968, 231725610, 231725613, 3, 640x360 
0x12CB3460, 36963313146637896, 231725640, 231725644, 4, 640x360 
0x12CB3460, 36963313146957488, 231725672, 231725676, 4, 640x360 
0x12CB3460, 36963313147276272, 231725711, 231725714, 3, 640x360 
0x12CB3460, 36963313147597840, 231725740, 231725743, 3, 640x360 
0x12CB3460, 36963313147916592, 231725770, 231725773, 3, 640x360 
0x12CB3460, 36963313148397424, 231725820, 231725823, 3, 640x360 
0x12CB3460, 36963313148716232, 231725882, 231725885, 3, 640x360 
0x12CB3460, 36963313149355016, 231725910, 231725913, 3, 640x360 
0x12CB3460, 36963313149675360, 231725941, 231725944, 3, 640x360 
0x12CB3460, 36963313149996344, 231725981, 231725984, 3, 640x360 
0x12CB3460, 36963313150317872, 231726011, 231726013, 2, 640x360 
0x12CB3460, 36963313150636616, 231726041, 231726044, 3, 640x360 
0x12CB3460, 36963313150956368, 231726069, 231726073, 4, 640x360 
0x12CB3460, 36963313151276560, 231726111, 231726113, 2, 640x360 
0x12CB3460, 36963313151596224, 231726141, 231726144, 3, 640x360 
0x12CB3460, 36963313151917056, 231726171, 231726174, 3, 640x360 
0x12CB3460, 36963313152396128, 231726220, 231726223, 3, 640x360 
0x12CB3460, 36963313152716248, 231726251, 231726254, 3, 640x360 
0x12CB3460, 36963313153036608, 231726280, 231726283, 3, 640x360 
0x12CB3460, 36963313153356600, 231726311, 231726314, 3, 640x360 
0x12CB3460, 36963313153676480, 231726341, 231726344, 3, 640x360 
0x12CB3460, 36963313153996096, 231726380, 231726383, 3, 640x360 
0x12CB3460, 36963313154316080, 231726410, 231726413, 3, 640x360 
0x12CB3460, 36963313154636680, 231726440, 231726442, 2, 640x360 
0x12CB3460, 36963313154956248, 231726471, 231726474, 3, 640x360 
0x12CB3460, 36963313155276080, 231726500, 231726504, 4, 640x360 
0x12CB3460, 36963313155597432, 231726540, 231726543, 3, 640x360 
0x12CB3460, 36963313155915224, 231726570, 231726573, 3, 640x360 
0x12CB3460, 36963313156397200, 231726619, 231726622, 3, 640x360 
0x12CB3460, 36963313156716048, 231726651, 231726655, 4, 640x360 
0x12CB3460, 36963313157036624, 231726680, 231726685, 5, 640x360 
0x12CB3460, 36963313157357288, 231726710, 231726713, 3, 640x360 
0x12CB3460, 36963313157676136, 231726740, 231726743, 3, 640x360 
0x12CB3460, 36963313157997176, 231726780, 231726783, 3, 640x360 
0x12CB3460, 36963313158316832, 231726809, 231726812, 3, 640x360 
0x12CB3460, 36963313158637640, 231726841, 231726844, 3, 640x360 
0x12CB3460, 36963313158961416, 231726888, 231726892, 4, 640x360 
0x12CB3460, 36963313159277352, 231726901, 231726906, 5, 640x360 
0x12CB3460, 36963313159596856, 231726939, 231726942, 3, 640x360 
0x12CB3460, 36963313160077912, 231726991, 231726994, 3, 640x360 
0x12CB3460, 36963313160399472, 231727020, 231727023, 3, 640x360 
0x12CB3460, 36963313160716568, 231727050, 231727055, 5, 640x360 
0x12CB3460, 36963313161036224, 231727080, 231727084, 4, 640x360 
0x12CB3460, 36963313161356432, 231727110, 231727113, 3, 640x360 
0x12CB3460, 36963313161675328, 231727141, 231727144, 3, 640x360 
0x12CB3460, 36963313161996800, 231727181, 231727183, 2, 640x360 
0x12CB3460, 36963313162315032, 231727210, 231727212, 2, 640x360 
0x12CB3460, 36963313162637680, 231727240, 231727243, 3, 640x360 
0x12CB3460, 36963313162956240, 231727270, 231727273, 3, 640x360 
0x12CB3460, 36963313163276632, 231727310, 231727313, 3, 640x360 
0x12CB3460, 36963313163597592, 231727340, 231727343, 3, 640x360 
0x12CB3460, 36963313164074488, 231727381, 231727384, 3, 640x360 
0x12CB3460, 36963313164397248, 231727420, 231727423, 3, 640x360 
0x12CB3460, 36963313164715336, 231727450, 231727452, 2, 640x360 
0x12CB3460, 36963313165037520, 231727481, 231727484, 3, 640x360 
0x12CB3460, 36963313165358976, 231727512, 231727515, 3, 640x360 
0x12CB3460, 36963313165680936, 231727546, 231727549, 3, 640x360 
0x12CB3460, 36963313165996704, 231727580, 231727583, 3, 640x360 
0x12CB3460, 36963313166319640, 231727611, 231727615, 4, 640x360 
0x12CB3460, 36963313166640680, 231727640, 231727644, 4, 640x360 
0x12CB3460, 36963313166957520, 231727670, 231727674, 4, 640x360 
0x12CB3460, 36963313167277880, 231727702, 231727706, 4, 640x360 
0x12CB3460, 36963313167597880, 231727740, 231727744, 4, 640x360 
0x12CB3460, 36963313168076544, 231727781, 231727784, 3, 640x360 
0x12CB3460, 36963313168395784, 231727819, 231727822, 3, 640x360 
0x12CB3460, 36963313168716536, 231727872, 231727875, 3, 640x360 
0x12CB3460, 36963313169035904, 231727880, 231727883, 3, 640x360 
0x12CB3460, 36963313169356416, 231727911, 231727914, 3, 640x360 
0x12CB3460, 36963313169676816, 231727941, 231727944, 3, 640x360 
0x12CB3460, 36963313169997560, 231727981, 231727984, 3, 640x360 
0x12CB3460, 36963313170316880, 231728011, 231728020, 9, 640x360 
0x12CB3460, 36963313170640400, 231728040, 231728044, 4, 640x360 
0x12CB3460, 36963313170955064, 231728071, 231728074, 3, 640x360 
0x12CB3460, 36963313171275152, 231728100, 231728104, 4, 640x360 
0x12CB3460, 36963313171755104, 231728151, 231728154, 3, 640x360 
0x12CB3460, 36963313172075256, 231728181, 231728185, 4, 640x360 
0x12CB3460, 36963313172395056, 231728220, 231728223, 3, 640x360 
0x12CB3460, 36963313172714632, 231728250, 231728253, 3, 640x360 
0x12CB3460, 36963313173036664, 231728280, 231728282, 2, 640x360 
0x12CB3460, 36963313173355952, 231728311, 231728313, 2, 640x360 
0x12CB3460, 36963313173675176, 231728340, 231728344, 4, 640x360 
0x12CB3460, 36963313173995888, 231728374, 231728378, 4, 640x360 
0x12CB3460, 36963313174314824, 231728409, 231728412, 3, 640x360 
0x12CB3460, 36963313174636640, 231728440, 231728443, 3, 640x360 
0x12CB3460, 36963313174956112, 231728470, 231728473, 3, 640x360 
0x12CB3460, 36963313175276448, 231728501, 231728504, 3, 640x360 
0x12CB3460, 36963313175755880, 231728551, 231728553, 2, 640x360 
0x12CB3460, 36963313176076792, 231728590, 231728593, 3, 640x360 
0x12CB3460, 36963313176397440, 231728620, 231728623, 3, 640x360 
0x12CB3460, 36963313176716880, 231728650, 231728654, 4, 640x360 
0x12CB3460, 36963313177037352, 231728681, 231728684, 3, 640x360 
0x12CB3460, 36963313177357696, 231728710, 231728714, 4, 640x360 
0x12CB3460, 36963313177679288, 231728745, 231728748, 3, 640x360 
0x12CB3460, 36963313177995976, 231728779, 231728782, 3, 640x360 
0x12CB3460, 36963313178315384, 231728810, 231728813, 3, 640x360 
0x12CB3460, 36963313178636840, 231728840, 231728843, 3, 640x360 
0x12CB3460, 36963313178956296, 231728883, 231728885, 2, 640x360 
0x12CB3460, 36963313179276760, 231728900, 231728904, 4, 640x360 
0x12CB3460, 36963313179756560, 231728950, 231728953, 3, 640x360 
0x12CB3460, 36963313180077352, 231728982, 231728986, 4, 640x360 
0x12CB3460, 36963313180398048, 231729020, 231729023, 3, 640x360 
0x12CB3460, 36963313180721664, 231729051, 231729057, 6, 640x360 
0x12CB3460, 36963313181035424, 231729080, 231729082, 2, 640x360 
0x12CB3460, 36963313181356760, 231729110, 231729113, 3, 640x360 
0x12CB3460, 36963313181676776, 231729150, 231729153, 3, 640x360 
0x12CB3460, 36963313181995552, 231729180, 231729183, 3, 640x360 
0x12CB3460, 36963313182315976, 231729210, 231729220, 10, 640x360 
0x12CB3460, 36963313182638408, 231729240, 231729243, 3, 640x360 
0x12CB3460, 36963313182956400, 231729271, 231729274, 3, 640x360 
0x12CB3460, 36963313183438144, 231729322, 231729325, 3, 640x360 
0x12CB3460, 36963313183758416, 231729383, 231729386, 3, 640x360 
0x12CB3460, 36963313184396240, 231729421, 231729423, 2, 640x360 
0x12CB3460, 36963313184715456, 231729450, 231729453, 3, 640x360 
0x12CB3460, 36963313185037488, 231729481, 231729484, 3, 640x360 
0x12CB3460, 36963313185358480, 231729510, 231729514, 4, 640x360 
0x12CB3460, 36963313185678376, 231729545, 231729549, 4, 640x360 
0x12CB3460, 36963313185995632, 231729579, 231729582, 3, 640x360 
0x12CB3460, 36963313186316536, 231729611, 231729614, 3, 640x360 
0x12CB3460, 36963313186639608, 231729641, 231729644, 3, 640x360 
0x12CB3460, 36963313186956504, 231729670, 231729674, 4, 640x360 
0x12CB3460, 36963313187438456, 231729722, 231729725, 3, 640x360 
0x12CB3460, 36963313187756104, 231729751, 231729753, 2, 640x360 
0x12CB3460, 36963313188076256, 231729790, 231729793, 3, 640x360 
0x12CB3460, 36963313188396288, 231729820, 231729823, 3, 640x360 
0x12CB3460, 36963313188716272, 231729850, 231729853, 3, 640x360 
0x12CB3460, 36963313189038808, 231729889, 231729893, 4, 640x360 
0x12CB3460, 36963313189355696, 231729910, 231729912, 2, 640x360 
0x12CB3460, 36963313189676240, 231729941, 231729943, 2, 640x360 
0x12CB3460, 36963313189997032, 231729981, 231729984, 3, 640x360 
0x12CB3460, 36963313190318280, 231730011, 231730014, 3, 640x360 
0x12CB3460, 36963313190638208, 231730040, 231730044, 4, 640x360 
0x12CB3460, 36963313191116624, 231730090, 231730093, 3, 640x360 
0x12CB3460, 36963313191435904, 231730120, 231730122, 2, 640x360 
0x12CB3460, 36963313191757312, 231730151, 231730154, 3, 640x360 
0x12CB3460, 36963313192077376, 231730192, 231730195, 3, 640x360 
0x12CB3460, 36963313192397336, 231730220, 231730223, 3, 640x360 
0x12CB3460, 36963313192716200, 231730249, 231730252, 3, 640x360 
0x12CB3460, 36963313193036560, 231730280, 231730283, 3, 640x360 
0x12CB3460, 36963313193355376, 231730310, 231730313, 3, 640x360 
0x12CB3460, 36963313193675920, 231730341, 231730345, 4, 640x360 
0x12CB3460, 36963313193995472, 231730377, 231730380, 3, 640x360 
0x12CB3460, 36963313194315024, 231730410, 231730413, 3, 640x360 
0x12CB3460, 36963313194636672, 231730441, 231730444, 3, 640x360 
0x12CB3460, 36963313195117432, 231730490, 231730493, 3, 640x360 
0x12CB3460, 36963313195436088, 231730521, 231730524, 3, 640x360 
0x12CB3460, 36963313195754840, 231730551, 231730554, 3, 640x360 
0x12CB3460, 36963313196074824, 231730580, 231730584, 4, 640x360 
0x12CB3460, 36963313196395072, 231730619, 231730622, 3, 640x360 
0x12CB3460, 36963313196717248, 231730650, 231730654, 4, 640x360 
0x12CB3460, 36963313197035616, 231730680, 231730683, 3, 640x360 
0x12CB3460, 36963313197355464, 231730710, 231730713, 3, 640x360 
0x12CB3460, 36963313197675056, 231730740, 231730744, 4, 640x360 
0x12CB3460, 36963313197996760, 231730780, 231730782, 2, 640x360 
0x12CB3460, 36963313198315840, 231730811, 231730814, 3, 640x360 
0x12CB3460, 36963313198637912, 231730840, 231730843, 3, 640x360 
0x12CB3460, 36963313199116400, 231730889, 231730893, 4, 640x360 
0x12CB3460, 36963313199434768, 231730920, 231730923, 3, 640x360 
0x12CB3460, 36963313199756792, 231730950, 231730953, 3, 640x360 
0x12CB3460, 36963313200077176, 231730981, 231730985, 4, 640x360 
0x12CB3460, 36963313200396008, 231731019, 231731022, 3, 640x360 
0x12CB3460, 36963313200717960, 231731050, 231731053, 3, 640x360 
0x12CB3460, 36963313201037056, 231731080, 231731083, 3, 640x360 
0x12CB3460, 36963313201355352, 231731111, 231731113, 2, 640x360 
0x12CB3460, 36963313201676208, 231731151, 231731153, 2, 640x360 
0x12CB3460, 36963313201996688, 231731180, 231731182, 2, 640x360 
0x12CB3460, 36963313202315600, 231731211, 231731213, 2, 640x360 
0x12CB3460, 36963313202794728, 231731260, 231731262, 2, 640x360 
0x12CB3460, 36963313203116880, 231731289, 231731292, 3, 640x360 
0x12CB3460, 36963313203435816, 231731321, 231731323, 2, 640x360 
0x12CB3460, 36963313203754712, 231731350, 231731353, 3, 640x360 
0x12CB3460, 36963313204074912, 231731383, 231731386, 3, 640x360 
0x12CB3460, 36963313204395848, 231731421, 231731438, 17, 640x360 
0x12CB3460, 36963313204715872, 231731450, 231731452, 2, 640x360 
0x12CB3460, 36963313205035776, 231731480, 231731483, 3, 640x360 
0x12CB3460, 36963313205355904, 231731511, 231731513, 2, 640x360 
0x12CB3460, 36963313205675336, 231731541, 231731546, 5, 640x360 
0x12CB3460, 36963313205995736, 231731580, 231731583, 3, 640x360 
0x12CB3460, 36963313206317552, 231731610, 231731613, 3, 640x360 
0x12CB3460, 36963313206796112, 231731660, 231731664, 4, 640x360 
0x12CB3460, 36963313207115176, 231731690, 231731694, 4, 640x360 
0x12CB3460, 36963313207437888, 231731721, 231731724, 3, 640x360 
0x12CB3460, 36963313207755248, 231731750, 231731754, 4, 640x360 
0x12CB3460, 36963313208076080, 231731790, 231731793, 3, 640x360 
0x12CB3460, 36963313208395664, 231731819, 231731822, 3, 640x360 
0x12CB3460, 36963313208717976, 231731878, 231731881, 3, 640x360 
0x12CB3460, 36963313209355256, 231731911, 231731914, 3, 640x360 
0x12CB3460, 36963313209675352, 231731950, 231731953, 3, 640x360 
0x12CB3460, 36963313209996968, 231731980, 231731983, 3, 640x360 
0x12CB3460, 36963313210319160, 231732010, 231732013, 3, 640x360 
0x12CB3460, 36963313210797136, 231732060, 231732063, 3, 640x360 
0x12CB3460, 36963313211115704, 231732090, 231732093, 3, 640x360 
0x12CB3460, 36963313211436224, 231732120, 231732138, 18, 640x360 
0x12CB3460, 36963313211757536, 231732151, 231732156, 5, 640x360 
0x12CB3460, 36963313212077960, 231732182, 231732186, 4, 640x360 
0x12CB3460, 36963313212396232, 231732220, 231732223, 3, 640x360 
0x12CB3460, 36963313212715080, 231732250, 231732253, 3, 640x360 
0x12CB3460, 36963313213036256, 231732280, 231732282, 2, 640x360 
0x12CB3460, 36963313213355560, 231732310, 231732313, 3, 640x360 
0x12CB3460, 36963313213675904, 231732372, 231732375, 3, 640x360 
0x12CB3460, 36963313213996856, 231732381, 231732385, 4, 640x360 
0x12CB3460, 36963313214475408, 231732430, 231732433, 3, 640x360 
0x12CB3460, 36963313214796776, 231732460, 231732469, 9, 640x360 
0x12CB3460, 36963313215116560, 231732491, 231732494, 3, 640x360 
0x12CB3460, 36963313215438128, 231732521, 231732524, 3, 640x360 
0x12CB3460, 36963313215756184, 231732551, 231732554, 3, 640x360 
0x12CB3460, 36963313216075656, 231732580, 231732584, 4, 640x360 
0x12CB3460, 36963313216396888, 231732619, 231732622, 3, 640x360 
0x12CB3460, 36963313216714480, 231732650, 231732656, 6, 640x360 
0x12CB3460, 36963313217038808, 231732680, 231732682, 2, 640x360 
0x12CB3460, 36963313217355328, 231732710, 231732713, 3, 640x360 
0x12CB3460, 36963313217675872, 231732750, 231732753, 3, 640x360 
0x12CB3460, 36963313217996840, 231732780, 231732783, 3, 640x360 
0x12CB3460, 36963313218477488, 231732822, 231732826, 4, 640x360 
0x12CB3460, 36963313218798440, 231732855, 231732859, 4, 640x360 
0x12CB3460, 36963313219116376, 231732887, 231732890, 3, 640x360 
0x12CB3460, 36963313219434464, 231732920, 231732923, 3, 640x360 
0x12CB3460, 36963313219756528, 231732951, 231732954, 3, 640x360 
0x12CB3460, 36963313220076856, 231732991, 231732994, 3, 640x360 
0x12CB3460, 36963313220398136, 231733021, 231733024, 3, 640x360 
0x12CB3460, 36963313220716440, 231733050, 231733054, 4, 640x360 
0x12CB3460, 36963313221034480, 231733080, 231733082, 2, 640x360 
0x12CB3460, 36963313221356208, 231733110, 231733113, 3, 640x360 
0x12CB3460, 36963313221675304, 231733142, 231733145, 3, 640x360 
0x12CB3460, 36963313222157256, 231733191, 231733194, 3, 640x360 
0x12CB3460, 36963313222475808, 231733231, 231733235, 4, 640x360 
0x12CB3460, 36963313222796600, 231733259, 231733262, 3, 640x360 
0x12CB3460, 36963313223116232, 231733290, 231733294, 4, 640x360 
0x12CB3460, 36963313223436424, 231733320, 231733324, 4, 640x360 
0x12CB3460, 36963313223756264, 231733371, 231733383, 12, 640x360 
0x12CB3460, 36963313224075616, 231733384, 231733389, 5, 640x360 
0x12CB3460, 36963313224395480, 231733420, 231733423, 3, 640x360 
0x12CB3460, 36963313224714968, 231733449, 231733452, 3, 640x360 
0x12CB3460, 36963313225036176, 231733480, 231733483, 3, 640x360 
0x12CB3460, 36963313225355384, 231733510, 231733513, 3, 640x360 
0x12CB3460, 36963313225675536, 231733550, 231733553, 3, 640x360 
0x12CB3460, 36963313226155512, 231733590, 231733593, 3, 640x360 
0x12CB3460, 36963313226474608, 231733621, 231733624, 3, 640x360 
0x12CB3460, 36963313226795968, 231733661, 231733664, 3, 640x360 
0x12CB3460, 36963313227116176, 231733690, 231733694, 4, 640x360 
0x12CB3460, 36963313227436896, 231733720, 231733723, 3, 640x360 
0x12CB3460, 36963313227754832, 231733750, 231733753, 3, 640x360 
0x12CB3460, 36963313228076216, 231733790, 231733793, 3, 640x360 
0x12CB3460, 36963313228395392, 231733820, 231733822, 2, 640x360 
0x12CB3460, 36963313228717704, 231733873, 231733876, 3, 640x360 
0x12CB3460, 36963313229037056, 231733880, 231733884, 4, 640x360 
0x12CB3460, 36963313229355664, 231733910, 231733913, 3, 640x360 
0x12CB3460, 36963313229676176, 231733940, 231733944, 4, 640x360 
0x12CB3460, 36963313230157984, 231733991, 231733995, 4, 640x360 
0x12CB3460, 36963313230476200, 231734020, 231734023, 3, 640x360 
0x12CB3460, 36963313230796160, 231734061, 231734064, 3, 640x360 
0x12CB3460, 36963313231114304, 231734090, 231734093, 3, 640x360 
0x12CB3460, 36963313231434568, 231734119, 231734122, 3, 640x360 
0x12CB3460, 36963313231755248, 231734151, 231734156, 5, 640x360 
0x12CB3460, 36963313232077512, 231734181, 231734185, 4, 640x360 
0x12CB3460, 36963313232399232, 231734219, 231734222, 3, 640x360 
0x12CB3460, 36963313232715184, 231734250, 231734253, 3, 640x360 
0x12CB3460, 36963313233034568, 231734279, 231734282, 3, 640x360 
0x12CB3460, 36963313233357592, 231734310, 231734313, 3, 640x360 
0x12CB3460, 36963313233837608, 231734391, 231734397, 6, 640x360 
0x12CB3460, 36963313234474648, 231734421, 231734423, 2, 640x360 
0x12CB3460, 36963313234796616, 231734459, 231734462, 3, 640x360 
0x12CB3460, 36963313235117176, 231734491, 231734494, 3, 640x360 
0x12CB3460, 36963313235437888, 231734520, 231734523, 3, 640x360 
0x12CB3460, 36963313235756000, 231734551, 231734554, 3, 640x360 
0x12CB3460, 36963313236074280, 231734580, 231734584, 4, 640x360 
0x12CB3460, 36963313236396904, 231734620, 231734622, 2, 640x360 
0x12CB3460, 36963313236717568, 231734650, 231734654, 4, 640x360 
0x12CB3460, 36963313237036088, 231734680, 231734683, 3, 640x360 
0x12CB3460, 36963313237355600, 231734710, 231734714, 4, 640x360 
0x12CB3460, 36963313237836464, 231734760, 231734763, 3, 640x360 
0x12CB3460, 36963313238156736, 231734791, 231734794, 3, 640x360 
0x12CB3460, 36963313238475712, 231734821, 231734825, 4, 640x360 
0x12CB3460, 36963313238797184, 231734887, 231734891, 4, 640x360 
0x12CB3460, 36963313239434896, 231734920, 231734924, 4, 640x360 
0x12CB3460, 36963313239755336, 231734951, 231734953, 2, 640x360 
0x12CB3460, 36963313240074584, 231734981, 231734984, 3, 640x360 
0x12CB3460, 36963313240395224, 231735020, 231735022, 2, 640x360 
0x12CB3460, 36963313240718352, 231735050, 231735054, 4, 640x360 
0x12CB3460, 36963313241036144, 231735080, 231735083, 3, 640x360 
0x12CB3460, 36963313241355312, 231735110, 231735113, 3, 640x360 
0x12CB3460, 36963313241836280, 231735160, 231735163, 3, 640x360 
0x12CB3460, 36963313242156840, 231735191, 231735194, 3, 640x360 
0x12CB3460, 36963313242474608, 231735222, 231735225, 3, 640x360 
0x12CB3460, 36963313242796616, 231735260, 231735263, 3, 640x360 
0x12CB3460, 36963313243117312, 231735290, 231735293, 3, 640x360 
0x12CB3460, 36963313243435800, 231735320, 231735323, 3, 640x360 
0x12CB3460, 36963313243754520, 231735373, 231735376, 3, 640x360 
0x12CB3460, 36963313244074448, 231735381, 231735386, 5, 640x360 
0x12CB3460, 36963313244395536, 231735420, 231735423, 3, 640x360 
0x12CB3460, 36963313244715472, 231735450, 231735453, 3, 640x360 
0x12CB3460, 36963313245035304, 231735480, 231735483, 3, 640x360 
0x12CB3460, 36963313245516576, 231735530, 231735533, 3, 640x360 
0x12CB3460, 36963313245837640, 231735561, 231735563, 2, 640x360 
0x12CB3460, 36963313246157168, 231735590, 231735594, 4, 640x360 
0x12CB3460, 36963313246478552, 231735631, 231735634, 3, 640x360 
0x12CB3460, 36963313246801648, 231735662, 231735665, 3, 640x360 
0x12CB3460, 36963313247114832, 231735690, 231735693, 3, 640x360 
0x12CB3460, 36963313247436752, 231735721, 231735724, 3, 640x360 
0x12CB3460, 36963313247755136, 231735750, 231735753, 3, 640x360 
0x12CB3460, 36963313248075768, 231735781, 231735785, 4, 640x360 
0x12CB3460, 36963313248396992, 231735821, 231735824, 3, 640x360 
0x12CB3460, 36963313248720584, 231735851, 231735884, 33, 640x360 
0x12CB3460, 36963313249038072, 231735895, 231735898, 3, 640x360 
0x12CB3460, 36963313249515960, 231735930, 231735932, 2, 640x360 
0x12CB3460, 36963313249836464, 231735959, 231735962, 3, 640x360 
0x12CB3460, 36963313250154896, 231735992, 231735995, 3, 640x360 
0x12CB3460, 36963313250475888, 231736031, 231736035, 4, 640x360 
0x12CB3460, 36963313250795184, 231736061, 231736064, 3, 640x360 
0x12CB3460, 36963313251114416, 231736090, 231736093, 3, 640x360 
0x12CB3460, 36963313251435960, 231736121, 231736124, 3, 640x360 
0x12CB3460, 36963313251755712, 231736150, 231736155, 5, 640x360 
0x12CB3460, 36963313252075608, 231736181, 231736184, 3, 640x360 
0x12CB3460, 36963313252395136, 231736219, 231736222, 3, 640x360 
0x12CB3460, 36963313252717088, 231736250, 231736253, 3, 640x360 
0x12CB3460, 36963313253036080, 231736279, 231736282, 3, 640x360 
0x12CB3460, 36963313253514728, 231736331, 231736333, 2, 640x360 
0x12CB3460, 36963313253842616, 231736381, 231736383, 2, 640x360 
0x12CB3460, 36963313254154216, 231736391, 231736394, 3, 640x360 
0x12CB3460, 36963313254474320, 231736421, 231736424, 3, 640x360 
0x12CB3460, 36963313254795000, 231736460, 231736462, 2, 640x360 
0x12CB3460, 36963313255114984, 231736490, 231736493, 3, 640x360 
0x12CB3460, 36963313255434912, 231736520, 231736523, 3, 640x360 
0x12CB3460, 36963313255755560, 231736550, 231736554, 4, 640x360 
0x12CB3460, 36963313256075512, 231736590, 231736593, 3, 640x360 
0x12CB3460, 36963313256395904, 231736620, 231736622, 2, 640x360 
0x12CB3460, 36963313256716800, 231736651, 231736655, 4, 640x360 
0x12CB3460, 36963313257195968, 231736701, 231736703, 2, 640x360 
0x12CB3460, 36963313257515224, 231736729, 231736732, 3, 640x360 
0x12CB3460, 36963313257836320, 231736760, 231736762, 2, 640x360 
0x12CB3460, 36963313258156304, 231736791, 231736794, 3, 640x360 
0x12CB3460, 36963313258476192, 231736830, 231736833, 3, 640x360 
0x12CB3460, 36963313258797712, 231736880, 231736887, 7, 640x360 
0x12CB3460, 36963313259116928, 231736891, 231736897, 6, 640x360 
0x12CB3460, 36963313259434136, 231736920, 231736922, 2, 640x360 
0x12CB3460, 36963313259755752, 231736950, 231736953, 3, 640x360 
0x12CB3460, 36963313260076648, 231736991, 231736994, 3, 640x360 
0x12CB3460, 36963313260396464, 231737020, 231737023, 3, 640x360 
0x12CB3460, 36963313260719440, 231737050, 231737053, 3, 640x360 
0x12CB3460, 36963313261195232, 231737100, 231737102, 2, 640x360 
0x12CB3460, 36963313261514400, 231737129, 231737132, 3, 640x360 
0x12CB3460, 36963313261836568, 231737160, 231737163, 3, 640x360 
0x12CB3460, 36963313262155744, 231737191, 231737194, 3, 640x360 
0x12CB3460, 36963313262476248, 231737223, 231737227, 4, 640x360 
0x12CB3460, 36963313262796240, 231737261, 231737263, 2, 640x360 
0x12CB3460, 36963313263116200, 231737290, 231737293, 3, 640x360 
0x12CB3460, 36963313263436568, 231737320, 231737323, 3, 640x360 
0x12CB3460, 36963313263755184, 231737350, 231737353, 3, 640x360 
0x12CB3460, 36963313264075464, 231737380, 231737384, 4, 640x360 
0x12CB3460, 36963313264395040, 231737420, 231737422, 2, 640x360 
0x12CB3460, 36963313264876056, 231737471, 231737474, 3, 640x360 
0x12CB3460, 36963313265195080, 231737500, 231737503, 3, 640x360 
0x12CB3460, 36963313265514168, 231737530, 231737532, 2, 640x360 
0x12CB3460, 36963313265836432, 231737560, 231737563, 3, 640x360 
0x12CB3460, 36963313266156600, 231737590, 231737593, 3, 640x360 
0x12CB3460, 36963313266477784, 231737630, 231737633, 3, 640x360 
0x12CB3460, 36963313266797784, 231737662, 231737665, 3, 640x360 
0x12CB3460, 36963313267115488, 231737690, 231737693, 3, 640x360 
0x12CB3460, 36963313267435488, 231737722, 231737724, 2, 640x360 
0x12CB3460, 36963313267758800, 231737750, 231737753, 3, 640x360 
0x12CB3460, 36963313268075888, 231737791, 231737793, 2, 640x360 
0x12CB3460, 36963313268396536, 231737820, 231737824, 4, 640x360 
0x12CB3460, 36963313268884392, 231737882, 231737885, 3, 640x360 
0x12CB3460, 36963313269195576, 231737900, 231737903, 3, 640x360 
0x12CB3460, 36963313269515656, 231737929, 231737932, 3, 640x360 
0x12CB3460, 36963313269834944, 231737961, 231737963, 2, 640x360 
0x12CB3460, 36963313270156912, 231737991, 231737995, 4, 640x360 
0x12CB3460, 36963313270475664, 231738031, 231738034, 3, 640x360 
0x12CB3460, 36963313270795768, 231738060, 231738063, 3, 640x360 
0x12CB3460, 36963313271114656, 231738089, 231738092, 3, 640x360 
0x12CB3460, 36963313271435568, 231738120, 231738122, 2, 640x360 
0x12CB3460, 36963313271756544, 231738149, 231738153, 4, 640x360 
0x12CB3460, 36963313272077024, 231738182, 231738186, 4, 640x360 
0x12CB3460, 36963313272400544, 231738220, 231738223, 3, 640x360 
0x12CB3460, 36963313272875696, 231738261, 231738264, 3, 640x360 
0x12CB3460, 36963313273194408, 231738300, 231738303, 3, 640x360 
0x12CB3460, 36963313273515424, 231738331, 231738333, 2, 640x360 
0x12CB3460, 36963313273838864, 231738372, 231738375, 3, 640x360 
0x12CB3460, 36963313274154480, 231738390, 231738393, 3, 640x360 
0x12CB3460, 36963313274475744, 231738430, 231738432, 2, 640x360 
0x12CB3460, 36963313274795392, 231738459, 231738462, 3, 640x360 
0x12CB3460, 36963313275116200, 231738491, 231738494, 3, 640x360 
0x12CB3460, 36963313275436248, 231738521, 231738523, 2, 640x360 
0x12CB3460, 36963313275755680, 231738551, 231738555, 4, 640x360 
0x12CB3460, 36963313276075568, 231738581, 231738584, 3, 640x360 
0x12CB3460, 36963313276556896, 231738630, 231738634, 4, 640x360 
0x12CB3460, 36963313276877936, 231738670, 231738673, 3, 640x360 
0x12CB3460, 36963313277196960, 231738700, 231738703, 3, 640x360 
0x12CB3460, 36963313277515024, 231738730, 231738732, 2, 640x360 
0x12CB3460, 36963313277835656, 231738760, 231738762, 2, 640x360 
0x12CB3460, 36963313278156024, 231738789, 231738793, 4, 640x360 
0x12CB3460, 36963313278475936, 231738830, 231738832, 2, 640x360 
0x12CB3460, 36963313278795600, 231738887, 231738890, 3, 640x360 
0x12CB3460, 36963313279434120, 231738920, 231738938, 18, 640x360 
0x12CB3460, 36963313279755912, 231738951, 231738954, 3, 640x360 
0x12CB3460, 36963313280076616, 231738981, 231738985, 4, 640x360 
0x12CB3460, 36963313280557720, 231739030, 231739034, 4, 640x360 
0x12CB3460, 36963313280875944, 231739070, 231739073, 3, 640x360 
0x12CB3460, 36963313281194128, 231739100, 231739102, 2, 640x360 
0x12CB3460, 36963313281516648, 231739130, 231739133, 3, 640x360 
0x12CB3460, 36963313281836592, 231739160, 231739163, 3, 640x360 
0x12CB3460, 36963313282157048, 231739189, 231739193, 4, 640x360 
0x12CB3460, 36963313282475640, 231739221, 231739224, 3, 640x360 
0x12CB3460, 36963313282794712, 231739261, 231739263, 2, 640x360 
0x12CB3460, 36963313283114648, 231739290, 231739293, 3, 640x360 
0x12CB3460, 36963313283437000, 231739321, 231739324, 3, 640x360 
0x12CB3460, 36963313283757424, 231739384, 231739387, 3, 640x360 
0x12CB3460, 36963313284554032, 231739430, 231739433, 3, 640x360 
0x12CB3460, 36963313284875848, 231739461, 231739465, 4, 640x360 
0x12CB3460, 36963313285195632, 231739500, 231739503, 3, 640x360 
0x12CB3460, 36963313285516488, 231739531, 231739534, 3, 640x360 
0x12CB3460, 36963313285836576, 231739560, 231739563, 3, 640x360 
0x12CB3460, 36963313286155928, 231739592, 231739596, 4, 640x360 
0x12CB3460, 36963313286477224, 231739631, 231739635, 4, 640x360 
0x12CB3460, 36963313286800728, 231739662, 231739666, 4, 640x360 
0x12CB3460, 36963313287116736, 231739689, 231739692, 3, 640x360 
0x12CB3460, 36963313287440136, 231739723, 231739726, 3, 640x360 
0x12CB3460, 36963313287755152, 231739749, 231739752, 3, 640x360 
0x12CB3460, 36963313288235424, 231739800, 231739803, 3, 640x360 
0x12CB3460, 36963313288557024, 231739830, 231739845, 15, 640x360 
0x12CB3460, 36963313288876296, 231739882, 231739886, 4, 640x360 
0x12CB3460, 36963313289194408, 231739893, 231739897, 4, 640x360 
0x12CB3460, 36963313289515728, 231739930, 231739932, 2, 640x360 
0x12CB3460, 36963313289834848, 231739959, 231739962, 3, 640x360 
0x12CB3460, 36963313290155744, 231739990, 231739994, 4, 640x360 
0x12CB3460, 36963313290474440, 231740021, 231740023, 2, 640x360 
0x12CB3460, 36963313290795968, 231740060, 231740065, 5, 640x360 
0x12CB3460, 36963313291113976, 231740090, 231740092, 2, 640x360 
0x12CB3460, 36963313291436216, 231740119, 231740122, 3, 640x360 
0x12CB3460, 36963313291756608, 231740150, 231740154, 4, 640x360 
0x12CB3460, 36963313292235680, 231740201, 231740204, 3, 640x360 
0x12CB3460, 36963313292555680, 231740230, 231740237, 7, 640x360 
0x12CB3460, 36963313292874224, 231740271, 231740274, 3, 640x360 
0x12CB3460, 36963313293194328, 231740300, 231740303, 3, 640x360 
0x12CB3460, 36963313293514296, 231740330, 231740333, 3, 640x360 
0x12CB3460, 36963313293835424, 231740382, 231740391, 9, 640x360 
0x12CB3460, 36963313294155304, 231740392, 231740395, 3, 640x360 
0x12CB3460, 36963313294473816, 231740421, 231740424, 3, 640x360 
0x12CB3460, 36963313294795520, 231740460, 231740462, 2, 640x360 
0x12CB3460, 36963313295115112, 231740491, 231740495, 4, 640x360 
0x12CB3460, 36963313295435976, 231740520, 231740524, 4, 640x360 
0x12CB3460, 36963313295756088, 231740550, 231740553, 3, 640x360 
0x12CB3460, 36963313296235552, 231740599, 231740602, 3, 640x360 
0x12CB3460, 36963313296553912, 231740631, 231740634, 3, 640x360 
0x12CB3460, 36963313296875136, 231740670, 231740674, 4, 640x360 
0x12CB3460, 36963313297195032, 231740700, 231740717, 17, 640x360 
0x12CB3460, 36963313297515528, 231740731, 231740733, 2, 640x360 
0x12CB3460, 36963313297835600, 231740760, 231740762, 2, 640x360 
0x12CB3460, 36963313298155808, 231740791, 231740794, 3, 640x360 
0x12CB3460, 36963313298475472, 231740831, 231740834, 3, 640x360 
0x12CB3460, 36963313298797872, 231740888, 231740891, 3, 640x360 
0x12CB3460, 36963313299435616, 231740920, 231740923, 3, 640x360 
0x12CB3460, 36963313299914312, 231740970, 231740973, 3, 640x360 
0x12CB3460, 36963313300237344, 231741000, 231741004, 4, 640x360 
0x12CB3460, 36963313300556712, 231741030, 231741034, 4, 640x360 
0x12CB3460, 36963313300875240, 231741070, 231741073, 3, 640x360 
0x12CB3460, 36963313301194168, 231741099, 231741102, 3, 640x360 
0x12CB3460, 36963313301515464, 231741130, 231741133, 3, 640x360 
0x12CB3460, 36963313301835720, 231741160, 231741163, 3, 640x360 
0x12CB3460, 36963313302158328, 231741191, 231741194, 3, 640x360 
0x12CB3460, 36963313302473952, 231741220, 231741224, 4, 640x360 
0x12CB3460, 36963313302794912, 231741260, 231741270, 10, 640x360 
0x12CB3460, 36963313303114648, 231741289, 231741292, 3, 640x360 
0x12CB3460, 36963313303435320, 231741320, 231741323, 3, 640x360 
0x12CB3460, 36963313303914464, 231741373, 231741385, 12, 640x360 
0x12CB3460, 36963313304238576, 231741400, 231741403, 3, 640x360 
0x12CB3460, 36963313304553856, 231741430, 231741432, 2, 640x360 
0x12CB3460, 36963313304875664, 231741460, 231741464, 4, 640x360 
0x12CB3460, 36963313305194496, 231741500, 231741503, 3, 640x360 
0x12CB3460, 36963313305515864, 231741529, 231741532, 3, 640x360 
0x12CB3460, 36963313305835968, 231741560, 231741563, 3, 640x360 
0x12CB3460, 36963313306155568, 231741590, 231741595, 5, 640x360 
0x12CB3460, 36963313306474912, 231741621, 231741624, 3, 640x360 
0x12CB3460, 36963313306795744, 231741661, 231741664, 3, 640x360 
0x12CB3460, 36963313307115240, 231741690, 231741693, 3, 640x360 
0x12CB3460, 36963313307596584, 231741739, 231741742, 3, 640x360 
0x12CB3460, 36963313307913936, 231741770, 231741773, 3, 640x360 
0x12CB3460, 36963313308238040, 231741800, 231741802, 2, 640x360 
0x12CB3460, 36963313308557168, 231741831, 231741834, 3, 640x360 
0x12CB3460, 36963313308881152, 231741894, 231741898, 4, 640x360 
0x12CB3460, 36963313309515384, 231741929, 231741932, 3, 640x360 
0x12CB3460, 36963313309836488, 231741961, 231741963, 2, 640x360 
0x12CB3460, 36963313310156384, 231741990, 231741994, 4, 640x360 
0x12CB3460, 36963313310476192, 231742031, 231742035, 4, 640x360 
0x12CB3460, 36963313310795152, 231742060, 231742064, 4, 640x360 
0x12CB3460, 36963313311114088, 231742090, 231742092, 2, 640x360 
0x12CB3460, 36963313311595632, 231742141, 231742144, 3, 640x360 
0x12CB3460, 36963313311915984, 231742170, 231742173, 3, 640x360 
0x12CB3460, 36963313312236936, 231742201, 231742204, 3, 640x360 
0x12CB3460, 36963313312557360, 231742230, 231742234, 4, 640x360 
0x12CB3460, 36963313312874288, 231742270, 231742273, 3, 640x360 
0x12CB3460, 36963313313195792, 231742300, 231742302, 2, 640x360 
0x12CB3460, 36963313313513968, 231742330, 231742332, 2, 640x360 
0x12CB3460, 36963313313839696, 231742371, 231742374, 3, 640x360 
0x12CB3460, 36963313314155312, 231742390, 231742393, 3, 640x360 
0x12CB3460, 36963313314475768, 231742430, 231742434, 4, 640x360 
0x12CB3460, 36963313314794400, 231742460, 231742462, 2, 640x360 
0x12CB3460, 36963313315114752, 231742491, 231742494, 3, 640x360 
0x12CB3460, 36963313315594672, 231742540, 231742543, 3, 640x360 
0x12CB3460, 36963313315916280, 231742571, 231742574, 3, 640x360 
0x12CB3460, 36963313316235544, 231742601, 231742604, 3, 640x360 
0x12CB3460, 36963313316555968, 231742630, 231742633, 3, 640x360 
0x12CB3460, 36963313316878480, 231742670, 231742673, 3, 640x360 
0x12CB3460, 36963313317195328, 231742699, 231742702, 3, 640x360 
0x12CB3460, 36963313317517640, 231742731, 231742734, 3, 640x360 
0x12CB3460, 36963313317834808, 231742760, 231742764, 4, 640x360 
0x12CB3460, 36963313318155464, 231742791, 231742794, 3, 640x360 
0x12CB3460, 36963313318475144, 231742831, 231742834, 3, 640x360 
0x12CB3460, 36963313318796968, 231742876, 231742879, 3, 640x360 
0x12CB3460, 36963313319275040, 231742902, 231742905, 3, 640x360 
0x12CB3460, 36963313319595512, 231742940, 231742943, 3, 640x360 
0x12CB3460, 36963313319915672, 231742970, 231742973, 3, 640x360 
0x12CB3460, 36963313320234920, 231743001, 231743004, 3, 640x360 
0x12CB3460, 36963313320555936, 231743031, 231743034, 3, 640x360 
0x12CB3460, 36963313320875664, 231743071, 231743074, 3, 640x360 
0x12CB3460, 36963313321194592, 231743100, 231743103, 3, 640x360 
0x12CB3460, 36963313321514832, 231743130, 231743133, 3, 640x360 
0x12CB3460, 36963313321835840, 231743160, 231743163, 3, 640x360 
0x12CB3460, 36963313322156336, 231743191, 231743194, 3, 640x360 
0x12CB3460, 36963313322477184, 231743223, 231743227, 4, 640x360 
0x12CB3460, 36963313322794720, 231743260, 231743263, 3, 640x360 
0x12CB3460, 36963313323276240, 231743309, 231743312, 3, 640x360 
0x12CB3460, 36963313323597640, 231743341, 231743344, 3, 640x360 
0x12CB3460, 36963313323919272, 231743375, 231743379, 4, 640x360 
0x12CB3460, 36963313324234384, 231743400, 231743405, 5, 640x360 
0x12CB3460, 36963313324553648, 231743430, 231743433, 3, 640x360 
0x12CB3460, 36963313324874512, 231743470, 231743473, 3, 640x360 
0x12CB3460, 36963313325197032, 231743500, 231743503, 3, 640x360 
0x12CB3460, 36963313325516952, 231743529, 231743533, 4, 640x360 
0x12CB3460, 36963313325836464, 231743560, 231743563, 3, 640x360 
0x12CB3460, 36963313326157944, 231743590, 231743594, 4, 640x360 
0x12CB3460, 36963313326476040, 231743630, 231743633, 3, 640x360 
0x12CB3460, 36963313326795696, 231743660, 231743663, 3, 640x360 
0x12CB3460, 36963313327275592, 231743701, 231743705, 4, 640x360 
0x12CB3460, 36963313327596520, 231743733, 231743737, 4, 640x360 
0x12CB3460, 36963313327915296, 231743770, 231743773, 3, 640x360 
0x12CB3460, 36963313328236568, 231743800, 231743803, 3, 640x360 
0x12CB3460, 36963313328555800, 231743831, 231743833, 2, 640x360 
0x12CB3460, 36963313328877792, 231743880, 231743883, 3, 640x360 
0x12CB3460, 36963313329193936, 231743900, 231743903, 3, 640x360 
0x12CB3460, 36963313329513656, 231743929, 231743932, 3, 640x360 
0x12CB3460, 36963313329835392, 231743960, 231743963, 3, 640x360 
0x12CB3460, 36963313330156696, 231743990, 231743994, 4, 640x360 
0x12CB3460, 36963313330475856, 231744031, 231744034, 3, 640x360 
0x12CB3460, 36963313330954968, 231744071, 231744073, 2, 640x360 
0x12CB3460, 36963313331275664, 231744110, 231744120, 10, 640x360 
0x12CB3460, 36963313331594320, 231744139, 231744142, 3, 640x360 
0x12CB3460, 36963313331914488, 231744171, 231744174, 3, 640x360 
0x12CB3460, 36963313332235200, 231744200, 231744203, 3, 640x360 
0x12CB3460, 36963313332558536, 231744233, 231744236, 3, 640x360 
0x12CB3460, 36963313332874656, 231744260, 231744263, 3, 640x360 
0x12CB3460, 36963313333194064, 231744300, 231744302, 2, 640x360 
0x12CB3460, 36963313333514800, 231744330, 231744333, 3, 640x360 
0x12CB3460, 36963313333835704, 231744372, 231744375, 3, 640x360 
0x12CB3460, 36963313334154464, 231744389, 231744393, 4, 640x360 
0x12CB3460, 36963313334474784, 231744421, 231744424, 3, 640x360 
0x12CB3460, 36963313334955744, 231744470, 231744488, 18, 640x360 
0x12CB3460, 36963313335276392, 231744510, 231744513, 3, 640x360 
0x12CB3460, 36963313335596872, 231744541, 231744544, 3, 640x360 
0x12CB3460, 36963313335915600, 231744571, 231744575, 4, 640x360 
0x12CB3460, 36963313336238144, 231744600, 231744603, 3, 640x360 
0x12CB3460, 36963313336555208, 231744629, 231744633, 4, 640x360 
0x12CB3460, 36963313337194952, 231744700, 231744703, 3, 640x360 
0x12CB3460, 36963313337516872, 231744730, 231744733, 3, 640x360 
0x12CB3460, 36963313338636592, 231744841, 231744844, 3, 640x360 
0x12CB3460, 36963313339594144, 231744940, 231744943, 3, 640x360 
0x12CB3460, 36963313340876832, 231745061, 231745064, 3, 640x360 
0x12CB3460, 36963313341194696, 231745101, 231745103, 2, 640x360 
0x12CB3460, 36963313341836720, 231745159, 231745162, 3, 640x360 
0x12CB3460, 36963313342155480, 231745191, 231745194, 3, 640x360 
0x12CB3460, 36963313342634704, 231745240, 231745242, 2, 640x360 
0x12CB3460, 36963313342955496, 231745270, 231745273, 3, 640x360 
0x12CB3460, 36963313343275496, 231745310, 231745313, 3, 640x360 
0x12CB3460, 36963313343594576, 231745340, 231745343, 3, 640x360 
0x12CB3460, 36963313343921576, 231745381, 231745384, 3, 640x360 
0x12CB3460, 36963313344234056, 231745400, 231745403, 3, 640x360 
0x12CB3460, 36963313344875560, 231745460, 231745464, 4, 640x360 
0x12CB3460, 36963313345195944, 231745501, 231745504, 3, 640x360 
0x12CB3460, 36963313345518000, 231745530, 231745534, 4, 640x360 
0x12CB3460, 36963313345835784, 231745561, 231745564, 3, 640x360 
0x12CB3460, 36963313346154736, 231745590, 231745594, 4, 640x360 
0x12CB3460, 36963313346637448, 231745640, 231745643, 3, 640x360 
0x12CB3460, 36963313346953984, 231745671, 231745674, 3, 640x360 
0x12CB3460, 36963313347276200, 231745709, 231745712, 3, 640x360 
0x12CB3460, 36963313347595424, 231745741, 231745745, 4, 640x360 
0x12CB3460, 36963313347913704, 231745770, 231745773, 3, 640x360 
0x12CB3460, 36963313348236032, 231745801, 231745803, 2, 640x360 
0x12CB3460, 36963313348556184, 231745831, 231745834, 3, 640x360 
0x12CB3460, 36963313348880376, 231745874, 231745877, 3, 640x360 
0x12CB3460, 36963313349193832, 231745899, 231745902, 3, 640x360 
0x12CB3460, 36963313349514040, 231745930, 231745933, 3, 640x360 
0x12CB3460, 36963313350316952, 231746010, 231746014, 4, 640x360 
0x12CB3460, 36963313350954456, 231746070, 231746073, 3, 640x360 
0x12CB3460, 36963313351275064, 231746101, 231746105, 4, 640x360 
0x12CB3460, 36963313351917864, 231746170, 231746173, 3, 640x360 
0x12CB3460, 36963313352235464, 231746201, 231746204, 3, 640x360 
0x12CB3460, 36963313352555752, 231746232, 231746236, 4, 640x360 
0x12CB3460, 36963313352874880, 231746270, 231746273, 3, 640x360 
0x12CB3460, 36963313353194408, 231746299, 231746302, 3, 640x360 
0x12CB3460, 36963313353514840, 231746330, 231746344, 14, 640x360 
0x12CB3460, 36963313353835720, 231746380, 231746383, 3, 640x360 
0x12CB3460, 36963313354318224, 231746410, 231746413, 3, 640x360 
0x12CB3460, 36963313354635248, 231746440, 231746442, 2, 640x360 
0x12CB3460, 36963313354955824, 231746469, 231746473, 4, 640x360 
0x12CB3460, 36963313355595144, 231746541, 231746544, 3, 640x360 
0x12CB3460, 36963313355914088, 231746570, 231746573, 3, 640x360 
0x12CB3460, 36963313356553936, 231746631, 231746633, 2, 640x360 
0x12CB3460, 36963313356875144, 231746661, 231746665, 4, 640x360 
0x12CB3460, 36963313358640024, 231746840, 231746843, 3, 640x360 
0x12CB3460, 36963313358954856, 231746881, 231746884, 3, 640x360 
0x12CB3460, 36963313359273936, 231746900, 231746904, 4, 640x360 
0x12CB3460, 36963313359595408, 231746940, 231746943, 3, 640x360 
0x12CB3460, 36963313359915712, 231746970, 231746973, 3, 640x360 
0x12CB3460, 36963313360237104, 231747001, 231747004, 3, 640x360 
0x12CB3460, 36963313360875264, 231747070, 231747072, 2, 640x360 
0x12CB3460, 36963313361515568, 231747130, 231747145, 15, 640x360 
0x12CB3460, 36963313361994392, 231747181, 231747184, 3, 640x360 
0x12CB3460, 36963313362314584, 231747210, 231747213, 3, 640x360 
0x12CB3460, 36963313362634840, 231747240, 231747243, 3, 640x360 
0x12CB3460, 36963313362953840, 231747270, 231747273, 3, 640x360 
0x12CB3460, 36963313363595744, 231747340, 231747343, 3, 640x360 
0x12CB3460, 36963313364234168, 231747400, 231747403, 3, 640x360 
0x12CB3460, 36963313364875360, 231747461, 231747465, 4, 640x360 
0x12CB3460, 36963313365195144, 231747499, 231747503, 4, 640x360 
0x12CB3460, 36963313365994600, 231747579, 231747582, 3, 640x360 
0x12CB3460, 36963313366315720, 231747610, 231747613, 3, 640x360 
0x12CB3460, 36963313366634840, 231747640, 231747643, 3, 640x360 
0x12CB3460, 36963313366954736, 231747669, 231747673, 4, 640x360 
0x12CB3460, 36963313367274000, 231747701, 231747705, 4, 640x360 
0x12CB3460, 36963313367595048, 231747740, 231747743, 3, 640x360 
0x12CB3460, 36963313367913720, 231747770, 231747772, 2, 640x360 
0x12CB3460, 36963313368556096, 231747830, 231747833, 3, 640x360 
0x12CB3460, 36963313369194704, 231747900, 231747905, 5, 640x360 
0x12CB3460, 36963313369515504, 231747930, 231747932, 2, 640x360 
0x12CB3460, 36963313369995848, 231747980, 231747983, 3, 640x360 
0x12CB3460, 36963313370314944, 231748010, 231748013, 3, 640x360 
0x12CB3460, 36963313370953232, 231748070, 231748073, 3, 640x360 
0x12CB3460, 36963313371275048, 231748101, 231748105, 4, 640x360 
0x12CB3460, 36963313371914608, 231748170, 231748173, 3, 640x360 
0x12CB3460, 36963313372235608, 231748200, 231748202, 2, 640x360 
0x12CB3460, 36963313372556240, 231748232, 231748235, 3, 640x360 
0x12CB3460, 36963313372873560, 231748260, 231748264, 4, 640x360 
0x12CB3460, 36963313373194416, 231748300, 231748302, 2, 640x360 
0x12CB3460, 36963313373674592, 231748367, 231748371, 4, 640x360 
0x12CB3460, 36963313373993632, 231748375, 231748378, 3, 640x360 
0x12CB3460, 36963313374313344, 231748409, 231748412, 3, 640x360 
0x12CB3460, 36963313374634864, 231748440, 231748443, 3, 640x360 
0x12CB3460, 36963313374955120, 231748470, 231748473, 3, 640x360 
0x12CB3460, 36963313375274632, 231748500, 231748504, 4, 640x360 
0x12CB3460, 36963313375594664, 231748540, 231748543, 3, 640x360 
0x12CB3460, 36963313375914496, 231748570, 231748575, 5, 640x360 
0x12CB3460, 36963313376235720, 231748600, 231748603, 3, 640x360 
0x12CB3460, 36963313376554256, 231748630, 231748632, 2, 640x360 
0x12CB3460, 36963313376875152, 231748670, 231748688, 18, 640x360 
0x12CB3460, 36963313377196624, 231748700, 231748703, 3, 640x360 
0x12CB3460, 36963313377674608, 231748742, 231748745, 3, 640x360 
0x12CB3460, 36963313377993816, 231748780, 231748782, 2, 640x360 
0x12CB3460, 36963313378313928, 231748810, 231748813, 3, 640x360 
0x12CB3460, 36963313378636096, 231748840, 231748843, 3, 640x360 
0x12CB3460, 36963313378953896, 231748871, 231748874, 3, 640x360 
0x12CB3460, 36963313379274904, 231748909, 231748912, 3, 640x360 
0x12CB3460, 36963313379594936, 231748940, 231748943, 3, 640x360 
0x12CB3460, 36963313379913880, 231748970, 231748973, 3, 640x360 
0x12CB3460, 36963313380235864, 231749001, 231749004, 3, 640x360 
0x12CB3460, 36963313380555992, 231749031, 231749035, 4, 640x360 
0x12CB3460, 36963313380874536, 231749070, 231749073, 3, 640x360 
0x12CB3460, 36963313381353352, 231749110, 231749113, 3, 640x360 
0x12CB3460, 36963313381673808, 231749150, 231749153, 3, 640x360 
0x12CB3460, 36963313381993792, 231749179, 231749183, 4, 640x360 
0x12CB3460, 36963313382316152, 231749211, 231749214, 3, 640x360 
0x12CB3460, 36963313382638312, 231749239, 231749243, 4, 640x360 
0x12CB3460, 36963313382953816, 231749271, 231749274, 3, 640x360 
0x12CB3460, 36963313383274528, 231749310, 231749313, 3, 640x360 
0x12CB3460, 36963313383594040, 231749339, 231749343, 4, 640x360 
0x12CB3460, 36963313383916776, 231749381, 231749384, 3, 640x360 
0x12CB3460, 36963313384238584, 231749399, 231749402, 3, 640x360 
0x12CB3460, 36963313384553912, 231749430, 231749433, 3, 640x360 
0x12CB3460, 36963313384874408, 231749471, 231749473, 2, 640x360 
0x12CB3460, 36963313385356688, 231749509, 231749514, 5, 640x360 
0x12CB3460, 36963313385677680, 231749550, 231749555, 5, 640x360 
0x12CB3460, 36963313385995008, 231749580, 231749583, 3, 640x360 
0x12CB3460, 36963313386313856, 231749610, 231749613, 3, 640x360 
0x12CB3460, 36963313386636320, 231749640, 231749643, 3, 640x360 
0x12CB3460, 36963313386955096, 231749670, 231749675, 5, 640x360 
0x12CB3460, 36963313387277768, 231749710, 231749713, 3, 640x360 
0x12CB3460, 36963313387595056, 231749733, 231749737, 4, 640x360 
0x12CB3460, 36963313387914064, 231749770, 231749773, 3, 640x360 
0x12CB3460, 36963313388235080, 231749800, 231749818, 18, 640x360 
0x12CB3460, 36963313388555304, 231749831, 231749834, 3, 640x360 
0x12CB3460, 36963313388880816, 231749873, 231749876, 3, 640x360 
0x12CB3460, 36963313389355000, 231749910, 231749913, 3, 640x360 
0x12CB3460, 36963313389673808, 231749950, 231749953, 3, 640x360 
0x12CB3460, 36963313389993648, 231749980, 231749982, 2, 640x360 
0x12CB3460, 36963313390315688, 231750010, 231750013, 3, 640x360 
0x12CB3460, 36963313390637112, 231750041, 231750044, 3, 640x360 
0x12CB3460, 36963313390955096, 231750071, 231750073, 2, 640x360 
0x12CB3460, 36963313391274888, 231750110, 231750113, 3, 640x360 
0x12CB3460, 36963313391595160, 231750140, 231750143, 3, 640x360 
0x12CB3460, 36963313391914744, 231750170, 231750173, 3, 640x360 
0x12CB3460, 36963313392235128, 231750202, 231750205, 3, 640x360 
0x12CB3460, 36963313392555728, 231750230, 231750234, 4, 640x360 
0x12CB3460, 36963313393035704, 231750280, 231750282, 2, 640x360 
0x12CB3460, 36963313393354288, 231750310, 231750312, 2, 640x360 
0x12CB3460, 36963313393674536, 231750340, 231750344, 4, 640x360 
0x12CB3460, 36963313393994496, 231750373, 231750377, 4, 640x360 
0x12CB3460, 36963313394314352, 231750409, 231750413, 4, 640x360 
0x12CB3460, 36963313394634496, 231750440, 231750442, 2, 640x360 
0x12CB3460, 36963313394953712, 231750471, 231750474, 3, 640x360 
0x12CB3460, 36963313395274008, 231750500, 231750504, 4, 640x360 
0x12CB3460, 36963313395594688, 231750540, 231750543, 3, 640x360 
0x12CB3460, 36963313395915048, 231750570, 231750573, 3, 640x360 
0x12CB3460, 36963313396233752, 231750600, 231750603, 3, 640x360 
0x12CB3460, 36963313396554296, 231750630, 231750634, 4, 640x360 
0x12CB3460, 36963313397035432, 231750679, 231750682, 3, 640x360 
0x12CB3460, 36963313397355704, 231750711, 231750714, 3, 640x360 
0x12CB3460, 36963313397675280, 231750741, 231750744, 3, 640x360 
0x12CB3460, 36963313397994808, 231750773, 231750776, 3, 640x360 
0x12CB3460, 36963313398315232, 231750810, 231750813, 3, 640x360 
0x12CB3460, 36963313398635696, 231750840, 231750843, 3, 640x360 
0x12CB3460, 36963313398957224, 231750890, 231750894, 4, 640x360 
0x12CB3460, 36963313399275144, 231750900, 231750904, 4, 640x360 
0x12CB3460, 36963313399594976, 231750940, 231750942, 2, 640x360 
0x12CB3460, 36963313399915552, 231750970, 231750973, 3, 640x360 
0x12CB3460, 36963313400236176, 231751001, 231751003, 2, 640x360 
0x12CB3460, 36963313400556976, 231751031, 231751034, 3, 640x360 
0x12CB3460, 36963313401033072, 231751079, 231751082, 3, 640x360 
0x12CB3460, 36963313401352832, 231751110, 231751113, 3, 640x360 
0x12CB3460, 36963313401673712, 231751150, 231751153, 3, 640x360 
0x12CB3460, 36963313401996728, 231751180, 231751183, 3, 640x360 
0x12CB3460, 36963313402314440, 231751210, 231751213, 3, 640x360 
0x12CB3460, 36963313402634080, 231751240, 231751243, 3, 640x360 
0x12CB3460, 36963313402954432, 231751271, 231751274, 3, 640x360 
0x12CB3460, 36963313403274152, 231751310, 231751313, 3, 640x360 
0x12CB3460, 36963313403594416, 231751340, 231751343, 3, 640x360 
0x12CB3460, 36963313403914608, 231751370, 231751373, 3, 640x360 
0x12CB3460, 36963313404234824, 231751400, 231751402, 2, 640x360 
0x12CB3460, 36963313404714976, 231751449, 231751453, 4, 640x360 
0x12CB3460, 36963313405035888, 231751480, 231751483, 3, 640x360 
0x12CB3460, 36963313405356064, 231751510, 231751514, 4, 640x360 
0x12CB3460, 36963313405678064, 231751550, 231751553, 3, 640x360 
0x12CB3460, 36963313405998344, 231751579, 231751582, 3, 640x360 
0x12CB3460, 36963313406315240, 231751610, 231751613, 3, 640x360 
0x12CB3460, 36963313406636632, 231751640, 231751643, 3, 640x360 
0x12CB3460, 36963313406956200, 231751670, 231751674, 4, 640x360 
0x12CB3460, 36963313407273688, 231751701, 231751704, 3, 640x360 
0x12CB3460, 36963313407596672, 231751740, 231751743, 3, 640x360 
0x12CB3460, 36963313407915024, 231751770, 231751773, 3, 640x360 
0x12CB3460, 36963313408235280, 231751800, 231751804, 4, 640x360 
0x12CB3460, 36963313408716744, 231751881, 231751883, 2, 640x360 
0x12CB3460, 36963313409354128, 231751910, 231751913, 3, 640x360 
0x12CB3460, 36963313409674736, 231751941, 231751944, 3, 640x360 
0x12CB3460, 36963313409995128, 231751980, 231751983, 3, 640x360 
0x12CB3460, 36963313410315736, 231752009, 231752013, 4, 640x360 
0x12CB3460, 36963313410634584, 231752041, 231752044, 3, 640x360 
0x12CB3460, 36963313410953256, 231752071, 231752073, 2, 640x360 
0x12CB3460, 36963313411274152, 231752100, 231752119, 19, 640x360 
0x12CB3460, 36963313411595352, 231752140, 231752143, 3, 640x360 
0x12CB3460, 36963313411915704, 231752170, 231752173, 3, 640x360 
0x12CB3460, 36963313412235216, 231752200, 231752203, 3, 640x360 
0x12CB3460, 36963313412713544, 231752250, 231752253, 3, 640x360 
0x12CB3460, 36963313413033376, 231752281, 231752283, 2, 640x360 
0x12CB3460, 36963313413355360, 231752310, 231752313, 3, 640x360 
0x12CB3460, 36963313413674000, 231752350, 231752353, 3, 640x360 
0x12CB3460, 36963313413995400, 231752377, 231752381, 4, 640x360 
0x12CB3460, 36963313414314288, 231752410, 231752413, 3, 640x360 
0x12CB3460, 36963313414634456, 231752439, 231752443, 4, 640x360 
0x12CB3460, 36963313414953984, 231752471, 231752474, 3, 640x360 
0x12CB3460, 36963313415275304, 231752511, 231752514, 3, 640x360 
0x12CB3460, 36963313415594864, 231752541, 231752544, 3, 640x360 
0x12CB3460, 36963313415914688, 231752571, 231752574, 3, 640x360 
0x12CB3460, 36963313416396160, 231752620, 231752638, 18, 640x360 
0x12CB3460, 36963313416714712, 231752650, 231752654, 4, 640x360 
0x12CB3460, 36963313417034624, 231752680, 231752683, 3, 640x360 
0x12CB3460, 36963313417356032, 231752709, 231752713, 4, 640x360 
0x12CB3460, 36963313417676232, 231752742, 231752746, 4, 640x360 
0x12CB3460, 36963313417994696, 231752780, 231752783, 3, 640x360 
0x12CB3460, 36963313418315728, 231752810, 231752813, 3, 640x360 
0x12CB3460, 36963313418634704, 231752840, 231752843, 3, 640x360 
0x12CB3460, 36963313418954576, 231752878, 231752880, 2, 640x360 
0x12CB3460, 36963313419274272, 231752901, 231752904, 3, 640x360 
0x12CB3460, 36963313419594664, 231752940, 231752943, 3, 640x360 
0x12CB3460, 36963313419915264, 231752970, 231752973, 3, 640x360 
0x12CB3460, 36963313420394968, 231753020, 231753024, 4, 640x360 
0x12CB3460, 36963313420715080, 231753050, 231753053, 3, 640x360 
0x12CB3460, 36963313421034424, 231753079, 231753081, 2, 640x360 
0x12CB3460, 36963313421354032, 231753109, 231753120, 11, 640x360 
0x12CB3460, 36963313421675144, 231753141, 231753145, 4, 640x360 
0x12CB3460, 36963313421996656, 231753180, 231753184, 4, 640x360 
0x12CB3460, 36963313422314656, 231753210, 231753213, 3, 640x360 
0x12CB3460, 36963313422633080, 231753239, 231753242, 3, 640x360 
0x12CB3460, 36963313422954672, 231753271, 231753274, 3, 640x360 
0x12CB3460, 36963313423273288, 231753310, 231753315, 5, 640x360 
0x12CB3460, 36963313423593632, 231753339, 231753342, 3, 640x360 
0x12CB3460, 36963313424074488, 231753380, 231753385, 5, 640x360 
0x12CB3460, 36963313424394432, 231753419, 231753422, 3, 640x360 
0x12CB3460, 36963313424713072, 231753450, 231753453, 3, 640x360 
0x12CB3460, 36963313425033648, 231753479, 231753482, 3, 640x360 
0x12CB3460, 36963313425355896, 231753510, 231753514, 4, 640x360 
0x12CB3460, 36963313425673936, 231753550, 231753552, 2, 640x360 
0x12CB3460, 36963313425996112, 231753581, 231753584, 3, 640x360 
0x12CB3460, 36963313426316056, 231753610, 231753613, 3, 640x360 
0x12CB3460, 36963313426637448, 231753640, 231753643, 3, 640x360 
0x12CB3460, 36963313426954584, 231753671, 231753673, 2, 640x360 
0x12CB3460, 36963313427275488, 231753711, 231753714, 3, 640x360 
0x12CB3460, 36963313427595792, 231753740, 231753743, 3, 640x360 
0x12CB3460, 36963313428074104, 231753790, 231753795, 5, 640x360 
0x12CB3460, 36963313428394376, 231753819, 231753822, 3, 640x360 
0x12CB3460, 36963313428716552, 231753850, 231753855, 5, 640x360 
0x12CB3460, 36963313429035560, 231753885, 231753888, 3, 640x360 
0x12CB3460, 36963313429354072, 231753910, 231753913, 3, 640x360 
0x12CB3460, 36963313429675008, 231753950, 231753953, 3, 640x360 
0x12CB3460, 36963313429994200, 231753981, 231753983, 2, 640x360 
0x12CB3460, 36963313430316024, 231754010, 231754013, 3, 640x360 
0x12CB3460, 36963313430638904, 231754040, 231754043, 3, 640x360 
0x12CB3460, 36963313430954192, 231754069, 231754073, 4, 640x360 
0x12CB3460, 36963313431273360, 231754100, 231754104, 4, 640x360 
0x12CB3460, 36963313431595064, 231754140, 231754143, 3, 640x360 
0x12CB3460, 36963313432073432, 231754191, 231754194, 3, 640x360 
0x12CB3460, 36963313432396856, 231754220, 231754223, 3, 640x360 
0x12CB3460, 36963313432715856, 231754250, 231754253, 3, 640x360 
0x12CB3460, 36963313433033144, 231754280, 231754283, 3, 640x360 
0x12CB3460, 36963313433354808, 231754310, 231754320, 10, 640x360 
0x12CB3460, 36963313433673736, 231754340, 231754344, 4, 640x360 
0x12CB3460, 36963313433996136, 231754381, 231754383, 2, 640x360 
0x12CB3460, 36963313434314248, 231754410, 231754413, 3, 640x360 
0x12CB3460, 36963313434633096, 231754440, 231754443, 3, 640x360 
0x12CB3460, 36963313434953816, 231754470, 231754473, 3, 640x360 
0x12CB3460, 36963313435275528, 231754501, 231754504, 3, 640x360 
0x12CB3460, 36963313435754248, 231754550, 231754553, 3, 640x360 
0x12CB3460, 36963313436073096, 231754580, 231754584, 4, 640x360 
0x12CB3460, 36963313436398168, 231754620, 231754623, 3, 640x360 
0x12CB3460, 36963313436714016, 231754650, 231754656, 6, 640x360 
0x12CB3460, 36963313437034752, 231754680, 231754683, 3, 640x360 
0x12CB3460, 36963313437355200, 231754710, 231754713, 3, 640x360 
0x12CB3460, 36963313437674288, 231754741, 231754745, 4, 640x360 
0x12CB3460, 36963313437995264, 231754780, 231754783, 3, 640x360 
0x12CB3460, 36963313438313560, 231754809, 231754812, 3, 640x360 
0x12CB3460, 36963313438636168, 231754841, 231754844, 3, 640x360 
0x12CB3460, 36963313438955312, 231754874, 231754877, 3, 640x360 
0x12CB3460, 36963313439273184, 231754900, 231754904, 4, 640x360 
0x12CB3460, 36963313439754768, 231754950, 231754953, 3, 640x360 
0x12CB3460, 36963313440075368, 231754990, 231754993, 3, 640x360 
0x12CB3460, 36963313440395184, 231755021, 231755025, 4, 640x360 
0x12CB3460, 36963313440716392, 231755050, 231755053, 3, 640x360 
0x12CB3460, 36963313441035744, 231755080, 231755083, 3, 640x360 
0x12CB3460, 36963313441354056, 231755110, 231755113, 3, 640x360 
0x12CB3460, 36963313441674656, 231755141, 231755145, 4, 640x360 
0x12CB3460, 36963313441996568, 231755180, 231755183, 3, 640x360 
0x12CB3460, 36963313442313864, 231755210, 231755213, 3, 640x360 
0x12CB3460, 36963313442636216, 231755240, 231755245, 5, 640x360 
0x12CB3460, 36963313442954296, 231755270, 231755274, 4, 640x360 
0x12CB3460, 36963313443274312, 231755300, 231755304, 4, 640x360 
0x12CB3460, 36963313443756008, 231755349, 231755353, 4, 640x360 
0x12CB3460, 36963313444073328, 231755382, 231755386, 4, 640x360 
0x12CB3460, 36963313444394896, 231755419, 231755422, 3, 640x360 
0x12CB3460, 36963313444713240, 231755450, 231755452, 2, 640x360 
0x12CB3460, 36963313445035368, 231755480, 231755483, 3, 640x360 
0x12CB3460, 36963313445355984, 231755511, 231755520, 9, 640x360 
0x12CB3460, 36963313445674704, 231755550, 231755553, 3, 640x360 
0x12CB3460, 36963313445994184, 231755580, 231755583, 3, 640x360 
0x12CB3460, 36963313446315752, 231755611, 231755613, 2, 640x360 
0x12CB3460, 36963313446634736, 231755640, 231755644, 4, 640x360 
0x12CB3460, 36963313446953592, 231755670, 231755673, 3, 640x360 
0x12CB3460, 36963313447435336, 231755720, 231755723, 3, 640x360 
0x12CB3460, 36963313447754888, 231755751, 231755754, 3, 640x360 
0x12CB3460, 36963313448073968, 231755790, 231755793, 3, 640x360 
0x12CB3460, 36963313448393344, 231755820, 231755823, 3, 640x360 
0x12CB3460, 36963313448713824, 231755851, 231755855, 4, 640x360 
0x12CB3460, 36963313449034016, 231755883, 231755886, 3, 640x360 
0x12CB3460, 36963313449353944, 231755911, 231755913, 2, 640x360 
0x12CB3460, 36963313449673080, 231755951, 231755953, 2, 640x360 
0x12CB3460, 36963313449994088, 231755979, 231755982, 3, 640x360 
0x12CB3460, 36963313450315488, 231756010, 231756013, 3, 640x360 
0x12CB3460, 36963313450636520, 231756040, 231756044, 4, 640x360 
0x12CB3460, 36963313450954368, 231756070, 231756075, 5, 640x360 
0x12CB3460, 36963313451434720, 231756120, 231756138, 18, 640x360 
0x12CB3460, 36963313451753232, 231756150, 231756153, 3, 640x360 
0x12CB3460, 36963313452075328, 231756190, 231756193, 3, 640x360 
0x12CB3460, 36963313452394880, 231756226, 231756229, 3, 640x360 
0x12CB3460, 36963313452714064, 231756249, 231756252, 3, 640x360 
0x12CB3460, 36963313453033488, 231756280, 231756283, 3, 640x360 
0x12CB3460, 36963313453354032, 231756310, 231756313, 3, 640x360 
0x12CB3460, 36963313453674160, 231756369, 231756373, 4, 640x360 
0x12CB3460, 36963313453994184, 231756380, 231756383, 3, 640x360 
0x12CB3460, 36963313454313368, 231756410, 231756413, 3, 640x360 
0x12CB3460, 36963313454634448, 231756440, 231756442, 2, 640x360 
0x12CB3460, 36963313455115344, 231756491, 231756493, 2, 640x360 
0x12CB3460, 36963313455436504, 231756520, 231756524, 4, 640x360 
0x12CB3460, 36963313455754176, 231756550, 231756552, 2, 640x360 
0x12CB3460, 36963313456073912, 231756580, 231756584, 4, 640x360 
0x12CB3460, 36963313456394096, 231756621, 231756623, 2, 640x360 
0x12CB3460, 36963313456712824, 231756649, 231756652, 3, 640x360 
0x12CB3460, 36963313457034272, 231756680, 231756683, 3, 640x360 
0x12CB3460, 36963313457354960, 231756710, 231756713, 3, 640x360 
0x12CB3460, 36963313457674008, 231756740, 231756744, 4, 640x360 
0x12CB3460, 36963313457995584, 231756779, 231756782, 3, 640x360 
0x12CB3460, 36963313458314704, 231756810, 231756821, 11, 640x360 
0x12CB3460, 36963313458635120, 231756840, 231756845, 5, 640x360 
0x12CB3460, 36963313459114984, 231756890, 231756893, 3, 640x360 
0x12CB3460, 36963313459433688, 231756920, 231756923, 3, 640x360 
0x12CB3460, 36963313459754448, 231756950, 231756968, 18, 640x360 
0x12CB3460, 36963313460074776, 231756990, 231756993, 3, 640x360 
0x12CB3460, 36963313460394112, 231757022, 231757024, 2, 640x360 
0x12CB3460, 36963313460715312, 231757051, 231757054, 3, 640x360 
0x12CB3460, 36963313461034064, 231757080, 231757083, 3, 640x360 
0x12CB3460, 36963313461353320, 231757111, 231757114, 3, 640x360 
0x12CB3460, 36963313461672904, 231757150, 231757153, 3, 640x360 
0x12CB3460, 36963313461998968, 231757180, 231757183, 3, 640x360 
0x12CB3460, 36963313462315784, 231757209, 231757212, 3, 640x360 
0x12CB3460, 36963313462635784, 231757241, 231757244, 3, 640x360 
0x12CB3460, 36963313463113912, 231757290, 231757292, 2, 640x360 
0x12CB3460, 36963313463434584, 231757320, 231757323, 3, 640x360 
0x12CB3460, 36963313463754392, 231757373, 231757377, 4, 640x360 
0x12CB3460, 36963313464073080, 231757380, 231757385, 5, 640x360 
0x12CB3460, 36963313464393392, 231757420, 231757423, 3, 640x360 
0x12CB3460, 36963313464714352, 231757450, 231757468, 18, 640x360 
0x12CB3460, 36963313465034896, 231757479, 231757482, 3, 640x360 
0x12CB3460, 36963313465355432, 231757511, 231757514, 3, 640x360 
0x12CB3460, 36963313465675544, 231757550, 231757553, 3, 640x360 
0x12CB3460, 36963313465996136, 231757580, 231757585, 5, 640x360 
0x12CB3460, 36963313466313720, 231757610, 231757613, 3, 640x360 
0x12CB3460, 36963313466793576, 231757660, 231757665, 5, 640x360 
0x12CB3460, 36963313467114440, 231757690, 231757693, 3, 640x360 
0x12CB3460, 36963313467434952, 231757719, 231757722, 3, 640x360 
0x12CB3460, 36963313467754600, 231757751, 231757754, 3, 640x360 
0x12CB3460, 36963313468074424, 231757790, 231757793, 3, 640x360 
0x12CB3460, 36963313468395144, 231757821, 231757824, 3, 640x360 
0x12CB3460, 36963313468714280, 231757877, 231757881, 4, 640x360 
0x12CB3460, 36963313469353568, 231757910, 231757913, 3, 640x360 
0x12CB3460, 36963313469674280, 231757940, 231757944, 4, 640x360 
0x12CB3460, 36963313469993984, 231757979, 231757982, 3, 640x360 
0x12CB3460, 36963313470315392, 231758011, 231758013, 2, 640x360 
0x12CB3460, 36963313470796624, 231758060, 231758062, 2, 640x360 
0x12CB3460, 36963313471112680, 231758091, 231758095, 4, 640x360 
0x12CB3460, 36963313471432880, 231758120, 231758122, 2, 640x360 
0x12CB3460, 36963313471753592, 231758150, 231758153, 3, 640x360 
0x12CB3460, 36963313472073840, 231758190, 231758194, 4, 640x360 
0x12CB3460, 36963313472395720, 231758220, 231758223, 3, 640x360 
0x12CB3460, 36963313472714744, 231758250, 231758253, 3, 640x360 
0x12CB3460, 36963313473032792, 231758280, 231758283, 3, 640x360 
0x12CB3460, 36963313473352848, 231758309, 231758313, 4, 640x360 
0x12CB3460, 36963313473673320, 231758340, 231758344, 4, 640x360 
0x12CB3460, 36963313473995088, 231758390, 231758392, 2, 640x360 
0x12CB3460, 36963313474314608, 231758410, 231758414, 4, 640x360 
0x12CB3460, 36963313474795104, 231758459, 231758462, 3, 640x360 
0x12CB3460, 36963313475115584, 231758490, 231758493, 3, 640x360 
0x12CB3460, 36963313475436824, 231758520, 231758524, 4, 640x360 
0x12CB3460, 36963313475754904, 231758549, 231758553, 4, 640x360 
0x12CB3460, 36963313476076376, 231758582, 231758586, 4, 640x360 
0x12CB3460, 36963313476395664, 231758619, 231758623, 4, 640x360 
0x12CB3460, 36963313476714536, 231758650, 231758654, 4, 640x360 
0x12CB3460, 36963313477034016, 231758680, 231758695, 15, 640x360 
0x12CB3460, 36963313477353272, 231758711, 231758713, 2, 640x360 
0x12CB3460, 36963313477673584, 231758740, 231758744, 4, 640x360 
0x12CB3460, 36963313477996224, 231758779, 231758782, 3, 640x360 
0x12CB3460, 36963313478472320, 231758830, 231758833, 3, 640x360 
0x12CB3460, 36963313478793624, 231758870, 231758874, 4, 640x360 
0x12CB3460, 36963313479112912, 231758890, 231758892, 2, 640x360 
0x12CB3460, 36963313479433744, 231758921, 231758923, 2, 640x360 
0x12CB3460, 36963313479753112, 231758950, 231758953, 3, 640x360 
0x12CB3460, 36963313480073952, 231758980, 231758984, 4, 640x360 
0x12CB3460, 36963313480394688, 231759020, 231759024, 4, 640x360 
0x12CB3460, 36963313480713760, 231759051, 231759053, 2, 640x360 
0x12CB3460, 36963313481032544, 231759079, 231759082, 3, 640x360 
0x12CB3460, 36963313481354240, 231759111, 231759114, 3, 640x360 
0x12CB3460, 36963313481674096, 231759150, 231759153, 3, 640x360 
0x12CB3460, 36963313481997504, 231759179, 231759182, 3, 640x360 
0x12CB3460, 36963313482473696, 231759230, 231759233, 3, 640x360 
0x12CB3460, 36963313482796480, 231759260, 231759263, 3, 640x360 
0x12CB3460, 36963313483115040, 231759290, 231759292, 2, 640x360 
0x12CB3460, 36963313483433176, 231759320, 231759323, 3, 640x360 
0x12CB3460, 36963313483754392, 231759377, 231759380, 3, 640x360 
0x12CB3460, 36963313484076128, 231759382, 231759386, 4, 640x360 
0x12CB3460, 36963313484394088, 231759420, 231759423, 3, 640x360 
0x12CB3460, 36963313484714304, 231759449, 231759452, 3, 640x360 
0x12CB3460, 36963313485034792, 231759480, 231759483, 3, 640x360 
0x12CB3460, 36963313485356160, 231759510, 231759514, 4, 640x360 
0x12CB3460, 36963313485675744, 231759551, 231759556, 5, 640x360 
0x12CB3460, 36963313485997176, 231759580, 231759584, 4, 640x360 
0x12CB3460, 36963313486472264, 231759630, 231759633, 3, 640x360 
0x12CB3460, 36963313486793416, 231759659, 231759662, 3, 640x360 
0x12CB3460, 36963313487113848, 231759689, 231759692, 3, 640x360 
0x12CB3460, 36963313487432520, 231759720, 231759723, 3, 640x360 
0x12CB3460, 36963313487753800, 231759749, 231759753, 4, 640x360 
0x12CB3460, 36963313488073840, 231759781, 231759784, 3, 640x360 
0x12CB3460, 36963313488393832, 231759820, 231759823, 3, 640x360 
0x12CB3460, 36963313488713032, 231759849, 231759852, 3, 640x360 
0x12CB3460, 36963313489035128, 231759884, 231759895, 11, 640x360 
0x12CB3460, 36963313489353576, 231759910, 231759912, 2, 640x360 
0x12CB3460, 36963313489673408, 231759941, 231759944, 3, 640x360 
0x12CB3460, 36963313490154752, 231759989, 231759993, 4, 640x360 
0x12CB3460, 36963313490473352, 231760030, 231760033, 3, 640x360 
0x12CB3460, 36963313490794792, 231760060, 231760063, 3, 640x360 
0x12CB3460, 36963313491112784, 231760090, 231760095, 5, 640x360 
0x12CB3460, 36963313491434208, 231760121, 231760123, 2, 640x360 
0x12CB3460, 36963313491755000, 231760150, 231760154, 4, 640x360 
0x12CB3460, 36963313492074312, 231760181, 231760184, 3, 640x360 
0x12CB3460, 36963313492393408, 231760220, 231760223, 3, 640x360 
0x12CB3460, 36963313492715520, 231760250, 231760270, 20, 640x360 
0x12CB3460, 36963313493033272, 231760279, 231760282, 3, 640x360 
0x12CB3460, 36963313493352888, 231760310, 231760313, 3, 640x360 
0x12CB3460, 36963313493674168, 231760350, 231760353, 3, 640x360 
0x12CB3460, 36963313494153552, 231760390, 231760393, 3, 640x360 
0x12CB3460, 36963313494475072, 231760421, 231760425, 4, 640x360 
0x12CB3460, 36963313494794416, 231760460, 231760463, 3, 640x360 
0x12CB3460, 36963313495115016, 231760489, 231760492, 3, 640x360 
0x12CB3460, 36963313495436368, 231760520, 231760523, 3, 640x360 
0x12CB3460, 36963313495753720, 231760550, 231760553, 3, 640x360 
0x12CB3460, 36963313496072800, 231760581, 231760584, 3, 640x360 
0x12CB3460, 36963313496393656, 231760620, 231760638, 18, 640x360 
0x12CB3460, 36963313496714096, 231760649, 231760653, 4, 640x360 
0x12CB3460, 36963313497033376, 231760681, 231760683, 2, 640x360 
0x12CB3460, 36963313497355728, 231760711, 231760714, 3, 640x360 
0x12CB3460, 36963313497833632, 231760760, 231760762, 2, 640x360 
0x12CB3460, 36963313498154552, 231760791, 231760794, 3, 640x360 
0x12CB3460, 36963313498473432, 231760822, 231760825, 3, 640x360 
0x12CB3460, 36963313498795288, 231760880, 231760884, 4, 640x360 
0x12CB3460, 36963313499115680, 231760891, 231760893, 2, 640x360 
0x12CB3460, 36963313499434288, 231760919, 231760922, 3, 640x360 
0x12CB3460, 36963313499755896, 231760950, 231760954, 4, 640x360 
0x12CB3460, 36963313500074600, 231760989, 231760992, 3, 640x360 
0x12CB3460, 36963313500394776, 231761021, 231761024, 3, 640x360 
0x12CB3460, 36963313500714928, 231761050, 231761056, 6, 640x360 
0x12CB3460, 36963313501034576, 231761080, 231761083, 3, 640x360 
0x12CB3460, 36963313501353576, 231761110, 231761112, 2, 640x360 
0x12CB3460, 36963313501832896, 231761159, 231761162, 3, 640x360 
0x12CB3460, 36963313502153728, 231761189, 231761194, 5, 640x360 
0x12CB3460, 36963313502473840, 231761220, 231761225, 5, 640x360 
0x12CB3460, 36963313502793672, 231761260, 231761263, 3, 640x360 
0x12CB3460, 36963313503112504, 231761289, 231761292, 3, 640x360 
0x12CB3460, 36963313503434000, 231761319, 231761322, 3, 640x360 
0x12CB3460, 36963313503754352, 231761350, 231761353, 3, 640x360 
0x12CB3460, 36963313504074016, 231761389, 231761392, 3, 640x360 
0x12CB3460, 36963313504397312, 231761420, 231761423, 3, 640x360 
0x12CB3460, 36963313504713624, 231761450, 231761453, 3, 640x360 
0x12CB3460, 36963313505034560, 231761480, 231761483, 3, 640x360 
0x12CB3460, 36963313505354248, 231761511, 231761514, 3, 640x360 
0x12CB3460, 36963313505834608, 231761560, 231761563, 3, 640x360 
0x12CB3460, 36963313506155616, 231761592, 231761595, 3, 640x360 
0x12CB3460, 36963313506474208, 231761621, 231761625, 4, 640x360 
0x12CB3460, 36963313506794496, 231761660, 231761663, 3, 640x360 
0x12CB3460, 36963313507112928, 231761690, 231761693, 3, 640x360 
0x12CB3460, 36963313507433512, 231761720, 231761723, 3, 640x360 
0x12CB3460, 36963313507753512, 231761750, 231761753, 3, 640x360 
0x12CB3460, 36963313508073824, 231761790, 231761793, 3, 640x360 
0x12CB3460, 36963313508393432, 231761819, 231761823, 4, 640x360 
0x12CB3460, 36963313508715960, 231761854, 231761857, 3, 640x360 
0x12CB3460, 36963313509034160, 231761880, 231761883, 3, 640x360 
0x12CB3460, 36963313509514040, 231761930, 231761933, 3, 640x360 
0x12CB3460, 36963313509833144, 231761960, 231761962, 2, 640x360 
0x12CB3460, 36963313510154168, 231761990, 231761993, 3, 640x360 
0x12CB3460, 36963313510473784, 231762029, 231762033, 4, 640x360 
0x12CB3460, 36963313510795240, 231762060, 231762062, 2, 640x360 
0x12CB3460, 36963313511113048, 231762090, 231762093, 3, 640x360 
0x12CB3460, 36963313511433152, 231762120, 231762123, 3, 640x360 
0x12CB3460, 36963313511754608, 231762150, 231762153, 3, 640x360 
0x12CB3460, 36963313512074816, 231762190, 231762193, 3, 640x360 
0x12CB3460, 36963313512396736, 231762221, 231762224, 3, 640x360 
0x12CB3460, 36963313512712888, 231762250, 231762253, 3, 640x360 
0x12CB3460, 36963313513033120, 231762280, 231762283, 3, 640x360 
0x12CB3460, 36963313513511992, 231762329, 231762332, 3, 640x360 
0x12CB3460, 36963313513835792, 231762367, 231762371, 4, 640x360 
0x12CB3460, 36963313514153768, 231762389, 231762393, 4, 640x360 
0x12CB3460, 36963313514472488, 231762420, 231762424, 4, 640x360 
0x12CB3460, 36963313514793944, 231762460, 231762462, 2, 640x360 
0x12CB3460, 36963313515114064, 231762490, 231762493, 3, 640x360 
0x12CB3460, 36963313515434216, 231762520, 231762524, 4, 640x360 
0x12CB3460, 36963313515755552, 231762550, 231762553, 3, 640x360 
0x12CB3460, 36963313516073696, 231762580, 231762583, 3, 640x360 
0x12CB3460, 36963313516394528, 231762620, 231762623, 3, 640x360 
0x12CB3460, 36963313516715496, 231762650, 231762653, 3, 640x360 
0x12CB3460, 36963313517033584, 231762680, 231762682, 2, 640x360 
0x12CB3460, 36963313517514896, 231762730, 231762745, 15, 640x360 
0x12CB3460, 36963313517835672, 231762760, 231762762, 2, 640x360 
0x12CB3460, 36963313518154608, 231762790, 231762793, 3, 640x360 
0x12CB3460, 36963313518476120, 231762829, 231762832, 3, 640x360 
0x12CB3460, 36963313518797784, 231762892, 231762896, 4, 640x360 
0x12CB3460, 36963313519433848, 231762920, 231762924, 4, 640x360 
0x12CB3460, 36963313519753824, 231762951, 231762953, 2, 640x360 
0x12CB3460, 36963313520074544, 231762989, 231762992, 3, 640x360 
0x12CB3460, 36963313520394272, 231763021, 231763024, 3, 640x360 
0x12CB3460, 36963313520713904, 231763050, 231763053, 3, 640x360 
0x12CB3460, 36963313521193808, 231763100, 231763103, 3, 640x360 
0x12CB3460, 36963313521512160, 231763129, 231763132, 3, 640x360 
0x12CB3460, 36963313521832496, 231763160, 231763162, 2, 640x360 
0x12CB3460, 36963313522154400, 231763189, 231763193, 4, 640x360 
0x12CB3460, 36963313522473032, 231763221, 231763225, 4, 640x360 
0x12CB3460, 36963313522793584, 231763260, 231763262, 2, 640x360 
0x12CB3460, 36963313523114056, 231763290, 231763293, 3, 640x360 
0x12CB3460, 36963313523432280, 231763320, 231763323, 3, 640x360 
0x12CB3460, 36963313523753896, 231763351, 231763364, 13, 640x360 
0x12CB3460, 36963313524072768, 231763381, 231763385, 4, 640x360 
0x12CB3460, 36963313524394152, 231763420, 231763423, 3, 640x360 
0x12CB3460, 36963313524714064, 231763450, 231763452, 2, 640x360 
0x12CB3460, 36963313525192848, 231763500, 231763502, 2, 640x360 
0x12CB3460, 36963313525512584, 231763530, 231763533, 3, 640x360 
0x12CB3460, 36963313525833872, 231763560, 231763563, 3, 640x360 
0x12CB3460, 36963313526154024, 231763590, 231763593, 3, 640x360 
0x12CB3460, 36963313526473448, 231763620, 231763625, 5, 640x360 
0x12CB3460, 36963313526796208, 231763660, 231763663, 3, 640x360 
0x12CB3460, 36963313527115128, 231763690, 231763694, 4, 640x360 
0x12CB3460, 36963313527436896, 231763721, 231763724, 3, 640x360 
0x12CB3460, 36963313527753200, 231763750, 231763754, 4, 640x360 
0x12CB3460, 36963313528073680, 231763780, 231763784, 4, 640x360 
0x12CB3460, 36963313528394176, 231763820, 231763823, 3, 640x360 
0x12CB3460, 36963313528715136, 231763873, 231763876, 3, 640x360 
0x12CB3460, 36963313529192352, 231763900, 231763903, 3, 640x360 
0x12CB3460, 36963313529514696, 231763930, 231763933, 3, 640x360 
0x12CB3460, 36963313529832728, 231763960, 231763963, 3, 640x360 
0x12CB3460, 36963313530154760, 231763989, 231763993, 4, 640x360 
0x12CB3460, 36963313530480224, 231764031, 231764035, 4, 640x360 
0x12CB3460, 36963313530797880, 231764060, 231764063, 3, 640x360 
0x12CB3460, 36963313531113008, 231764090, 231764093, 3, 640x360 
0x12CB3460, 36963313531433008, 231764119, 231764123, 4, 640x360 
0x12CB3460, 36963313531753632, 231764150, 231764153, 3, 640x360 
0x12CB3460, 36963313532075240, 231764189, 231764192, 3, 640x360 
0x12CB3460, 36963313532395880, 231764221, 231764224, 3, 640x360 
0x12CB3460, 36963313532873856, 231764260, 231764263, 3, 640x360 
0x12CB3460, 36963313533192400, 231764300, 231764303, 3, 640x360 
0x12CB3460, 36963313533512320, 231764330, 231764332, 2, 640x360 
0x12CB3460, 36963313533835512, 231764377, 231764380, 3, 640x360 
0x12CB3460, 36963313534153512, 231764390, 231764393, 3, 640x360 
0x12CB3460, 36963313534474344, 231764421, 231764425, 4, 640x360 
0x12CB3460, 36963313534792816, 231764459, 231764462, 3, 640x360 
0x12CB3460, 36963313535112584, 231764490, 231764493, 3, 640x360 
0x12CB3460, 36963313535434768, 231764520, 231764523, 3, 640x360 
0x12CB3460, 36963313535753688, 231764550, 231764553, 3, 640x360 
0x12CB3460, 36963313536074056, 231764580, 231764585, 5, 640x360 
0x12CB3460, 36963313536396928, 231764619, 231764622, 3, 640x360 
0x12CB3460, 36963313536872512, 231764670, 231764673, 3, 640x360 
0x12CB3460, 36963313537194080, 231764700, 231764703, 3, 640x360 
0x12CB3460, 36963313537515736, 231764731, 231764734, 3, 640x360 
0x12CB3460, 36963313537833064, 231764760, 231764763, 3, 640x360 
0x12CB3460, 36963313538153368, 231764790, 231764793, 3, 640x360 
0x12CB3460, 36963313538472992, 231764830, 231764833, 3, 640x360 
0x12CB3460, 36963313538794192, 231764877, 231764880, 3, 640x360 
0x12CB3460, 36963313539112216, 231764890, 231764894, 4, 640x360 
0x12CB3460, 36963313539753904, 231764950, 231764953, 3, 640x360 
0x12CB3460, 36963313540395560, 231765022, 231765025, 3, 640x360 
0x12CB3460, 36963313541193560, 231765100, 231765103, 3, 640x360 
0x12CB3460, 36963313541833688, 231765160, 231765163, 3, 640x360 
0x12CB3460, 36963313542473424, 231765221, 231765240, 19, 640x360 
0x12CB3460, 36963313543112160, 231765289, 231765292, 3, 640x360 
0x12CB3460, 36963313543755976, 231765375, 231765378, 3, 640x360 
0x12CB3460, 36963313544393576, 231765420, 231765424, 4, 640x360 
0x12CB3460, 36963313545193600, 231765500, 231765503, 3, 640x360 
0x12CB3460, 36963313545836320, 231765560, 231765563, 3, 640x360 
0x12CB3460, 36963313546473264, 231765620, 231765625, 5, 640x360 
0x12CB3460, 36963313547112864, 231765690, 231765693, 3, 640x360 
0x12CB3460, 36963313547753768, 231765751, 231765753, 2, 640x360 
0x12CB3460, 36963313548393256, 231765819, 231765823, 4, 640x360 
0x12CB3460, 36963313549191776, 231765899, 231765902, 3, 640x360 
0x12CB3460, 36963313549832504, 231765960, 231765963, 3, 640x360 
0x12CB3460, 36963313550472680, 231766031, 231766035, 4, 640x360 
0x12CB3460, 36963313551112864, 231766090, 231766094, 4, 640x360 
0x12CB3460, 36963313551753016, 231766150, 231766154, 4, 640x360 
0x12CB3460, 36963313552394088, 231766222, 231766224, 2, 640x360 
0x12CB3460, 36963313553192456, 231766299, 231766302, 3, 640x360 
0x12CB3460, 36963313553834864, 231766378, 231766381, 3, 640x360 
0x12CB3460, 36963313554473096, 231766420, 231766425, 5, 640x360 
0x12CB3460, 36963313555113928, 231766490, 231766492, 2, 640x360 
0x12CB3460, 36963313555756272, 231766561, 231766565, 4, 640x360 
0x12CB3460, 36963313556397904, 231766620, 231766624, 4, 640x360 
0x12CB3460, 36963313557193792, 231766700, 231766704, 4, 640x360 
0x12CB3460, 36963313557832976, 231766760, 231766763, 3, 640x360 
0x12CB3460, 36963313558473336, 231766830, 231766834, 4, 640x360 
0x12CB3460, 36963313559112464, 231766884, 231766888, 4, 640x360 
0x12CB3460, 36963313559753816, 231766951, 231766953, 2, 640x360 
0x12CB3460, 36963313560395728, 231767021, 231767024, 3, 640x360 
0x12CB3460, 36963313561192256, 231767100, 231767103, 3, 640x360 
0x12CB3460, 36963313561832152, 231767160, 231767163, 3, 640x360 
0x12CB3460, 36963313562476472, 231767223, 231767226, 3, 640x360 
0x12CB3460, 36963313563113448, 231767290, 231767292, 2, 640x360 
0x12CB3460, 36963313563756040, 231767350, 231767354, 4, 640x360 
0x12CB3460, 36963313564392880, 231767421, 231767425, 4, 640x360 
0x12CB3460, 36963313565193808, 231767500, 231767503, 3, 640x360 
0x12CB3460, 36963313565833736, 231767561, 231767563, 2, 640x360 
0x12CB3460, 36963313566472576, 231767620, 231767624, 4, 640x360 
0x12CB3460, 36963313567115224, 231767690, 231767692, 2, 640x360 
0x12CB3460, 36963313567754936, 231767761, 231767763, 2, 640x360 
0x12CB3460, 36963313568393720, 231767820, 231767823, 3, 640x360 
0x12CB3460, 36963313569192336, 231767900, 231767903, 3, 640x360 
0x12CB3460, 36963313569832000, 231767959, 231767962, 3, 640x360 
0x12CB3460, 36963313570473136, 231768030, 231768034, 4, 640x360 
0x12CB3460, 36963313571112920, 231768089, 231768092, 3, 640x360 
0x12CB3460, 36963313571752616, 231768150, 231768153, 3, 640x360 
0x12CB3460, 36963313572394272, 231768220, 231768223, 3, 640x360 
0x12CB3460, 36963313573191832, 231768300, 231768302, 2, 640x360 
0x12CB3460, 36963313573833752, 231768371, 231768374, 3, 640x360 
0x12CB3460, 36963313574473872, 231768421, 231768425, 4, 640x360 
0x12CB3460, 36963313575113592, 231768490, 231768493, 3, 640x360 
0x12CB3460, 36963313575754560, 231768551, 231768554, 3, 640x360 
0x12CB3460, 36963313576394184, 231768620, 231768623, 3, 640x360 
0x12CB3460, 36963313577193856, 231768699, 231768702, 3, 640x360 
0x12CB3460, 36963313577832416, 231768760, 231768762, 2, 640x360 
0x12CB3460, 36963313578475184, 231768829, 231768833, 4, 640x360 
0x12CB3460, 36963313579115664, 231768889, 231768892, 3, 640x360 
0x12CB3460, 36963313579753152, 231768950, 231768953, 3, 640x360 
0x12CB3460, 36963313580395904, 231769020, 231769023, 3, 640x360 
0x12CB3460, 36963313581191192, 231769100, 231769103, 3, 640x360 
0x12CB3460, 36963313581832208, 231769160, 231769163, 3, 640x360 
0x12CB3460, 36963313582472528, 231769221, 231769224, 3, 640x360 
0x12CB3460, 36963313583112616, 231769289, 231769292, 3, 640x360 
0x12CB3460, 36963313583754184, 231769377, 231769381, 4, 640x360 
0x12CB3460, 36963313584395736, 231769420, 231769423, 3, 640x360 
0x12CB3460, 36963313585194456, 231769500, 231769502, 2, 640x360 
0x12CB3460, 36963313585833920, 231769562, 231769565, 3, 640x360 
0x12CB3460, 36963313586473440, 231769631, 231769634, 3, 640x360 
0x12CB3460, 36963313587113040, 231769690, 231769692, 2, 640x360 
0x12CB3460, 36963313587752920, 231769750, 231769753, 3, 640x360 
0x12CB3460, 36963313588392696, 231769820, 231769823, 3, 640x360 
0x12CB3460, 36963313589191928, 231769899, 231769902, 3, 640x360 
0x12CB3460, 36963313589833984, 231769959, 231769962, 3, 640x360 
0x12CB3460, 36963313590475784, 231770031, 231770035, 4, 640x360 
0x12CB3460, 36963313591112448, 231770090, 231770092, 2, 640x360 
0x12CB3460, 36963313591752600, 231770150, 231770154, 4, 640x360 
0x12CB3460, 36963313592393872, 231770220, 231770224, 4, 640x360 
0x12CB3460, 36963313593194136, 231770300, 231770302, 2, 640x360 
0x12CB3460, 36963313593832424, 231770377, 231770380, 3, 640x360 
0x12CB3460, 36963313594472200, 231770420, 231770424, 4, 640x360 
0x12CB3460, 36963313595113792, 231770490, 231770493, 3, 640x360 
0x12CB3460, 36963313595754328, 231770551, 231770553, 2, 640x360 
0x12CB3460, 36963313596395080, 231770613, 231770616, 3, 640x360 
0x12CB3460, 36963313597193944, 231770700, 231770703, 3, 640x360 
0x12CB3460, 36963313597832544, 231770760, 231770763, 3, 640x360 
0x12CB3460, 36963313598472992, 231770829, 231770832, 3, 640x360 
0x12CB3460, 36963313599112528, 231770890, 231770893, 3, 640x360 
0x12CB3460, 36963313599753384, 231770950, 231770952, 2, 640x360 
0x12CB3460, 36963313600395200, 231771020, 231771023, 3, 640x360 
0x12CB3460, 36963313601191056, 231771101, 231771103, 2, 640x360 
0x12CB3460, 36963313601832552, 231771160, 231771163, 3, 640x360 
0x12CB3460, 36963313602472224, 231771221, 231771224, 3, 640x360 
0x12CB3460, 36963313603111536, 231771290, 231771293, 3, 640x360 
0x12CB3460, 36963313603754648, 231771372, 231771375, 3, 640x360 
0x12CB3460, 36963313604393632, 231771420, 231771422, 2, 640x360 
0x12CB3460, 36963313605033000, 231771479, 231771482, 3, 640x360 
0x12CB3460, 36963313605836224, 231771562, 231771565, 3, 640x360 
0x12CB3460, 36963313606472128, 231771620, 231771624, 4, 640x360 
0x12CB3460, 36963313607112296, 231771689, 231771691, 2, 640x360 
0x12CB3460, 36963313607752512, 231771750, 231771752, 2, 640x360 
0x12CB3460, 36963313608394456, 231771819, 231771823, 4, 640x360 
0x12CB3460, 36963313609033224, 231771888, 231771891, 3, 640x360 
0x12CB3460, 36963313609832888, 231771959, 231771962, 3, 640x360 
0x12CB3460, 36963313610475248, 231772030, 231772033, 3, 640x360 
0x12CB3460, 36963313611112184, 231772089, 231772091, 2, 640x360 
0x12CB3460, 36963313611752760, 231772149, 231772152, 3, 640x360 
0x12CB3460, 36963313612397400, 231772225, 231772229, 4, 640x360 
0x12CB3460, 36963313613032888, 231772279, 231772282, 3, 640x360 
0x12CB3460, 36963313613833408, 231772373, 231772376, 3, 640x360 
0x12CB3460, 36963313614472440, 231772422, 231772425, 3, 640x360 
0x12CB3460, 36963313615112296, 231772490, 231772497, 7, 640x360 
0x12CB3460, 36963313615753688, 231772551, 231772553, 2, 640x360 
0x12CB3460, 36963313616393544, 231772620, 231772638, 18, 640x360 
0x12CB3460, 36963313617036304, 231772680, 231772683, 3, 640x360 
0x12CB3460, 36963313617832480, 231772760, 231772765, 5, 640x360 
0x12CB3460, 36963313618473736, 231772830, 231772832, 2, 640x360 
0x12CB3460, 36963313619111392, 231772890, 231772893, 3, 640x360 
0x12CB3460, 36963313619753000, 231772949, 231772952, 3, 640x360 
0x12CB3460, 36963313620394184, 231773021, 231773024, 3, 640x360 
0x12CB3460, 36963313621032192, 231773080, 231773083, 3, 640x360 
0x12CB3460, 36963313621833120, 231773161, 231773163, 2, 640x360 
0x12CB3460, 36963313622471272, 231773221, 231773224, 3, 640x360 
0x12CB3460, 36963313623112336, 231773290, 231773292, 2, 640x360 
0x12CB3460, 36963313623753944, 231773350, 231773353, 3, 640x360 
0x12CB3460, 36963313624391888, 231773420, 231773423, 3, 640x360 
0x12CB3460, 36963313625033544, 231773480, 231773482, 2, 640x360 
0x12CB3460, 36963313625833584, 231773560, 231773562, 2, 640x360 
0x12CB3460, 36963313626472232, 231773623, 231773626, 3, 640x360 
0x12CB3460, 36963313627112168, 231773690, 231773693, 3, 640x360 
0x12CB3460, 36963313627752552, 231773749, 231773752, 3, 640x360 
0x12CB3460, 36963313628393344, 231773821, 231773823, 2, 640x360 
0x12CB3460, 36963313629033232, 231773880, 231773883, 3, 640x360 
0x12CB3460, 36963313629832968, 231773960, 231773962, 2, 640x360 
0x12CB3460, 36963313630476048, 231774030, 231774032, 2, 640x360 
0x12CB3460, 36963313631112512, 231774090, 231774094, 4, 640x360 
0x12CB3460, 36963313631752072, 231774150, 231774152, 2, 640x360 
0x12CB3460, 36963313632395088, 231774221, 231774224, 3, 640x360 
0x12CB3460, 36963313633032432, 231774280, 231774283, 3, 640x360 
0x12CB3460, 36963313633833000, 231774366, 231774369, 3, 640x360 
0x12CB3460, 36963313634473080, 231774421, 231774425, 4, 640x360 
0x12CB3460, 36963313635111640, 231774489, 231774492, 3, 640x360 
0x12CB3460, 36963313635755160, 231774552, 231774555, 3, 640x360 
0x12CB3460, 36963313636396848, 231774622, 231774625, 3, 640x360 
0x12CB3460, 36963313637032616, 231774680, 231774682, 2, 640x360 
0x12CB3460, 36963313637831016, 231774759, 231774762, 3, 640x360 
0x12CB3460, 36963313638471528, 231774821, 231774824, 3, 640x360 
0x12CB3460, 36963313639111496, 231774888, 231774890, 2, 640x360 
0x12CB3460, 36963313639752032, 231774950, 231774953, 3, 640x360 
0x12CB3460, 36963313640393808, 231775020, 231775024, 4, 640x360 
0x12CB3460, 36963313641032784, 231775079, 231775082, 3, 640x360 
0x12CB3460, 36963313641832816, 231775159, 231775162, 3, 640x360 
0x12CB3460, 36963313642473672, 231775224, 231775228, 4, 640x360 
0x12CB3460, 36963313643111056, 231775290, 231775292, 2, 640x360 
0x12CB3460, 36963313643755096, 231775375, 231775378, 3, 640x360 
0x12CB3460, 36963313644392080, 231775420, 231775423, 3, 640x360 
0x12CB3460, 36963313645033272, 231775480, 231775482, 2, 640x360 
0x12CB3460, 36963313645833872, 231775561, 231775564, 3, 640x360 
0x12CB3460, 36963313646472720, 231775622, 231775625, 3, 640x360 
0x12CB3460, 36963313647113136, 231775690, 231775693, 3, 640x360 
0x12CB3460, 36963313647752792, 231775751, 231775753, 2, 640x360 
0x12CB3460, 36963313648393024, 231775820, 231775823, 3, 640x360 
0x12CB3460, 36963313649034040, 231775880, 231775882, 2, 640x360 
0x12CB3460, 36963313649832432, 231775960, 231775962, 2, 640x360 
0x12CB3460, 36963313650474856, 231776030, 231776035, 5, 640x360 
0x12CB3460, 36963313651112384, 231776090, 231776094, 4, 640x360 
0x12CB3460, 36963313651751944, 231776150, 231776153, 3, 640x360 
0x12CB3460, 36963313652393512, 231776221, 231776225, 4, 640x360 
0x12CB3460, 36963313653033544, 231776280, 231776283, 3, 640x360 
0x12CB3460, 36963313653831992, 231776380, 231776383, 3, 640x360 
0x12CB3460, 36963313654471488, 231776421, 231776425, 4, 640x360 
0x12CB3460, 36963313655111576, 231776490, 231776492, 2, 640x360 
0x12CB3460, 36963313655753304, 231776550, 231776554, 4, 640x360 
0x12CB3460, 36963313656396112, 231776620, 231776623, 3, 640x360 
0x12CB3460, 36963313657033096, 231776679, 231776682, 3, 640x360 
0x12CB3460, 36963313657830504, 231776759, 231776762, 3, 640x360 
0x12CB3460, 36963313658471296, 231776822, 231776825, 3, 640x360 
0x12CB3460, 36963313659111176, 231776890, 231776893, 3, 640x360 
0x12CB3460, 36963313659753088, 231776951, 231776954, 3, 640x360 
0x12CB3460, 36963313660393352, 231777020, 231777023, 3, 640x360 
0x12CB3460, 36963313661032344, 231777080, 231777082, 2, 640x360 
0x12CB3460, 36963313661832032, 231777159, 231777162, 3, 640x360 
0x12CB3460, 36963313662471944, 231777222, 231777241, 19, 640x360 
0x12CB3460, 36963313663112088, 231777289, 231777292, 3, 640x360 
0x12CB3460, 36963313663752368, 231777364, 231777367, 3, 640x360 
0x12CB3460, 36963313664391320, 231777420, 231777423, 3, 640x360 
0x12CB3460, 36963313665032648, 231777479, 231777482, 3, 640x360 
0x12CB3460, 36963313665833984, 231777560, 231777563, 3, 640x360 
0x12CB3460, 36963313666472336, 231777623, 231777627, 4, 640x360 
0x12CB3460, 36963313667113224, 231777690, 231777693, 3, 640x360 
0x12CB3460, 36963313667752992, 231777750, 231777752, 2, 640x360 
0x12CB3460, 36963313668395688, 231777820, 231777824, 4, 640x360 
0x12CB3460, 36963313669032656, 231777880, 231777896, 16, 640x360 
0x12CB3460, 36963313669673240, 231777950, 231777952, 2, 640x360 
0x12CB3460, 36963313670475560, 231778030, 231778033, 3, 640x360 
0x12CB3460, 36963313671112056, 231778090, 231778093, 3, 640x360 
0x12CB3460, 36963313671752032, 231778150, 231778153, 3, 640x360 
0x12CB3460, 36963313672392352, 231778220, 231778224, 4, 640x360 
0x12CB3460, 36963313673033552, 231778280, 231778283, 3, 640x360 
0x12CB3460, 36963313673672056, 231778340, 231778344, 4, 640x360 
0x12CB3460, 36963313674470456, 231778422, 231778425, 3, 640x360 
0x12CB3460, 36963313675112616, 231778489, 231778492, 3, 640x360 
0x12CB3460, 36963313675755152, 231778550, 231778553, 3, 640x360 
0x12CB3460, 36963313676392248, 231778621, 231778625, 4, 640x360 
0x12CB3460, 36963313677032896, 231778680, 231778683, 3, 640x360 
0x12CB3460, 36963313677675968, 231778743, 231778746, 3, 640x360 
0x12CB3460, 36963313678471288, 231778821, 231778825, 4, 640x360 
0x12CB3460, 36963313679110760, 231778890, 231778893, 3, 640x360 
0x12CB3460, 36963313679752896, 231778950, 231778953, 3, 640x360 
0x12CB3460, 36963313680394760, 231779020, 231779023, 3, 640x360 
0x12CB3460, 36963313681032624, 231779080, 231779083, 3, 640x360 
0x12CB3460, 36963313681673480, 231779150, 231779153, 3, 640x360 
0x12CB3460, 36963313682471408, 231779221, 231779224, 3, 640x360 
0x12CB3460, 36963313683110880, 231779289, 231779291, 2, 640x360 
0x12CB3460, 36963313683752440, 231779349, 231779352, 3, 640x360 
0x12CB3460, 36963313684391928, 231779421, 231779423, 2, 640x360 
0x12CB3460, 36963313685033584, 231779480, 231779483, 3, 640x360 
0x12CB3460, 36963313685674688, 231779550, 231779553, 3, 640x360 
0x12CB3460, 36963313686471376, 231779622, 231779625, 3, 640x360 
0x12CB3460, 36963313687111680, 231779690, 231779693, 3, 640x360 
0x12CB3460, 36963313687752960, 231779750, 231779753, 3, 640x360 
0x12CB3460, 36963313688393032, 231779819, 231779823, 4, 640x360 
0x12CB3460, 36963313689032400, 231779880, 231779882, 2, 640x360 
0x12CB3460, 36963313689672216, 231779940, 231779943, 3, 640x360 
0x12CB3460, 36963313690472352, 231780030, 231780034, 4, 640x360 
0x12CB3460, 36963313691111488, 231780090, 231780092, 2, 640x360 
0x12CB3460, 36963313691753560, 231780149, 231780152, 3, 640x360 
0x12CB3460, 36963313692392064, 231780220, 231780224, 4, 640x360 
0x12CB3460, 36963313693035648, 231780281, 231780285, 4, 640x360 
0x12CB3460, 36963313693673496, 231780373, 231780376, 3, 640x360 
0x12CB3460, 36963313694470408, 231780420, 231780424, 4, 640x360 
0x12CB3460, 36963313695112216, 231780489, 231780491, 2, 640x360 
0x12CB3460, 36963313695754168, 231780550, 231780554, 4, 640x360 
0x12CB3460, 36963313696392952, 231780620, 231780623, 3, 640x360 
0x12CB3460, 36963313697032880, 231780679, 231780682, 3, 640x360 
0x12CB3460, 36963313697672288, 231780741, 231780744, 3, 640x360 
0x12CB3460, 36963313698471528, 231780821, 231780825, 4, 640x360 
0x12CB3460, 36963313699111808, 231780887, 231780889, 2, 640x360 
0x12CB3460, 36963313699752368, 231780950, 231780952, 2, 640x360 
0x12CB3460, 36963313700392704, 231781019, 231781024, 5, 640x360 
0x12CB3460, 36963313701032656, 231781080, 231781083, 3, 640x360 
0x12CB3460, 36963313701672672, 231781140, 231781143, 3, 640x360 
0x12CB3460, 36963313702470848, 231781221, 231781224, 3, 640x360 
0x12CB3460, 36963313703114744, 231781289, 231781291, 2, 640x360 
0x12CB3460, 36963313703753032, 231781375, 231781377, 2, 640x360 
0x12CB3460, 36963313704392456, 231781420, 231781423, 3, 640x360 
0x12CB3460, 36963313705032496, 231781480, 231781483, 3, 640x360 
0x12CB3460, 36963313705673912, 231781549, 231781552, 3, 640x360 
0x12CB3460, 36963313706474376, 231781630, 231781634, 4, 640x360 
0x12CB3460, 36963313707112048, 231781690, 231781693, 3, 640x360 
0x12CB3460, 36963313707752784, 231781750, 231781752, 2, 640x360 
0x12CB3460, 36963313708392480, 231781820, 231781824, 4, 640x360 
0x12CB3460, 36963313709032192, 231781880, 231781882, 2, 640x360 
0x12CB3460, 36963313709672576, 231781941, 231781944, 3, 640x360 
0x12CB3460, 36963313710472200, 231782029, 231782032, 3, 640x360 
0x12CB3460, 36963313711111472, 231782090, 231782092, 2, 640x360 
0x12CB3460, 36963313711751736, 231782149, 231782153, 4, 640x360 
0x12CB3460, 36963313712391904, 231782220, 231782223, 3, 640x360 
0x12CB3460, 36963313713033872, 231782280, 231782282, 2, 640x360 
0x12CB3460, 36963313713672176, 231782350, 231782352, 2, 640x360 
0x12CB3460, 36963313714471280, 231782421, 231782424, 3, 640x360 
0x12CB3460, 36963313715111808, 231782489, 231782491, 2, 640x360 
0x12CB3460, 36963313715752232, 231782551, 231782553, 2, 640x360 
0x12CB3460, 36963313716392440, 231782619, 231782622, 3, 640x360 
0x12CB3460, 36963313717031936, 231782680, 231782683, 3, 640x360 
0x12CB3460, 36963313717673512, 231782743, 231782746, 3, 640x360 
0x12CB3460, 36963313718470776, 231782822, 231782825, 3, 640x360 
0x12CB3460, 36963313719110264, 231782890, 231782892, 2, 640x360 
0x12CB3460, 36963313719752776, 231782950, 231782953, 3, 640x360 
0x12CB3460, 36963313720391440, 231783019, 231783023, 4, 640x360 
0x12CB3460, 36963313721032248, 231783079, 231783082, 3, 640x360 
0x12CB3460, 36963313721673368, 231783150, 231783152, 2, 640x360 
0x12CB3460, 36963313722475152, 231783231, 231783235, 4, 640x360 
0x12CB3460, 36963313723112032, 231783290, 231783293, 3, 640x360 
0x12CB3460, 36963313723752272, 231783373, 231783376, 3, 640x360 
0x12CB3460, 36963313724391080, 231783419, 231783422, 3, 640x360 
0x12CB3460, 36963313725031872, 231783480, 231783497, 17, 640x360 
0x12CB3460, 36963313725675048, 231783543, 231783546, 3, 640x360 
0x12CB3460, 36963313726473736, 231783630, 231783632, 2, 640x360 
0x12CB3460, 36963313727112424, 231783690, 231783692, 2, 640x360 
0x12CB3460, 36963313727753616, 231783750, 231783753, 3, 640x360 
0x12CB3460, 36963313728391240, 231783819, 231783822, 3, 640x360 
0x12CB3460, 36963313729031896, 231783884, 231783886, 2, 640x360 
0x12CB3460, 36963313729671544, 231783941, 231783944, 3, 640x360 
0x12CB3460, 36963313730471816, 231784021, 231784023, 2, 640x360 
0x12CB3460, 36963313731111352, 231784090, 231784092, 2, 640x360 
0x12CB3460, 36963313731751168, 231784150, 231784153, 3, 640x360 
0x12CB3460, 36963313732393368, 231784219, 231784222, 3, 640x360 
0x12CB3460, 36963313733033256, 231784280, 231784283, 3, 640x360 
0x12CB3460, 36963313733671920, 231784361, 231784363, 2, 640x360 
0x12CB3460, 36963313734312168, 231784410, 231784413, 3, 640x360 
0x12CB3460, 36963313735111208, 231784490, 231784493, 3, 640x360 
0x12CB3460, 36963313735751296, 231784550, 231784553, 3, 640x360 
0x12CB3460, 36963313736394016, 231784621, 231784624, 3, 640x360 
0x12CB3460, 36963313737032640, 231784679, 231784682, 3, 640x360 
0x12CB3460, 36963313737673120, 231784742, 231784745, 3, 640x360 
0x12CB3460, 36963313738312576, 231784809, 231784812, 3, 640x360 
0x12CB3460, 36963313739111536, 231784889, 231784892, 3, 640x360 
0x12CB3460, 36963313739751088, 231784950, 231784952, 2, 640x360 
0x12CB3460, 36963313740391648, 231785019, 231785023, 4, 640x360 
0x12CB3460, 36963313741031680, 231785080, 231785083, 3, 640x360 
0x12CB3460, 36963313741671656, 231785140, 231785143, 3, 640x360 
0x12CB3460, 36963313742313176, 231785210, 231785213, 3, 640x360 
0x12CB3460, 36963313743110952, 231785291, 231785294, 3, 640x360 
0x12CB3460, 36963313743752160, 231785349, 231785352, 3, 640x360 
0x12CB3460, 36963313744391448, 231785420, 231785423, 3, 640x360 
0x12CB3460, 36963313745031624, 231785480, 231785482, 2, 640x360 
0x12CB3460, 36963313745674264, 231785550, 231785553, 3, 640x360 
0x12CB3460, 36963313746316360, 231785610, 231785615, 5, 640x360 
0x12CB3460, 36963313747112408, 231785690, 231785692, 2, 640x360 
0x12CB3460, 36963313747752216, 231785751, 231785753, 2, 640x360 
0x12CB3460, 36963313748392320, 231785819, 231785823, 4, 640x360 
0x12CB3460, 36963313749031360, 231785878, 231785896, 18, 640x360 
0x12CB3460, 36963313749672792, 231785941, 231785944, 3, 640x360 
0x12CB3460, 36963313750311912, 231786009, 231786011, 2, 640x360 
0x12CB3460, 36963313751110888, 231786089, 231786093, 4, 640x360 
0x12CB3460, 36963313751750776, 231786149, 231786152, 3, 640x360 
0x12CB3460, 36963313752393304, 231786220, 231786223, 3, 640x360 
0x12CB3460, 36963313753032248, 231786280, 231786283, 3, 640x360 
0x12CB3460, 36963313753671976, 231786349, 231786352, 3, 640x360 
0x12CB3460, 36963313754311392, 231786410, 231786412, 2, 640x360 
0x12CB3460, 36963313755111384, 231786489, 231786492, 3, 640x360 
0x12CB3460, 36963313755750496, 231786550, 231786553, 3, 640x360 
0x12CB3460, 36963313756390416, 231786620, 231786623, 3, 640x360 
0x12CB3460, 36963313757031128, 231786680, 231786697, 17, 640x360 
0x12CB3460, 36963313757671600, 231786741, 231786745, 4, 640x360 
0x12CB3460, 36963313758311728, 231786810, 231786813, 3, 640x360 
0x12CB3460, 36963313759110560, 231786889, 231786891, 2, 640x360 
0x12CB3460, 36963313759752112, 231786952, 231786954, 2, 640x360 
0x12CB3460, 36963313760393784, 231787021, 231787025, 4, 640x360 
0x12CB3460, 36963313761031976, 231787080, 231787082, 2, 640x360 
0x12CB3460, 36963313761670720, 231787150, 231787153, 3, 640x360 
0x12CB3460, 36963313762312744, 231787210, 231787212, 2, 640x360 
0x12CB3460, 36963313763110088, 231787290, 231787293, 3, 640x360 
0x12CB3460, 36963313763752520, 231787372, 231787375, 3, 640x360 
0x12CB3460, 36963313764390816, 231787412, 231787416, 4, 640x360 
0x12CB3460, 36963313765031744, 231787479, 231787482, 3, 640x360 
0x12CB3460, 36963313765672928, 231787540, 231787544, 4, 640x360 
0x12CB3460, 36963313766314408, 231787610, 231787614, 4, 640x360 
0x12CB3460, 36963313767112672, 231787690, 231787693, 3, 640x360 
0x12CB3460, 36963313767752216, 231787750, 231787753, 3, 640x360 
0x12CB3460, 36963313768390824, 231787819, 231787823, 4, 640x360 
0x12CB3460, 36963313769031664, 231787880, 231787882, 2, 640x360 
0x12CB3460, 36963313769671440, 231787950, 231787953, 3, 640x360 
0x12CB3460, 36963313770312096, 231788009, 231788012, 3, 640x360 
0x12CB3460, 36963313771109768, 231788089, 231788092, 3, 640x360 
0x12CB3460, 36963313771751216, 231788150, 231788152, 2, 640x360 
0x12CB3460, 36963313772393064, 231788223, 231788226, 3, 640x360 
0x12CB3460, 36963313773033600, 231788280, 231788283, 3, 640x360 
0x12CB3460, 36963313773671864, 231788340, 231788344, 4, 640x360 
0x12CB3460, 36963313774311104, 231788410, 231788413, 3, 640x360 
0x12CB3460, 36963313775110680, 231788490, 231788493, 3, 640x360 
0x12CB3460, 36963313775750744, 231788549, 231788553, 4, 640x360 
0x12CB3460, 36963313776392744, 231788621, 231788624, 3, 640x360 
0x12CB3460, 36963313777030704, 231788679, 231788682, 3, 640x360 
0x12CB3460, 36963313777672368, 231788741, 231788744, 3, 640x360 
0x12CB3460, 36963313778312872, 231788810, 231788813, 3, 640x360 
0x12CB3460, 36963313779110864, 231788884, 231788888, 4, 640x360 
0x12CB3460, 36963313779752368, 231788950, 231788953, 3, 640x360 
0x12CB3460, 36963313780392744, 231789020, 231789024, 4, 640x360 
0x12CB3460, 36963313781030672, 231789080, 231789083, 3, 640x360 
0x12CB3460, 36963313781671624, 231789141, 231789145, 4, 640x360 
0x12CB3460, 36963313782311472, 231789209, 231789212, 3, 640x360 
0x12CB3460, 36963313783111456, 231789290, 231789293, 3, 640x360 
0x12CB3460, 36963313783751320, 231789373, 231789376, 3, 640x360 
0x12CB3460, 36963313784390656, 231789419, 231789422, 3, 640x360 
0x12CB3460, 36963313785032456, 231789480, 231789483, 3, 640x360 
0x12CB3460, 36963313785675544, 231789550, 231789553, 3, 640x360 
0x12CB3460, 36963313786316928, 231789611, 231789615, 4, 640x360 
0x12CB3460, 36963313787111496, 231789690, 231789693, 3, 640x360 
0x12CB3460, 36963313787751528, 231789751, 231789754, 3, 640x360 
0x12CB3460, 36963313788391256, 231789820, 231789823, 3, 640x360 
0x12CB3460, 36963313789033536, 231789888, 231789891, 3, 640x360 
0x12CB3460, 36963313789672016, 231789941, 231789945, 4, 640x360 
0x12CB3460, 36963313790313384, 231790010, 231790014, 4, 640x360 
0x12CB3460, 36963313791109856, 231790089, 231790093, 4, 640x360 
0x12CB3460, 36963313791751632, 231790149, 231790152, 3, 640x360 
0x12CB3460, 36963313792390712, 231790219, 231790222, 3, 640x360 
0x12CB3460, 36963313793031008, 231790279, 231790282, 3, 640x360 
0x12CB3460, 36963313793672152, 231790366, 231790369, 3, 640x360 
0x12CB3460, 36963313794312056, 231790410, 231790413, 3, 640x360 
0x12CB3460, 36963313794958120, 231790470, 231790475, 5, 640x360 
0x12CB3460, 36963313795750880, 231790549, 231790553, 4, 640x360 
0x12CB3460, 36963313796390472, 231790620, 231790625, 5, 640x360 
0x12CB3460, 36963313797030104, 231790680, 231790682, 2, 640x360 
0x12CB3460, 36963313797672016, 231790740, 231790744, 4, 640x360 
0x12CB3460, 36963313798312216, 231790810, 231790813, 3, 640x360 
0x12CB3460, 36963313798952464, 231790871, 231790874, 3, 640x360 
0x12CB3460, 36963313799750320, 231790951, 231790968, 17, 640x360 
0x12CB3460, 36963313800391696, 231791019, 231791023, 4, 640x360 
0x12CB3460, 36963313801030624, 231791080, 231791083, 3, 640x360 
0x12CB3460, 36963313801672952, 231791150, 231791154, 4, 640x360 
0x12CB3460, 36963313802312240, 231791209, 231791212, 3, 640x360 
0x12CB3460, 36963313802952240, 231791269, 231791273, 4, 640x360 
0x12CB3460, 36963313803749720, 231791349, 231791352, 3, 640x360 
0x12CB3460, 36963313804390064, 231791420, 231791424, 4, 640x360 
0x12CB3460, 36963313805032344, 231791480, 231791484, 4, 640x360 
0x12CB3460, 36963313805672048, 231791550, 231791552, 2, 640x360 
0x12CB3460, 36963313806313960, 231791610, 231791613, 3, 640x360 
0x12CB3460, 36963313806951600, 231791669, 231791672, 3, 640x360 
0x12CB3460, 36963313807750664, 231791749, 231791752, 3, 640x360 
0x12CB3460, 36963313808391512, 231791820, 231791823, 3, 640x360 
0x12CB3460, 36963313809030896, 231791880, 231791883, 3, 640x360 
0x12CB3460, 36963313809672080, 231791950, 231791953, 3, 640x360 
0x12CB3460, 36963313810312312, 231792009, 231792012, 3, 640x360 
0x12CB3460, 36963313810950512, 231792070, 231792074, 4, 640x360 
0x12CB3460, 36963313811752920, 231792150, 231792153, 3, 640x360 
0x12CB3460, 36963313812391840, 231792220, 231792224, 4, 640x360 
0x12CB3460, 36963313813031544, 231792281, 231792284, 3, 640x360 
0x12CB3460, 36963313813671488, 231792341, 231792344, 3, 640x360 
0x12CB3460, 36963313814311800, 231792410, 231792413, 3, 640x360 
0x12CB3460, 36963313814951760, 231792470, 231792474, 4, 640x360 
0x12CB3460, 36963313815750408, 231792551, 231792554, 3, 640x360 
0x12CB3460, 36963313816390688, 231792619, 231792622, 3, 640x360 
0x12CB3460, 36963313817030824, 231792679, 231792682, 3, 640x360 
0x12CB3460, 36963313817670528, 231792740, 231792744, 4, 640x360 
0x12CB3460, 36963313818315608, 231792810, 231792812, 2, 640x360 
0x12CB3460, 36963313818954064, 231792884, 231792887, 3, 640x360 
0x12CB3460, 36963313819750320, 231792951, 231792966, 15, 640x360 
0x12CB3460, 36963313820392664, 231793019, 231793022, 3, 640x360 
0x12CB3460, 36963313821031312, 231793079, 231793082, 3, 640x360 
0x12CB3460, 36963313821672536, 231793141, 231793147, 6, 640x360 
0x12CB3460, 36963313822311040, 231793210, 231793213, 3, 640x360 
0x12CB3460, 36963313822952216, 231793269, 231793273, 4, 640x360 
0x12CB3460, 36963313823751000, 231793350, 231793354, 4, 640x360 
0x12CB3460, 36963313824390712, 231793421, 231793425, 4, 640x360 
0x12CB3460, 36963313825030432, 231793480, 231793483, 3, 640x360 
0x12CB3460, 36963313825671232, 231793540, 231793544, 4, 640x360 
0x12CB3460, 36963313826311824, 231793610, 231793613, 3, 640x360 
0x12CB3460, 36963313826952184, 231793670, 231793674, 4, 640x360 
0x12CB3460, 36963313827749640, 231793750, 231793752, 2, 640x360 
0x12CB3460, 36963313828391384, 231793820, 231793822, 2, 640x360 
0x12CB3460, 36963313829030496, 231793880, 231793882, 2, 640x360 
0x12CB3460, 36963313829671728, 231793949, 231793952, 3, 640x360 
0x12CB3460, 36963313830312536, 231794010, 231794012, 2, 640x360 
0x12CB3460, 36963313830951888, 231794070, 231794073, 3, 640x360 
0x12CB3460, 36963313831751816, 231794150, 231794154, 4, 640x360 
0x12CB3460, 36963313832393872, 231794219, 231794223, 4, 640x360 
0x12CB3460, 36963313833031296, 231794280, 231794283, 3, 640x360 
0x12CB3460, 36963313833671032, 231794340, 231794344, 4, 640x360 
0x12CB3460, 36963313834310736, 231794409, 231794412, 3, 640x360 
0x12CB3460, 36963313834955752, 231794469, 231794473, 4, 640x360 
0x12CB3460, 36963313835750800, 231794550, 231794554, 4, 640x360 
0x12CB3460, 36963313836390264, 231794613, 231794617, 4, 640x360 
0x12CB3460, 36963313837030808, 231794679, 231794682, 3, 640x360 
0x12CB3460, 36963313837670752, 231794740, 231794742, 2, 640x360 
0x12CB3460, 36963313838312216, 231794810, 231794812, 2, 640x360 
0x12CB3460, 36963313838951400, 231794876, 231794894, 18, 640x360 
0x12CB3460, 36963313839750152, 231794949, 231794952, 3, 640x360 
0x12CB3460, 36963313840390568, 231795020, 231795024, 4, 640x360 
0x12CB3460, 36963313841030832, 231795079, 231795081, 2, 640x360 
0x12CB3460, 36963313841672120, 231795150, 231795153, 3, 640x360 
0x12CB3460, 36963313842310696, 231795210, 231795213, 3, 640x360 
0x12CB3460, 36963313842951792, 231795270, 231795273, 3, 640x360 
0x12CB3460, 36963313843749448, 231795372, 231795375, 3, 640x360 
0x12CB3460, 36963313844390952, 231795419, 231795422, 3, 640x360 
0x12CB3460, 36963313845030328, 231795480, 231795482, 2, 640x360 
0x12CB3460, 36963313845671192, 231795550, 231795553, 3, 640x360 
0x12CB3460, 36963313846312600, 231795610, 231795613, 3, 640x360 
0x12CB3460, 36963313846951240, 231795669, 231795675, 6, 640x360 
0x12CB3460, 36963313847749184, 231795750, 231795752, 2, 640x360 
0x12CB3460, 36963313848392136, 231795820, 231795823, 3, 640x360 
0x12CB3460, 36963313849032656, 231795887, 231795891, 4, 640x360 
0x12CB3460, 36963313849671448, 231795941, 231795944, 3, 640x360 
0x12CB3460, 36963313850312576, 231796010, 231796012, 2, 640x360 
0x12CB3460, 36963313850950800, 231796069, 231796073, 4, 640x360 
0x12CB3460, 36963313851750264, 231796150, 231796153, 3, 640x360 
0x12CB3460, 36963313852392616, 231796220, 231796223, 3, 640x360 
0x12CB3460, 36963313853030736, 231796280, 231796283, 3, 640x360 
0x12CB3460, 36963313853671576, 231796340, 231796344, 4, 640x360 
0x12CB3460, 36963313854311288, 231796410, 231796413, 3, 640x360 
0x12CB3460, 36963313854952464, 231796471, 231796474, 3, 640x360 
0x12CB3460, 36963313855749552, 231796550, 231796552, 2, 640x360 
0x12CB3460, 36963313856389888, 231796619, 231796622, 3, 640x360 
0x12CB3460, 36963313857030496, 231796679, 231796682, 3, 640x360 
0x12CB3460, 36963313857670960, 231796740, 231796743, 3, 640x360 
0x12CB3460, 36963313858311136, 231796811, 231796813, 2, 640x360 
0x12CB3460, 36963313858952184, 231796880, 231796883, 3, 640x360 
0x12CB3460, 36963313859593008, 231796939, 231796942, 3, 640x360 
0x12CB3460, 36963313860392072, 231797020, 231797024, 4, 640x360 
0x12CB3460, 36963313861030472, 231797081, 231797083, 2, 640x360 
0x12CB3460, 36963313861670856, 231797141, 231797144, 3, 640x360 
0x12CB3460, 36963313862312080, 231797209, 231797212, 3, 640x360 
0x12CB3460, 36963313862952304, 231797269, 231797273, 4, 640x360 
0x12CB3460, 36963313863592064, 231797340, 231797342, 2, 640x360 
0x12CB3460, 36963313864390368, 231797420, 231797423, 3, 640x360 
0x12CB3460, 36963313865030640, 231797480, 231797484, 4, 640x360 
0x12CB3460, 36963313865671248, 231797540, 231797543, 3, 640x360 
0x12CB3460, 36963313866313248, 231797610, 231797613, 3, 640x360 
0x12CB3460, 36963313866952136, 231797670, 231797673, 3, 640x360 
0x12CB3460, 36963313867590608, 231797739, 231797742, 3, 640x360 
0x12CB3460, 36963313868390192, 231797820, 231797822, 2, 640x360 
0x12CB3460, 36963313869029656, 231797879, 231797882, 3, 640x360 
0x12CB3460, 36963313869671184, 231797940, 231797944, 4, 640x360 
0x12CB3460, 36963313870311864, 231798009, 231798012, 3, 640x360 
0x12CB3460, 36963313870950368, 231798070, 231798073, 3, 640x360 
0x12CB3460, 36963313871591112, 231798140, 231798143, 3, 640x360 
0x12CB3460, 36963313872391256, 231798219, 231798223, 4, 640x360 
0x12CB3460, 36963313873030720, 231798281, 231798283, 2, 640x360 
0x12CB3460, 36963313873671456, 231798340, 231798343, 3, 640x360 
0x12CB3460, 36963313874310712, 231798409, 231798412, 3, 640x360 
0x12CB3460, 36963313874951736, 231798470, 231798473, 3, 640x360 
0x12CB3460, 36963313875592152, 231798540, 231798544, 4, 640x360 
0x12CB3460, 36963313876393968, 231798621, 231798624, 3, 640x360 
0x12CB3460, 36963313877030288, 231798680, 231798683, 3, 640x360 
0x12CB3460, 36963313877670480, 231798740, 231798743, 3, 640x360 
0x12CB3460, 36963313878310856, 231798810, 231798813, 3, 640x360 
0x12CB3460, 36963313878955384, 231798885, 231798888, 3, 640x360 
0x12CB3460, 36963313879591616, 231798940, 231798942, 2, 640x360 
0x12CB3460, 36963313880393832, 231799020, 231799022, 2, 640x360 
0x12CB3460, 36963313881030160, 231799080, 231799082, 2, 640x360 
0x12CB3460, 36963313881671896, 231799149, 231799152, 3, 640x360 
0x12CB3460, 36963313882310624, 231799209, 231799212, 3, 640x360 
0x12CB3460, 36963313882951744, 231799271, 231799273, 2, 640x360 
0x12CB3460, 36963313883591688, 231799340, 231799343, 3, 640x360 
0x12CB3460, 36963313884390744, 231799419, 231799421, 2, 640x360 
0x12CB3460, 36963313885030864, 231799480, 231799482, 2, 640x360 
0x12CB3460, 36963313885670824, 231799550, 231799552, 2, 640x360 
0x12CB3460, 36963313886312264, 231799609, 231799612, 3, 640x360 
0x12CB3460, 36963313886953504, 231799670, 231799673, 3, 640x360 
0x12CB3460, 36963313887592984, 231799741, 231799744, 3, 640x360 
0x12CB3460, 36963313888389872, 231799819, 231799822, 3, 640x360 
0x12CB3460, 36963313889030072, 231799879, 231799882, 3, 640x360 
0x12CB3460, 36963313889671520, 231799950, 231799952, 2, 640x360 
0x12CB3460, 36963313890312768, 231800010, 231800013, 3, 640x360 
0x12CB3460, 36963313890952984, 231800071, 231800074, 3, 640x360 
0x12CB3460, 36963313891592056, 231800139, 231800142, 3, 640x360 
0x12CB3460, 36963313892391336, 231800219, 231800222, 3, 640x360 
0x12CB3460, 36963313893030912, 231800279, 231800282, 3, 640x360 
0x12CB3460, 36963313893670464, 231800350, 231800353, 3, 640x360 
0x12CB3460, 36963313894310760, 231800410, 231800412, 2, 640x360 
0x12CB3460, 36963313894951168, 231800471, 231800473, 2, 640x360 
0x12CB3460, 36963313895591488, 231800540, 231800542, 2, 640x360 
0x12CB3460, 36963313896389056, 231800620, 231800622, 2, 640x360 
0x12CB3460, 36963313897030376, 231800680, 231800682, 2, 640x360 
0x12CB3460, 36963313897671136, 231800740, 231800744, 4, 640x360 
0x12CB3460, 36963313898311696, 231800809, 231800812, 3, 640x360 
0x12CB3460, 36963313898951184, 231800879, 231800882, 3, 640x360 
0x12CB3460, 36963313899590968, 231800939, 231800943, 4, 640x360 
0x12CB3460, 36963313900389536, 231801020, 231801023, 3, 640x360 
0x12CB3460, 36963313901031064, 231801080, 231801082, 2, 640x360 
0x12CB3460, 36963313901670584, 231801140, 231801144, 4, 640x360 
0x12CB3460, 36963313902311328, 231801209, 231801212, 3, 640x360 
0x12CB3460, 36963313902951024, 231801270, 231801273, 3, 640x360 
0x12CB3460, 36963313903592368, 231801341, 231801343, 2, 640x360 
0x12CB3460, 36963313904389120, 231801419, 231801422, 3, 640x360 
0x12CB3460, 36963313905029032, 231801479, 231801483, 4, 640x360 
0x12CB3460, 36963313905671248, 231801550, 231801552, 2, 640x360 
0x12CB3460, 36963313906314744, 231801610, 231801613, 3, 640x360 
0x12CB3460, 36963313906950160, 231801670, 231801672, 2, 640x360 
0x12CB3460, 36963313907592192, 231801739, 231801742, 3, 640x360 
0x12CB3460, 36963313908389664, 231801820, 231801824, 4, 640x360 
0x12CB3460, 36963313909031168, 231801887, 231801890, 3, 640x360 
0x12CB3460, 36963313909670728, 231801941, 231801944, 3, 640x360 
0x12CB3460, 36963313910311616, 231802010, 231802013, 3, 640x360 
0x12CB3460, 36963313910950616, 231802070, 231802074, 4, 640x360 
0x12CB3460, 36963313911591136, 231802132, 231802136, 4, 640x360 
0x12CB3460, 36963313912389040, 231802219, 231802222, 3, 640x360 
0x12CB3460, 36963313913030152, 231802281, 231802284, 3, 640x360 
0x12CB3460, 36963313913670376, 231802364, 231802367, 3, 640x360 
0x12CB3460, 36963313914309648, 231802409, 231802412, 3, 640x360 
0x12CB3460, 36963313914950544, 231802470, 231802473, 3, 640x360 
0x12CB3460, 36963313915591576, 231802539, 231802544, 5, 640x360 
0x12CB3460, 36963313916395176, 231802619, 231802623, 4, 640x360 
0x12CB3460, 36963313917032008, 231802680, 231802682, 2, 640x360 
0x12CB3460, 36963313917673824, 231802741, 231802745, 4, 640x360 
0x12CB3460, 36963313918309984, 231802810, 231802812, 2, 640x360 
0x12CB3460, 36963313918950640, 231802874, 231802876, 2, 640x360 
0x12CB3460, 36963313919591280, 231802940, 231802943, 3, 640x360 
0x12CB3460, 36963313920391144, 231803020, 231803025, 5, 640x360 
0x12CB3460, 36963313921030200, 231803079, 231803082, 3, 640x360 
0x12CB3460, 36963313921670608, 231803151, 231803153, 2, 640x360 
0x12CB3460, 36963313922310264, 231803210, 231803213, 3, 640x360 
0x12CB3460, 36963313922951200, 231803269, 231803273, 4, 640x360 
0x12CB3460, 36963313923591672, 231803340, 231803342, 2, 640x360 
0x12CB3460, 36963313924231768, 231803399, 231803402, 3, 640x360 
0x12CB3460, 36963313925030936, 231803479, 231803482, 3, 640x360 
0x12CB3460, 36963313925674032, 231803551, 231803568, 17, 640x360 
0x12CB3460, 36963313926312120, 231803610, 231803613, 3, 640x360 
0x12CB3460, 36963313926949648, 231803670, 231803672, 2, 640x360 
0x12CB3460, 36963313927592000, 231803740, 231803743, 3, 640x360 
0x12CB3460, 36963313928231360, 231803800, 231803803, 3, 640x360 
0x12CB3460, 36963313929028768, 231803879, 231803881, 2, 640x360 
0x12CB3460, 36963313929670768, 231803950, 231803952, 2, 640x360 
0x12CB3460, 36963313930310096, 231804010, 231804013, 3, 640x360 
0x12CB3460, 36963313930950760, 231804069, 231804073, 4, 640x360 
0x12CB3460, 36963313931592696, 231804140, 231804143, 3, 640x360 
0x12CB3460, 36963313932232992, 231804201, 231804204, 3, 640x360 
0x12CB3460, 36963313933029224, 231804281, 231804283, 2, 640x360 
0x12CB3460, 36963313933670680, 231804341, 231804344, 3, 640x360 
0x12CB3460, 36963313934309504, 231804410, 231804413, 3, 640x360 
0x12CB3460, 36963313934951160, 231804470, 231804473, 3, 640x360 
0x12CB3460, 36963313935591768, 231804539, 231804542, 3, 640x360 
0x12CB3460, 36963313936237400, 231804602, 231804605, 3, 640x360 
0x12CB3460, 36963313937029744, 231804679, 231804682, 3, 640x360 
0x12CB3460, 36963313937671896, 231804741, 231804745, 4, 640x360 
0x12CB3460, 36963313938310440, 231804810, 231804812, 2, 640x360 
0x12CB3460, 36963313938951424, 231804881, 231804884, 3, 640x360 
0x12CB3460, 36963313939590864, 231804940, 231804942, 2, 640x360 
0x12CB3460, 36963313940230344, 231805000, 231805003, 3, 640x360 
0x12CB3460, 36963313941029552, 231805079, 231805082, 3, 640x360 
0x12CB3460, 36963313941671056, 231805149, 231805152, 3, 640x360 
0x12CB3460, 36963313942311016, 231805209, 231805212, 3, 640x360 
0x12CB3460, 36963313942951040, 231805270, 231805273, 3, 640x360 
0x12CB3460, 36963313943591408, 231805339, 231805342, 3, 640x360 
0x12CB3460, 36963313944231232, 231805400, 231805403, 3, 640x360 
0x12CB3460, 36963313945030944, 231805480, 231805497, 17, 640x360 
0x12CB3460, 36963313945670824, 231805540, 231805544, 4, 640x360 
0x12CB3460, 36963313946311728, 231805610, 231805615, 5, 640x360 
0x12CB3460, 36963313946950896, 231805671, 231805674, 3, 640x360 
0x12CB3460, 36963313947591584, 231805740, 231805742, 2, 640x360 
0x12CB3460, 36963313948235144, 231805802, 231805820, 18, 640x360 
0x12CB3460, 36963313949035016, 231805882, 231805885, 3, 640x360 
0x12CB3460, 36963313949669280, 231805950, 231805953, 3, 640x360 
0x12CB3460, 36963313950311512, 231806010, 231806013, 3, 640x360 
0x12CB3460, 36963313950950184, 231806069, 231806072, 3, 640x360 
0x12CB3460, 36963313951590088, 231806139, 231806142, 3, 640x360 
0x12CB3460, 36963313952233128, 231806200, 231806203, 3, 640x360 
0x12CB3460, 36963313953032312, 231806280, 231806284, 4, 640x360 
0x12CB3460, 36963313953669704, 231806340, 231806344, 4, 640x360 
0x12CB3460, 36963313954310112, 231806409, 231806412, 3, 640x360 
0x12CB3460, 36963313954949400, 231806470, 231806474, 4, 640x360 
0x12CB3460, 36963313955591064, 231806540, 231806543, 3, 640x360 
0x12CB3460, 36963313956232992, 231806601, 231806604, 3, 640x360 
0x12CB3460, 36963313957029488, 231806680, 231806682, 2, 640x360 
0x12CB3460, 36963313957673008, 231806742, 231806746, 4, 640x360 
0x12CB3460, 36963313958309952, 231806810, 231806813, 3, 640x360 
0x12CB3460, 36963313958950040, 231806877, 231806880, 3, 640x360 
0x12CB3460, 36963313959590920, 231806939, 231806943, 4, 640x360 
0x12CB3460, 36963313960231944, 231807000, 231807003, 3, 640x360 
0x12CB3460, 36963313961028592, 231807079, 231807082, 3, 640x360 
0x12CB3460, 36963313961670880, 231807150, 231807153, 3, 640x360 
0x12CB3460, 36963313962310760, 231807210, 231807213, 3, 640x360 
0x12CB3460, 36963313962950720, 231807269, 231807272, 3, 640x360 
0x12CB3460, 36963313963590784, 231807339, 231807342, 3, 640x360 
0x12CB3460, 36963313964229544, 231807399, 231807403, 4, 640x360 
0x12CB3460, 36963313965030696, 231807479, 231807482, 3, 640x360 
0x12CB3460, 36963313965672096, 231807549, 231807552, 3, 640x360 
0x12CB3460, 36963313966311768, 231807611, 231807614, 3, 640x360 
0x12CB3460, 36963313966950672, 231807670, 231807673, 3, 640x360 
0x12CB3460, 36963313967590576, 231807733, 231807737, 4, 640x360 
0x12CB3460, 36963313968232240, 231807800, 231807803, 3, 640x360 
0x12CB3460, 36963313969029888, 231807882, 231807885, 3, 640x360 
0x12CB3460, 36963313969670408, 231807941, 231807944, 3, 640x360 
0x12CB3460, 36963313970311424, 231808010, 231808013, 3, 640x360 
0x12CB3460, 36963313970948872, 231808070, 231808072, 2, 640x360 
0x12CB3460, 36963313971591960, 231808140, 231808142, 2, 640x360 
0x12CB3460, 36963313972231064, 231808199, 231808201, 2, 640x360 
0x12CB3460, 36963313973028608, 231808279, 231808282, 3, 640x360 
0x12CB3460, 36963313973669744, 231808339, 231808343, 4, 640x360 
0x12CB3460, 36963313974308952, 231808410, 231808412, 2, 640x360 
0x12CB3460, 36963313974949624, 231808471, 231808474, 3, 640x360 
0x12CB3460, 36963313975589872, 231808540, 231808543, 3, 640x360 
0x12CB3460, 36963313976230240, 231808599, 231808602, 3, 640x360 
0x12CB3460, 36963313977030344, 231808679, 231808682, 3, 640x360 
0x12CB3460, 36963313977669400, 231808740, 231808743, 3, 640x360 
0x12CB3460, 36963313978310112, 231808810, 231808815, 5, 640x360 
0x12CB3460, 36963313978949368, 231808875, 231808878, 3, 640x360 
0x12CB3460, 36963313979590240, 231808939, 231808942, 3, 640x360 
0x12CB3460, 36963313980233176, 231809000, 231809003, 3, 640x360 
0x12CB3460, 36963313981029888, 231809080, 231809083, 3, 640x360 
0x12CB3460, 36963313981671360, 231809149, 231809152, 3, 640x360 
0x12CB3460, 36963313982309304, 231809210, 231809213, 3, 640x360 
0x12CB3460, 36963313982950176, 231809270, 231809273, 3, 640x360 
0x12CB3460, 36963313983590512, 231809339, 231809342, 3, 640x360 
0x12CB3460, 36963313984229248, 231809400, 231809403, 3, 640x360 
0x12CB3460, 36963313985031512, 231809481, 231809483, 2, 640x360 
0x12CB3460, 36963313985670624, 231809550, 231809553, 3, 640x360 
0x12CB3460, 36963313986311744, 231809610, 231809613, 3, 640x360 
0x12CB3460, 36963313986950152, 231809671, 231809677, 6, 640x360 
0x12CB3460, 36963313987592616, 231809739, 231809741, 2, 640x360 
0x12CB3460, 36963313988231576, 231809800, 231809803, 3, 640x360 
0x12CB3460, 36963313988874968, 231809884, 231809887, 3, 640x360 
0x12CB3460, 36963313989670112, 231809949, 231809952, 3, 640x360 
0x12CB3460, 36963313990310112, 231810010, 231810012, 2, 640x360 
0x12CB3460, 36963313990949736, 231810070, 231810073, 3, 640x360 
0x12CB3460, 36963313991591632, 231810139, 231810142, 3, 640x360 
0x12CB3460, 36963313992230080, 231810199, 231810202, 3, 640x360 
0x12CB3460, 36963313992870072, 231810270, 231810275, 5, 640x360 
0x12CB3460, 36963313993668688, 231810340, 231810344, 4, 640x360 
0x12CB3460, 36963313994309656, 231810409, 231810411, 2, 640x360 
0x12CB3460, 36963313994949216, 231810470, 231810472, 2, 640x360 
0x12CB3460, 36963313995590432, 231810540, 231810543, 3, 640x360 
0x12CB3460, 36963313996230048, 231810600, 231810602, 2, 640x360 
0x12CB3460, 36963313996870872, 231810661, 231810664, 3, 640x360 
0x12CB3460, 36963313997670248, 231810740, 231810743, 3, 640x360 
0x12CB3460, 36963313998309176, 231810810, 231810812, 2, 640x360 
0x12CB3460, 36963313998952224, 231810887, 231810890, 3, 640x360 
0x12CB3460, 36963313999591024, 231810941, 231810943, 2, 640x360 
0x12CB3460, 36963314000231984, 231811000, 231811003, 3, 640x360 
0x12CB3460, 36963314000870808, 231811069, 231811072, 3, 640x360 
0x12CB3460, 36963314001669712, 231811149, 231811152, 3, 640x360 
0x12CB3460, 36963314002309216, 231811209, 231811211, 2, 640x360 
0x12CB3460, 36963314002949728, 231811270, 231811272, 2, 640x360 
0x12CB3460, 36963314003589784, 231811339, 231811342, 3, 640x360 
0x12CB3460, 36963314004229464, 231811399, 231811403, 4, 640x360 
0x12CB3460, 36963314004870584, 231811471, 231811474, 3, 640x360 
0x12CB3460, 36963314005670072, 231811550, 231811553, 3, 640x360 
0x12CB3460, 36963314006310616, 231811609, 231811613, 4, 640x360 
0x12CB3460, 36963314006950088, 231811670, 231811674, 4, 640x360 
0x12CB3460, 36963314007591912, 231811739, 231811742, 3, 640x360 
0x12CB3460, 36963314008231040, 231811799, 231811802, 3, 640x360 
0x12CB3460, 36963314008872472, 231811873, 231811876, 3, 640x360 
0x12CB3460, 36963314009670216, 231811949, 231811953, 4, 640x360 
0x12CB3460, 36963314010311016, 231812010, 231812013, 3, 640x360 
0x12CB3460, 36963314010948728, 231812070, 231812073, 3, 640x360 
0x12CB3460, 36963314011589488, 231812139, 231812142, 3, 640x360 
0x12CB3460, 36963314012230304, 231812199, 231812202, 3, 640x360 
0x12CB3460, 36963314012870536, 231812270, 231812274, 4, 640x360 
0x12CB3460, 36963314013671712, 231812368, 231812371, 3, 640x360 
0x12CB3460, 36963314014308424, 231812409, 231812412, 3, 640x360 
0x12CB3460, 36963314014949064, 231812470, 231812473, 3, 640x360 
0x12CB3460, 36963314015591464, 231812539, 231812542, 3, 640x360 
0x12CB3460, 36963314016230144, 231812600, 231812602, 2, 640x360 
0x12CB3460, 36963314016869888, 231812661, 231812665, 4, 640x360 
0x12CB3460, 36963314017668912, 231812740, 231812748, 8, 640x360 
0x12CB3460, 36963314018309168, 231812809, 231812812, 3, 640x360 
0x12CB3460, 36963314018949008, 231812871, 231812874, 3, 640x360 
0x12CB3460, 36963314019590712, 231812938, 231812943, 5, 640x360 
0x12CB3460, 36963314020230440, 231812999, 231813002, 3, 640x360 
0x12CB3460, 36963314020872544, 231813069, 231813071, 2, 640x360 
0x12CB3460, 36963314021670128, 231813140, 231813144, 4, 640x360 
0x12CB3460, 36963314022308352, 231813209, 231813211, 2, 640x360 
0x12CB3460, 36963314022949344, 231813269, 231813272, 3, 640x360 
0x12CB3460, 36963314023589328, 231813340, 231813343, 3, 640x360 
0x12CB3460, 36963314024229312, 231813400, 231813403, 3, 640x360 
0x12CB3460, 36963314024871320, 231813470, 231813472, 2, 640x360 
0x12CB3460, 36963314025669624, 231813540, 231813544, 4, 640x360 
0x12CB3460, 36963314026309712, 231813610, 231813613, 3, 640x360 
0x12CB3460, 36963314026950336, 231813669, 231813673, 4, 640x360 
0x12CB3460, 36963314027591224, 231813740, 231813742, 2, 640x360 
0x12CB3460, 36963314028231112, 231813800, 231813803, 3, 640x360 
0x12CB3460, 36963314028873304, 231813884, 231813887, 3, 640x360 
0x12CB3460, 36963314029669344, 231813940, 231813944, 4, 640x360 
0x12CB3460, 36963314030310472, 231814011, 231814014, 3, 640x360 
0x12CB3460, 36963314030949320, 231814069, 231814072, 3, 640x360 
0x12CB3460, 36963314031589976, 231814140, 231814146, 6, 640x360 
0x12CB3460, 36963314032230520, 231814199, 231814202, 3, 640x360 
0x12CB3460, 36963314032870296, 231814270, 231814274, 4, 640x360 
0x12CB3460, 36963314033669360, 231814340, 231814344, 4, 640x360 
0x12CB3460, 36963314034309256, 231814409, 231814412, 3, 640x360 
0x12CB3460, 36963314034950184, 231814471, 231814474, 3, 640x360 
0x12CB3460, 36963314035590856, 231814539, 231814542, 3, 640x360 
0x12CB3460, 36963314036229968, 231814599, 231814602, 3, 640x360 
0x12CB3460, 36963314036870280, 231814660, 231814666, 6, 640x360 
0x12CB3460, 36963314037670072, 231814740, 231814748, 8, 640x360 
0x12CB3460, 36963314038308976, 231814810, 231814812, 2, 640x360 
0x12CB3460, 36963314038949984, 231814880, 231814883, 3, 640x360 
0x12CB3460, 36963314039590216, 231814939, 231814942, 3, 640x360 
0x12CB3460, 36963314040232608, 231814999, 231815004, 5, 640x360 
0x12CB3460, 36963314040869072, 231815060, 231815063, 3, 640x360 
0x12CB3460, 36963314041668504, 231815151, 231815154, 3, 640x360 
0x12CB3460, 36963314042310184, 231815209, 231815213, 4, 640x360 
0x12CB3460, 36963314042950752, 231815270, 231815274, 4, 640x360 
0x12CB3460, 36963314043589072, 231815339, 231815342, 3, 640x360 
0x12CB3460, 36963314044228976, 231815400, 231815404, 4, 640x360 
0x12CB3460, 36963314044870824, 231815470, 231815473, 3, 640x360 
0x12CB3460, 36963314045671840, 231815542, 231815546, 4, 640x360 
0x12CB3460, 36963314046308576, 231815609, 231815612, 3, 640x360 
0x12CB3460, 36963314046949336, 231815669, 231815672, 3, 640x360 
0x12CB3460, 36963314047590904, 231815739, 231815742, 3, 640x360 
0x12CB3460, 36963314048230496, 231815800, 231815803, 3, 640x360 
0x12CB3460, 36963314048877152, 231815880, 231815883, 3, 640x360 
0x12CB3460, 36963314049669800, 231815940, 231815943, 3, 640x360 
0x12CB3460, 36963314050310040, 231816009, 231816014, 5, 640x360 
0x12CB3460, 36963314050949056, 231816069, 231816072, 3, 640x360 
0x12CB3460, 36963314051589896, 231816132, 231816137, 5, 640x360 
0x12CB3460, 36963314052229400, 231816200, 231816203, 3, 640x360 
0x12CB3460, 36963314052870216, 231816260, 231816264, 4, 640x360 
0x12CB3460, 36963314053511048, 231816330, 231816333, 3, 640x360 
0x12CB3460, 36963314054309592, 231816410, 231816412, 2, 640x360 
0x12CB3460, 36963314054948456, 231816470, 231816473, 3, 640x360 
0x12CB3460, 36963314055590008, 231816540, 231816543, 3, 640x360 
0x12CB3460, 36963314056229712, 231816599, 231816602, 3, 640x360 
0x12CB3460, 36963314056870128, 231816660, 231816664, 4, 640x360 
0x12CB3460, 36963314057510600, 231816729, 231816732, 3, 640x360 
0x12CB3460, 36963314058308968, 231816810, 231816812, 2, 640x360 
0x12CB3460, 36963314058952512, 231816896, 231816899, 3, 640x360 
0x12CB3460, 36963314059590816, 231816939, 231816942, 3, 640x360 
0x12CB3460, 36963314060231888, 231817000, 231817003, 3, 640x360 
0x12CB3460, 36963314060870016, 231817060, 231817064, 4, 640x360 
0x12CB3460, 36963314061509896, 231817129, 231817132, 3, 640x360 
0x12CB3460, 36963314062309704, 231817209, 231817214, 5, 640x360 
0x12CB3460, 36963314062950264, 231817269, 231817274, 5, 640x360 
0x12CB3460, 36963314063588784, 231817340, 231817343, 3, 640x360 
0x12CB3460, 36963314064229544, 231817399, 231817402, 3, 640x360 
0x12CB3460, 36963314064870272, 231817470, 231817473, 3, 640x360 
0x12CB3460, 36963314065510336, 231817531, 231817533, 2, 640x360 
0x12CB3460, 36963314066309856, 231817610, 231817613, 3, 640x360 
0x12CB3460, 36963314066951264, 231817670, 231817674, 4, 640x360 
0x12CB3460, 36963314067590168, 231817740, 231817743, 3, 640x360 
0x12CB3460, 36963314068230464, 231817800, 231817802, 2, 640x360 
0x12CB3460, 36963314068874536, 231817889, 231817892, 3, 640x360 
0x12CB3460, 36963314069510408, 231817930, 231817932, 2, 640x360 
0x12CB3460, 36963314070308704, 231818010, 231818014, 4, 640x360 
0x12CB3460, 36963314070948528, 231818071, 231818075, 4, 640x360 
0x12CB3460, 36963314071590288, 231818134, 231818137, 3, 640x360 
0x12CB3460, 36963314072228616, 231818200, 231818208, 8, 640x360 
0x12CB3460, 36963314072869992, 231818260, 231818263, 3, 640x360 
0x12CB3460, 36963314073509856, 231818330, 231818337, 7, 640x360 
0x12CB3460, 36963314074309928, 231818411, 231818414, 3, 640x360 
0x12CB3460, 36963314074950064, 231818470, 231818475, 5, 640x360 
0x12CB3460, 36963314075590440, 231818539, 231818542, 3, 640x360 
0x12CB3460, 36963314076231224, 231818599, 231818603, 4, 640x360 
0x12CB3460, 36963314076870592, 231818661, 231818664, 3, 640x360 
0x12CB3460, 36963314077509712, 231818730, 231818732, 2, 640x360 
0x12CB3460, 36963314078307736, 231818809, 231818812, 3, 640x360 
0x12CB3460, 36963314078948176, 231818880, 231818883, 3, 640x360 
0x12CB3460, 36963314079588352, 231818940, 231818943, 3, 640x360 
0x12CB3460, 36963314080230000, 231819000, 231819003, 3, 640x360 
0x12CB3460, 36963314080869008, 231819060, 231819063, 3, 640x360 
0x12CB3460, 36963314081510136, 231819130, 231819132, 2, 640x360 
0x12CB3460, 36963314082308800, 231819209, 231819212, 3, 640x360 
0x12CB3460, 36963314082950624, 231819269, 231819273, 4, 640x360 
0x12CB3460, 36963314083591552, 231819341, 231819349, 8, 640x360 
0x12CB3460, 36963314084228384, 231819399, 231819403, 4, 640x360 
0x12CB3460, 36963314084869736, 231819470, 231819474, 4, 640x360 
0x12CB3460, 36963314085509672, 231819530, 231819533, 3, 640x360 
0x12CB3460, 36963314086310560, 231819610, 231819613, 3, 640x360 
0x12CB3460, 36963314086948864, 231819670, 231819673, 3, 640x360 
0x12CB3460, 36963314087588888, 231819739, 231819742, 3, 640x360 
0x12CB3460, 36963314088229696, 231819799, 231819802, 3, 640x360 
0x12CB3460, 36963314088869848, 231819863, 231819866, 3, 640x360 
0x12CB3460, 36963314089510120, 231819930, 231819932, 2, 640x360 
0x12CB3460, 36963314090309584, 231820011, 231820013, 2, 640x360 
0x12CB3460, 36963314090948056, 231820069, 231820072, 3, 640x360 
0x12CB3460, 36963314091589016, 231820140, 231820143, 3, 640x360 
0x12CB3460, 36963314092228280, 231820200, 231820202, 2, 640x360 
0x12CB3460, 36963314092869416, 231820260, 231820264, 4, 640x360 
0x12CB3460, 36963314093511408, 231820329, 231820332, 3, 640x360 
0x12CB3460, 36963314094307584, 231820409, 231820412, 3, 640x360 
0x12CB3460, 36963314094949808, 231820470, 231820473, 3, 640x360 
0x12CB3460, 36963314095590160, 231820539, 231820541, 2, 640x360 
0x12CB3460, 36963314096229296, 231820599, 231820602, 3, 640x360 
0x12CB3460, 36963314096869648, 231820669, 231820672, 3, 640x360 
0x12CB3460, 36963314097509192, 231820730, 231820733, 3, 640x360 
0x12CB3460, 36963314098308264, 231820811, 231820824, 13, 640x360 
0x12CB3460, 36963314098949280, 231820882, 231820885, 3, 640x360 
0x12CB3460, 36963314099588640, 231820940, 231820943, 3, 640x360 
0x12CB3460, 36963314100231096, 231821000, 231821003, 3, 640x360 
0x12CB3460, 36963314100868632, 231821060, 231821064, 4, 640x360 
0x12CB3460, 36963314101510408, 231821129, 231821132, 3, 640x360 
0x12CB3460, 36963314102310216, 231821209, 231821212, 3, 640x360 
0x12CB3460, 36963314102948728, 231821270, 231821273, 3, 640x360 
0x12CB3460, 36963314103587832, 231821340, 231821345, 5, 640x360 
0x12CB3460, 36963314104228056, 231821399, 231821403, 4, 640x360 
0x12CB3460, 36963314104870432, 231821460, 231821463, 3, 640x360 
0x12CB3460, 36963314105511128, 231821529, 231821532, 3, 640x360 
0x12CB3460, 36963314106308136, 231821609, 231821612, 3, 640x360 
0x12CB3460, 36963314106948624, 231821669, 231821674, 5, 640x360 
0x12CB3460, 36963314107589656, 231821739, 231821742, 3, 640x360 
0x12CB3460, 36963314108229904, 231821800, 231821803, 3, 640x360 
0x12CB3460, 36963314108873016, 231821871, 231821874, 3, 640x360 
0x12CB3460, 36963314109509088, 231821929, 231821932, 3, 640x360 
0x12CB3460, 36963314110309424, 231822010, 231822015, 5, 640x360 
0x12CB3460, 36963314110949240, 231822070, 231822073, 3, 640x360 
0x12CB3460, 36963314111591488, 231822140, 231822143, 3, 640x360 
0x12CB3460, 36963314112230152, 231822200, 231822203, 3, 640x360 
0x12CB3460, 36963314112869288, 231822270, 231822273, 3, 640x360 
0x12CB3460, 36963314113511648, 231822331, 231822335, 4, 640x360 
0x12CB3460, 36963314114307408, 231822410, 231822413, 3, 640x360 
0x12CB3460, 36963314114949000, 231822471, 231822475, 4, 640x360 
0x12CB3460, 36963314115588928, 231822539, 231822542, 3, 640x360 
0x12CB3460, 36963314116231112, 231822601, 231822603, 2, 640x360 
0x12CB3460, 36963314116874648, 231822670, 231822673, 3, 640x360 
0x12CB3460, 36963314117510584, 231822731, 231822749, 18, 640x360 
0x12CB3460, 36963314118150712, 231822791, 231822793, 2, 640x360 
0x12CB3460, 36963314118950800, 231822897, 231822900, 3, 640x360 
0x12CB3460, 36963314119589272, 231822939, 231822942, 3, 640x360 
0x12CB3460, 36963314120230760, 231822999, 231823002, 3, 640x360 
0x12CB3460, 36963314120870336, 231823069, 231823072, 3, 640x360 
0x12CB3460, 36963314121509472, 231823129, 231823132, 3, 640x360 
0x12CB3460, 36963314122150848, 231823190, 231823193, 3, 640x360 
0x12CB3460, 36963314122949016, 231823270, 231823272, 2, 640x360 
0x12CB3460, 36963314123590136, 231823339, 231823342, 3, 640x360 
0x12CB3460, 36963314124228576, 231823399, 231823401, 2, 640x360 
0x12CB3460, 36963314124869096, 231823470, 231823473, 3, 640x360 
0x12CB3460, 36963314125514576, 231823530, 231823533, 3, 640x360 
0x12CB3460, 36963314126149136, 231823591, 231823593, 2, 640x360 
0x12CB3460, 36963314126952432, 231823671, 231823675, 4, 640x360 
0x12CB3460, 36963314127590120, 231823733, 231823738, 5, 640x360 
0x12CB3460, 36963314128230360, 231823801, 231823804, 3, 640x360 
0x12CB3460, 36963314128870688, 231823864, 231823867, 3, 640x360 
0x12CB3460, 36963314129515552, 231823930, 231823933, 3, 640x360 
0x12CB3460, 36963314130149112, 231823990, 231823993, 3, 640x360 
0x12CB3460, 36963314130948616, 231824069, 231824073, 4, 640x360 
0x12CB3460, 36963314131588160, 231824140, 231824143, 3, 640x360 
0x12CB3460, 36963314132228824, 231824201, 231824204, 3, 640x360 
0x12CB3460, 36963314132868328, 231824260, 231824263, 3, 640x360 
0x12CB3460, 36963314133510000, 231824329, 231824332, 3, 640x360 
0x12CB3460, 36963314134149400, 231824389, 231824391, 2, 640x360 
0x12CB3460, 36963314134948992, 231824469, 231824473, 4, 640x360 
